id,network,epoch,start_slot,end_slot,total_slots,total_blocks_produced,total_slots_skipped,total_skip_percent,created_at
774396,mainnet,244,105408000,105415432,7433,7035,398,0.05354500201802771,2021-11-06 00:00:46 UTC
774398,mainnet,244,105408000,105415609,7610,7206,404,0.053088042049934295,2021-11-06 00:02:12 UTC
774399,mainnet,244,105408000,105415772,7773,7364,409,0.05261803679403062,2021-11-06 00:03:36 UTC
774401,mainnet,244,105408000,105415962,7963,7552,411,0.051613713424588724,2021-11-06 00:05:09 UTC
774402,mainnet,244,105408000,105416191,8192,7773,419,0.0511474609375,2021-11-06 00:07:11 UTC
774404,mainnet,244,105408000,105416344,8345,7919,426,0.05104853205512283,2021-11-06 00:08:44 UTC
774405,mainnet,244,105408000,105416532,8533,8104,429,0.05027540138286652,2021-11-06 00:10:10 UTC
774407,mainnet,244,105408000,105416707,8708,8266,442,0.05075792374827744,2021-11-06 00:11:37 UTC
774408,mainnet,244,105408000,105416890,8891,8438,453,0.050950399280170956,2021-11-06 00:13:01 UTC
774410,mainnet,244,105408000,105417048,9049,8590,459,0.05072383688805393,2021-11-06 00:14:27 UTC
774411,mainnet,244,105408000,105417226,9227,8750,477,0.05169610924460821,2021-11-06 00:15:52 UTC
774413,mainnet,244,105408000,105417396,9397,8916,481,0.051186548898584656,2021-11-06 00:17:15 UTC
774414,mainnet,244,105408000,105417575,9576,9079,497,0.051900584795321635,2021-11-06 00:18:48 UTC
774416,mainnet,244,105408000,105417710,9711,9189,522,0.05375347544022243,2021-11-06 00:20:12 UTC
774417,mainnet,244,105408000,105417906,9907,9365,542,0.054708791763399614,2021-11-06 00:21:41 UTC
774419,mainnet,244,105408000,105418140,10141,9595,546,0.053840844098215164,2021-11-06 00:23:35 UTC
774420,mainnet,244,105408000,105418312,10313,9761,552,0.053524677591389506,2021-11-06 00:25:00 UTC
774422,mainnet,244,105408000,105418482,10483,9916,567,0.054087570351998474,2021-11-06 00:26:23 UTC
774423,mainnet,244,105408000,105418642,10643,10076,567,0.053274452691910175,2021-11-06 00:27:43 UTC
774425,mainnet,244,105408000,105418826,10827,10254,573,0.052923247436963146,2021-11-06 00:29:26 UTC
774426,mainnet,244,105408000,105419024,11025,10447,578,0.05242630385487528,2021-11-06 00:30:52 UTC
774428,mainnet,244,105408000,105419188,11189,10610,579,0.05174725176512646,2021-11-06 00:32:11 UTC
774429,mainnet,244,105408000,105419382,11383,10800,583,0.051216726697707105,2021-11-06 00:33:41 UTC
774431,mainnet,244,105408000,105419548,11549,10962,587,0.050826911420902246,2021-11-06 00:35:03 UTC
774432,mainnet,244,105408000,105419728,11729,11140,589,0.050217409838860944,2021-11-06 00:36:29 UTC
774434,mainnet,244,105408000,105419897,11898,11309,589,0.049504118339216675,2021-11-06 00:37:50 UTC
774435,mainnet,244,105408000,105420086,12087,11489,598,0.04947464217754612,2021-11-06 00:39:22 UTC
774437,mainnet,244,105408000,105420284,12285,11680,605,0.04924704924704925,2021-11-06 00:41:17 UTC
774438,mainnet,244,105408000,105420492,12493,11887,606,0.04850716401184663,2021-11-06 00:42:41 UTC
774440,mainnet,244,105408000,105420671,12672,12058,614,0.04845328282828283,2021-11-06 00:44:07 UTC
774441,mainnet,244,105408000,105420852,12853,12234,619,0.04815996265463316,2021-11-06 00:45:32 UTC
774443,mainnet,244,105408000,105421020,13021,12397,624,0.04792258659089164,2021-11-06 00:46:58 UTC
774444,mainnet,244,105408000,105421201,13202,12573,629,0.047644296318739586,2021-11-06 00:48:26 UTC
774446,mainnet,244,105408000,105421367,13368,12733,635,0.04750149611011371,2021-11-06 00:49:48 UTC
774447,mainnet,244,105408000,105421532,13533,12898,635,0.04692233798862041,2021-11-06 00:51:15 UTC
774449,mainnet,244,105408000,105421709,13710,13066,644,0.04697301239970824,2021-11-06 00:52:41 UTC
774450,mainnet,244,105408000,105421896,13897,13245,652,0.04691660070518817,2021-11-06 00:54:08 UTC
774451,mainnet,244,105408000,105422045,14046,13379,667,0.04748682899045992,2021-11-06 00:55:32 UTC
774453,mainnet,244,105408000,105422225,14226,13549,677,0.04758892169267538,2021-11-06 00:56:53 UTC
774454,mainnet,244,105408000,105422404,14405,13720,685,0.047552933009371745,2021-11-06 00:58:18 UTC
774456,mainnet,244,105408000,105422471,14472,13787,685,0.047332780541735765,2021-11-06 00:59:53 UTC
774457,mainnet,244,105408000,105422760,14761,14040,721,0.048844929205338394,2021-11-06 01:01:21 UTC
774459,mainnet,244,105408000,105422895,14896,14175,721,0.048402255639097745,2021-11-06 01:02:52 UTC
774460,mainnet,244,105408000,105423128,15129,14387,742,0.04904488069270937,2021-11-06 01:04:30 UTC
774462,mainnet,244,105408000,105423309,15310,14562,748,0.0488569562377531,2021-11-06 01:05:58 UTC
774463,mainnet,244,105408000,105423494,15495,14745,750,0.0484027105517909,2021-11-06 01:07:26 UTC
774465,mainnet,244,105408000,105423684,15685,14929,756,0.04819891616193816,2021-11-06 01:09:09 UTC
774466,mainnet,244,105408000,105423910,15911,15145,766,0.048142794293256234,2021-11-06 01:10:49 UTC
774468,mainnet,244,105408000,105424081,16082,15310,772,0.0480039796045268,2021-11-06 01:12:16 UTC
774469,mainnet,244,105408000,105424247,16248,15466,782,0.04812900049236829,2021-11-06 01:13:40 UTC
774471,mainnet,244,105408000,105424440,16441,15653,788,0.04792895809257344,2021-11-06 01:15:22 UTC
774472,mainnet,244,105408000,105424673,16674,15885,789,0.047319179560993165,2021-11-06 01:17:02 UTC
774474,mainnet,244,105408000,105424851,16852,16058,794,0.0471160693092808,2021-11-06 01:18:43 UTC
774475,mainnet,244,105408000,105425049,17050,16248,802,0.04703812316715542,2021-11-06 01:20:11 UTC
774477,mainnet,244,105408000,105425236,17237,16434,803,0.04658583280153159,2021-11-06 01:21:49 UTC
774478,mainnet,244,105408000,105425462,17463,16656,807,0.046211991066827,2021-11-06 01:23:27 UTC
774480,mainnet,244,105408000,105425654,17655,16843,812,0.04599263664684226,2021-11-06 01:25:07 UTC
774481,mainnet,244,105408000,105425850,17851,17034,817,0.04576774410397177,2021-11-06 01:26:39 UTC
774483,mainnet,244,105408000,105426048,18049,17223,826,0.04576430827192642,2021-11-06 01:28:17 UTC
774484,mainnet,244,105408000,105426217,18218,17384,834,0.04577889998902185,2021-11-06 01:29:39 UTC
774486,mainnet,244,105408000,105426382,18383,17537,846,0.046020780068541586,2021-11-06 01:31:15 UTC
774487,mainnet,244,105408000,105426590,18591,17734,857,0.046097574094992204,2021-11-06 01:32:43 UTC
774489,mainnet,244,105408000,105426763,18764,17900,864,0.04604561927094436,2021-11-06 01:34:11 UTC
774490,mainnet,244,105408000,105426944,18945,18076,869,0.04586962259171285,2021-11-06 01:35:38 UTC
774492,mainnet,244,105408000,105427134,19135,18265,870,0.045466422785471645,2021-11-06 01:37:09 UTC
774493,mainnet,244,105408000,105427356,19357,18482,875,0.0452032856331043,2021-11-06 01:38:56 UTC
774495,mainnet,244,105408000,105427544,19545,18668,877,0.04487081094909184,2021-11-06 01:40:24 UTC
774497,mainnet,244,105408000,105427794,19795,18913,882,0.04455670623894923,2021-11-06 01:42:19 UTC
774498,mainnet,244,105408000,105428030,20031,19148,883,0.04408167340622036,2021-11-06 01:44:14 UTC
774500,mainnet,244,105408000,105428206,20207,19320,887,0.043895679714950266,2021-11-06 01:45:37 UTC
774501,mainnet,244,105408000,105428394,20395,19503,892,0.04373620985535671,2021-11-06 01:47:04 UTC
774503,mainnet,244,105408000,105428567,20568,19667,901,0.04380591209646052,2021-11-06 01:48:27 UTC
774504,mainnet,244,105408000,105428730,20731,19825,906,0.04370266750277362,2021-11-06 01:49:49 UTC
774506,mainnet,244,105408000,105428914,20915,20005,910,0.04350944298350466,2021-11-06 01:51:13 UTC
774507,mainnet,244,105408000,105429093,21094,20179,915,0.04337726367687494,2021-11-06 01:52:38 UTC
774509,mainnet,244,105408000,105429268,21269,20349,920,0.04325544219286285,2021-11-06 01:54:02 UTC
774510,mainnet,244,105408000,105429448,21449,20529,920,0.04289244253811367,2021-11-06 01:55:28 UTC
774512,mainnet,244,105408000,105429624,21625,20704,921,0.042589595375722544,2021-11-06 01:57:00 UTC
774513,mainnet,244,105408000,105429837,21838,20908,930,0.04258631742833593,2021-11-06 01:59:05 UTC
774515,mainnet,244,105408000,105430065,22066,21129,937,0.04246351853530318,2021-11-06 02:00:36 UTC
774516,mainnet,244,105408000,105430251,22252,21313,939,0.04219845407154413,2021-11-06 02:02:11 UTC
774518,mainnet,244,105408000,105430428,22429,21477,952,0.04244504882072317,2021-11-06 02:03:35 UTC
774519,mainnet,244,105408000,105430608,22609,21650,959,0.04241673669777522,2021-11-06 02:04:59 UTC
774521,mainnet,244,105408000,105430789,22790,21831,959,0.0420798595875384,2021-11-06 02:06:23 UTC
774522,mainnet,244,105408000,105430967,22968,22009,959,0.041753744339951236,2021-11-06 02:07:51 UTC
774524,mainnet,244,105408000,105431111,23112,22142,970,0.04196953963309104,2021-11-06 02:09:17 UTC
774525,mainnet,244,105408000,105431273,23274,22295,979,0.04206410586921028,2021-11-06 02:10:52 UTC
774527,mainnet,244,105408000,105431473,23474,22487,987,0.04204651955354861,2021-11-06 02:12:27 UTC
774528,mainnet,244,105408000,105431642,23643,22647,996,0.04212663367592945,2021-11-06 02:13:49 UTC
774530,mainnet,244,105408000,105431827,23828,22831,997,0.04184153097196575,2021-11-06 02:15:16 UTC
774531,mainnet,244,105408000,105432008,24009,23011,998,0.041567745428797535,2021-11-06 02:16:40 UTC
774533,mainnet,244,105408000,105432205,24206,23203,1003,0.04143600760142113,2021-11-06 02:18:16 UTC
774534,mainnet,244,105408000,105432374,24375,23367,1008,0.04135384615384615,2021-11-06 02:19:38 UTC
774536,mainnet,244,105408000,105432543,24544,23532,1012,0.04123207301173403,2021-11-06 02:21:03 UTC
774537,mainnet,244,105408000,105432754,24755,23739,1016,0.04104221369420319,2021-11-06 02:22:40 UTC
774539,mainnet,244,105408000,105432930,24931,23903,1028,0.041233805302635276,2021-11-06 02:24:05 UTC
774540,mainnet,244,105408000,105433117,25118,24086,1032,0.04108607373198503,2021-11-06 02:25:35 UTC
774542,mainnet,244,105408000,105433301,25302,24262,1040,0.04110347008141649,2021-11-06 02:27:02 UTC
774543,mainnet,244,105408000,105433488,25489,24434,1055,0.0413904037035584,2021-11-06 02:28:26 UTC
774545,mainnet,244,105408000,105433675,25676,24620,1056,0.041127901542296307,2021-11-06 02:30:05 UTC
774546,mainnet,244,105408000,105433873,25874,24812,1062,0.04104506454355724,2021-11-06 02:31:33 UTC
774548,mainnet,244,105408000,105434043,26044,24982,1062,0.04077714636768546,2021-11-06 02:32:57 UTC
774549,mainnet,244,105408000,105434216,26217,25153,1064,0.04058435366365336,2021-11-06 02:34:22 UTC
774551,mainnet,244,105408000,105434390,26391,25325,1066,0.040392558069038687,2021-11-06 02:35:48 UTC
774552,mainnet,244,105408000,105434574,26575,25505,1070,0.04026340545625588,2021-11-06 02:37:16 UTC
774554,mainnet,244,105408000,105434749,26750,25680,1070,0.04,2021-11-06 02:38:44 UTC
774555,mainnet,244,105408000,105434928,26929,25850,1079,0.04006832782502135,2021-11-06 02:40:07 UTC
774557,mainnet,244,105408000,105435134,27135,26048,1087,0.040058964437073886,2021-11-06 02:41:44 UTC
774558,mainnet,244,105408000,105435341,27342,26242,1100,0.04023114622192963,2021-11-06 02:43:22 UTC
774560,mainnet,244,105408000,105435533,27534,26433,1101,0.03998692525604707,2021-11-06 02:44:52 UTC
774561,mainnet,244,105408000,105435708,27709,26606,1103,0.039806561045147786,2021-11-06 02:46:27 UTC
774563,mainnet,244,105408000,105435909,27910,26805,1105,0.03959154424937299,2021-11-06 02:47:56 UTC
774564,mainnet,244,105408000,105436087,28088,26979,1109,0.03948305326117915,2021-11-06 02:49:30 UTC
774566,mainnet,244,105408000,105436272,28273,27153,1120,0.039613765783609804,2021-11-06 02:50:58 UTC
774567,mainnet,244,105408000,105436453,28454,27331,1123,0.039467210234061995,2021-11-06 02:52:27 UTC
774569,mainnet,244,105408000,105436636,28637,27513,1124,0.03924992143031742,2021-11-06 02:53:51 UTC
774570,mainnet,244,105408000,105436820,28821,27693,1128,0.03913812844800666,2021-11-06 02:55:16 UTC
774572,mainnet,244,105408000,105437082,29083,27947,1136,0.03906061960595537,2021-11-06 02:57:21 UTC
774574,mainnet,244,105408000,105437278,29279,28141,1138,0.03886744765873151,2021-11-06 02:58:57 UTC
774575,mainnet,244,105408000,105437493,29494,28353,1141,0.038685834406998035,2021-11-06 03:00:55 UTC
774577,mainnet,244,105408000,105437698,29699,28551,1148,0.038654500151520256,2021-11-06 03:02:29 UTC
774578,mainnet,244,105408000,105437876,29877,28728,1149,0.03845767647354152,2021-11-06 03:03:54 UTC
774580,mainnet,244,105408000,105438068,30069,28919,1150,0.0382453689846686,2021-11-06 03:05:30 UTC
774581,mainnet,244,105408000,105438241,30242,29091,1151,0.03805965213940877,2021-11-06 03:06:55 UTC
774583,mainnet,244,105408000,105438487,30488,29332,1156,0.03791655733403306,2021-11-06 03:08:52 UTC
774584,mainnet,244,105408000,105438666,30667,29511,1156,0.037695242443016926,2021-11-06 03:10:18 UTC
774586,mainnet,244,105408000,105438918,30919,29759,1160,0.037517384132733915,2021-11-06 03:12:15 UTC
774588,mainnet,244,105408000,105439190,31191,30023,1168,0.037446699368407554,2021-11-06 03:14:23 UTC
774589,mainnet,244,105408000,105439426,31427,30246,1181,0.03757915168485697,2021-11-06 03:16:16 UTC
774591,mainnet,244,105408000,105439593,31594,30403,1191,0.03769703108185098,2021-11-06 03:17:39 UTC
774592,mainnet,244,105408000,105439816,31817,30618,1199,0.03768425684382563,2021-11-06 03:19:26 UTC
774594,mainnet,244,105408000,105439997,31998,30791,1207,0.037721107569223075,2021-11-06 03:20:54 UTC
774595,mainnet,244,105408000,105440199,32200,30991,1209,0.037546583850931674,2021-11-06 03:22:31 UTC
774597,mainnet,244,105408000,105440396,32397,31186,1211,0.037380004321387786,2021-11-06 03:24:06 UTC
774598,mainnet,244,105408000,105440577,32578,31367,1211,0.03717232488182209,2021-11-06 03:25:29 UTC
774600,mainnet,244,105408000,105440763,32764,31545,1219,0.03720546941765352,2021-11-06 03:26:58 UTC
774601,mainnet,244,105408000,105440946,32947,31726,1221,0.03705951983488633,2021-11-06 03:28:24 UTC
774603,mainnet,244,105408000,105441109,33110,31888,1222,0.036907278767743884,2021-11-06 03:29:47 UTC
774604,mainnet,244,105408000,105441296,33297,32072,1225,0.03679010121031925,2021-11-06 03:31:20 UTC
774606,mainnet,244,105408000,105441491,33492,32262,1230,0.036725188104622,2021-11-06 03:32:49 UTC
774607,mainnet,244,105408000,105441685,33686,32454,1232,0.03657305705634388,2021-11-06 03:34:21 UTC
774609,mainnet,244,105408000,105441880,33881,32647,1234,0.036421593223340515,2021-11-06 03:35:56 UTC
774610,mainnet,244,105408000,105442070,34071,32833,1238,0.036335886824572214,2021-11-06 03:37:25 UTC
774612,mainnet,244,105408000,105442250,34251,33012,1239,0.036174126302881665,2021-11-06 03:38:53 UTC
774613,mainnet,244,105408000,105442457,34458,33219,1239,0.035956816994602125,2021-11-06 03:40:35 UTC
774615,mainnet,244,105408000,105442649,34650,33404,1246,0.03595959595959596,2021-11-06 03:42:05 UTC
774616,mainnet,244,105408000,105442842,34843,33593,1250,0.03587521166374882,2021-11-06 03:43:32 UTC
774618,mainnet,244,105408000,105443045,35046,33793,1253,0.035753010329281514,2021-11-06 03:45:12 UTC
774619,mainnet,244,105408000,105443254,35255,33996,1259,0.03571124663168345,2021-11-06 03:46:50 UTC
774621,mainnet,244,105408000,105443428,35429,34168,1261,0.03559231138333004,2021-11-06 03:48:18 UTC
774622,mainnet,244,105408000,105443618,35619,34356,1263,0.035458603554282826,2021-11-06 03:49:51 UTC
774624,mainnet,244,105408000,105443806,35807,34543,1264,0.0353003602647527,2021-11-06 03:51:19 UTC
774625,mainnet,244,105408000,105443980,35981,34715,1266,0.0351852366526778,2021-11-06 03:52:42 UTC
774627,mainnet,244,105408000,105444168,36169,34902,1267,0.035029998064640994,2021-11-06 03:54:19 UTC
774628,mainnet,244,105408000,105444376,36377,35106,1271,0.034939659675069415,2021-11-06 03:55:51 UTC
774630,mainnet,244,105408000,105444572,36573,35297,1276,0.03488912585787329,2021-11-06 03:57:22 UTC
774631,mainnet,244,105408000,105444766,36767,35486,1281,0.034841025919982595,2021-11-06 03:58:59 UTC
774633,mainnet,244,105408000,105444954,36955,35668,1287,0.03482613989987823,2021-11-06 04:00:34 UTC
774634,mainnet,244,105408000,105445129,37130,35819,1311,0.03530837597629949,2021-11-06 04:02:15 UTC
774636,mainnet,244,105408000,105445318,37319,36002,1317,0.03529033468206544,2021-11-06 04:03:47 UTC
774637,mainnet,244,105408000,105445400,37401,36079,1322,0.035346648485334614,2021-11-06 04:05:26 UTC
774639,mainnet,244,105408000,105445669,37670,36313,1357,0.036023360764534114,2021-11-06 04:06:56 UTC
774640,mainnet,244,105408000,105445856,37857,36479,1378,0.036400137359008905,2021-11-06 04:08:23 UTC
774642,mainnet,244,105408000,105446032,38033,36654,1379,0.03625798648542056,2021-11-06 04:09:50 UTC
774643,mainnet,244,105408000,105446236,38237,36856,1381,0.03611685017130005,2021-11-06 04:11:29 UTC
774645,mainnet,244,105408000,105446434,38435,37050,1385,0.036034864056198775,2021-11-06 04:13:04 UTC
774646,mainnet,244,105408000,105446607,38608,37207,1401,0.036287815996684625,2021-11-06 04:14:28 UTC
774648,mainnet,244,105408000,105446814,38815,37413,1402,0.0361200566791189,2021-11-06 04:16:11 UTC
774649,mainnet,244,105408000,105446988,38989,37583,1406,0.03606145323039832,2021-11-06 04:17:37 UTC
774651,mainnet,244,105408000,105447207,39208,37796,1412,0.03601305855947766,2021-11-06 04:19:15 UTC
774653,mainnet,244,105408000,105447397,39398,37982,1416,0.03594091070612721,2021-11-06 04:20:54 UTC
774654,mainnet,244,105408000,105447559,39560,38141,1419,0.035869565217391305,2021-11-06 04:22:19 UTC
774656,mainnet,244,105408000,105447728,39729,38304,1425,0.035868005738880916,2021-11-06 04:23:47 UTC
774657,mainnet,244,105408000,105447905,39906,38474,1432,0.03588432817120232,2021-11-06 04:25:19 UTC
774659,mainnet,244,105408000,105448088,40089,38647,1442,0.03596996682381701,2021-11-06 04:27:02 UTC
774660,mainnet,244,105408000,105448246,40247,38802,1445,0.03590329714015952,2021-11-06 04:28:29 UTC
774662,mainnet,244,105408000,105448420,40421,38967,1454,0.03597140100442839,2021-11-06 04:29:56 UTC
774663,mainnet,244,105408000,105448604,40605,39151,1454,0.03580839798054427,2021-11-06 04:31:25 UTC
774665,mainnet,244,105408000,105448818,40819,39353,1466,0.03591464759058282,2021-11-06 04:33:11 UTC
774666,mainnet,244,105408000,105449008,41009,39542,1467,0.0357726352751835,2021-11-06 04:34:36 UTC
774668,mainnet,244,105408000,105449180,41181,39713,1468,0.035647507345620555,2021-11-06 04:36:02 UTC
774669,mainnet,244,105408000,105449364,41365,39885,1480,0.035779040251420285,2021-11-06 04:37:38 UTC
774671,mainnet,244,105408000,105449626,41627,40143,1484,0.03564993874168208,2021-11-06 04:40:05 UTC
774673,mainnet,244,105408000,105449896,41897,40406,1491,0.03558727355180562,2021-11-06 04:41:46 UTC
774674,mainnet,244,105408000,105450085,42086,40590,1496,0.03554626241505489,2021-11-06 04:43:24 UTC
774676,mainnet,244,105408000,105450300,42301,40800,1501,0.035483794709344936,2021-11-06 04:45:02 UTC
774677,mainnet,244,105408000,105450496,42497,40991,1506,0.03543779560910182,2021-11-06 04:46:36 UTC
774679,mainnet,244,105408000,105450677,42678,41164,1514,0.035474951965884065,2021-11-06 04:48:06 UTC
774680,mainnet,244,105408000,105450866,42867,41348,1519,0.03543518324118786,2021-11-06 04:49:35 UTC
774682,mainnet,244,105408000,105451053,43054,41534,1520,0.0353045013239188,2021-11-06 04:51:07 UTC
774683,mainnet,244,105408000,105451216,43217,41691,1526,0.03531017886479858,2021-11-06 04:52:35 UTC
774685,mainnet,244,105408000,105451408,43409,41871,1538,0.03543044069202239,2021-11-06 04:54:04 UTC
774686,mainnet,244,105408000,105451600,43601,42054,1547,0.035480837595467996,2021-11-06 04:55:40 UTC
774688,mainnet,244,105408000,105451791,43792,42240,1552,0.03544026306174644,2021-11-06 04:57:08 UTC
774689,mainnet,244,105408000,105451968,43969,42415,1554,0.03534308262639587,2021-11-06 04:58:33 UTC
774691,mainnet,244,105408000,105452159,44160,42601,1559,0.035303442028985506,2021-11-06 05:00:12 UTC
774692,mainnet,244,105408000,105452359,44360,42794,1566,0.03530207394048693,2021-11-06 05:01:43 UTC
774694,mainnet,244,105408000,105452536,44537,42970,1567,0.03518422884343355,2021-11-06 05:03:12 UTC
774695,mainnet,244,105408000,105452714,44715,43145,1570,0.03511126020351112,2021-11-06 05:04:38 UTC
774697,mainnet,244,105408000,105452897,44898,43328,1570,0.034968150028954516,2021-11-06 05:06:03 UTC
774698,mainnet,244,105408000,105453102,45103,43533,1570,0.03480921446466976,2021-11-06 05:07:39 UTC
774700,mainnet,244,105408000,105453279,45280,43708,1572,0.03471731448763251,2021-11-06 05:09:06 UTC
774701,mainnet,244,105408000,105453460,45461,43885,1576,0.03466707727502694,2021-11-06 05:10:33 UTC
774703,mainnet,244,105408000,105453644,45645,44063,1582,0.03465877971300252,2021-11-06 05:12:01 UTC
774704,mainnet,244,105408000,105453832,45833,44246,1587,0.034625706368773594,2021-11-06 05:13:26 UTC
774706,mainnet,244,105408000,105454006,46007,44415,1592,0.03460342991283935,2021-11-06 05:14:51 UTC
774707,mainnet,244,105408000,105454205,46206,44612,1594,0.034497684283426394,2021-11-06 05:16:29 UTC
774709,mainnet,244,105408000,105454406,46407,44813,1594,0.034348266425323765,2021-11-06 05:18:09 UTC
774710,mainnet,244,105408000,105454615,46616,45009,1607,0.034473142268748924,2021-11-06 05:19:44 UTC
774712,mainnet,244,105408000,105454790,46791,45183,1608,0.03436558312495993,2021-11-06 05:21:13 UTC
774713,mainnet,244,105408000,105454971,46972,45355,1617,0.03442476368900622,2021-11-06 05:22:37 UTC
774715,mainnet,244,105408000,105455195,47196,45574,1622,0.034367319264344436,2021-11-06 05:24:23 UTC
774716,mainnet,244,105408000,105455378,47379,45756,1623,0.03425568289748623,2021-11-06 05:25:54 UTC
774718,mainnet,244,105408000,105455583,47584,45953,1631,0.03427622730329523,2021-11-06 05:27:31 UTC
774719,mainnet,244,105408000,105455778,47779,46146,1633,0.03417819544151196,2021-11-06 05:29:07 UTC
774721,mainnet,244,105408000,105455960,47961,46324,1637,0.034131898834469675,2021-11-06 05:30:35 UTC
774722,mainnet,244,105408000,105456120,48121,46467,1654,0.03437168803640822,2021-11-06 05:32:01 UTC
774724,mainnet,244,105408000,105456306,48307,46640,1667,0.03450845633138055,2021-11-06 05:33:27 UTC
774725,mainnet,244,105408000,105456457,48458,46780,1678,0.03462792521358703,2021-11-06 05:34:52 UTC
774727,mainnet,244,105408000,105456625,48626,46941,1685,0.034652243655657465,2021-11-06 05:36:17 UTC
774728,mainnet,244,105408000,105456776,48777,47091,1686,0.034565471431207334,2021-11-06 05:37:43 UTC
774730,mainnet,244,105408000,105456962,48963,47252,1711,0.03494475420215264,2021-11-06 05:39:11 UTC
774731,mainnet,244,105408000,105457130,49131,47411,1720,0.03500844680547923,2021-11-06 05:40:37 UTC
774733,mainnet,244,105408000,105457307,49308,47584,1724,0.03496390038127687,2021-11-06 05:42:02 UTC
774734,mainnet,244,105408000,105457486,49487,47759,1728,0.034918261361569704,2021-11-06 05:43:28 UTC
774736,mainnet,244,105408000,105457653,49654,47915,1739,0.03502235469448584,2021-11-06 05:44:50 UTC
774737,mainnet,244,105408000,105457843,49844,48104,1740,0.03490891581735013,2021-11-06 05:46:29 UTC
774739,mainnet,244,105408000,105458041,50042,48286,1756,0.03509052395987371,2021-11-06 05:47:56 UTC
774740,mainnet,244,105408000,105458226,50227,48465,1762,0.03508073347004599,2021-11-06 05:49:31 UTC
774742,mainnet,244,105408000,105458410,50411,48640,1771,0.03513122136041737,2021-11-06 05:50:55 UTC
774743,mainnet,244,105408000,105458624,50625,48849,1776,0.035081481481481484,2021-11-06 05:52:41 UTC
774745,mainnet,244,105408000,105458814,50815,49039,1776,0.03495030994785005,2021-11-06 05:54:09 UTC
774746,mainnet,244,105408000,105458992,50993,49213,1780,0.03490675190712451,2021-11-06 05:55:36 UTC
774748,mainnet,244,105408000,105459163,51164,49379,1785,0.03488781174263154,2021-11-06 05:57:03 UTC
774749,mainnet,244,105408000,105459336,51337,49537,1800,0.03506243060560609,2021-11-06 05:58:27 UTC
774751,mainnet,244,105408000,105459505,51506,49697,1809,0.03512212169455986,2021-11-06 05:59:53 UTC
774752,mainnet,244,105408000,105459701,51702,49878,1824,0.03527909945456655,2021-11-06 06:01:29 UTC
774754,mainnet,244,105408000,105459904,51905,50072,1833,0.03531451690588575,2021-11-06 06:03:06 UTC
774755,mainnet,244,105408000,105460086,52087,50249,1838,0.035287115787048594,2021-11-06 06:04:42 UTC
774757,mainnet,244,105408000,105460285,52286,50443,1843,0.035248441265348276,2021-11-06 06:06:07 UTC
774758,mainnet,244,105408000,105460454,52455,50607,1848,0.035230197311981695,2021-11-06 06:07:33 UTC
774760,mainnet,244,105408000,105460647,52648,50795,1853,0.03519601884212126,2021-11-06 06:09:21 UTC
774762,mainnet,244,105408000,105460882,52883,51016,1867,0.035304351114724956,2021-11-06 06:10:57 UTC
774763,mainnet,244,105408000,105461069,53070,51195,1875,0.035330695308083665,2021-11-06 06:12:28 UTC
774765,mainnet,244,105408000,105461254,53255,51379,1876,0.03522673927330767,2021-11-06 06:13:54 UTC
774766,mainnet,244,105408000,105461428,53429,51549,1880,0.03518688352767224,2021-11-06 06:15:19 UTC
774768,mainnet,244,105408000,105461616,53617,51737,1880,0.03506350597758174,2021-11-06 06:16:49 UTC
774769,mainnet,244,105408000,105461806,53807,51927,1880,0.03493969186165369,2021-11-06 06:18:17 UTC
774770,mainnet,244,105408000,105461978,53979,52092,1887,0.03495803923748124,2021-11-06 06:19:42 UTC
774772,mainnet,244,105408000,105462162,54163,52274,1889,0.03487620700478186,2021-11-06 06:21:11 UTC
774773,mainnet,244,105408000,105462342,54343,52449,1894,0.034852694919308834,2021-11-06 06:22:39 UTC
774775,mainnet,244,105408000,105462546,54547,52643,1904,0.03490567767246595,2021-11-06 06:24:15 UTC
774777,mainnet,244,105408000,105462739,54740,52830,1910,0.034892217756667884,2021-11-06 06:25:53 UTC
774778,mainnet,244,105408000,105462918,54919,53004,1915,0.034869535133560337,2021-11-06 06:27:20 UTC
774780,mainnet,244,105408000,105463104,55105,53190,1915,0.034751837401324745,2021-11-06 06:28:57 UTC
774781,mainnet,244,105408000,105463280,55281,53360,1921,0.03474973318138239,2021-11-06 06:30:27 UTC
774783,mainnet,244,105408000,105463472,55473,53543,1930,0.0347917004668938,2021-11-06 06:31:54 UTC
774784,mainnet,244,105408000,105463643,55644,53714,1930,0.03468478182733089,2021-11-06 06:33:20 UTC
774786,mainnet,244,105408000,105463808,55809,53876,1933,0.034635990610833375,2021-11-06 06:34:48 UTC
774787,mainnet,244,105408000,105463980,55981,54043,1938,0.03461888855147282,2021-11-06 06:36:15 UTC
774789,mainnet,244,105408000,105464143,56144,54204,1940,0.034554003989740664,2021-11-06 06:37:40 UTC
774790,mainnet,244,105408000,105464342,56343,54403,1940,0.034431961379408266,2021-11-06 06:39:22 UTC
774792,mainnet,244,105408000,105464534,56535,54590,1945,0.03440346687892456,2021-11-06 06:40:48 UTC
774793,mainnet,244,105408000,105464730,56731,54780,1951,0.034390368581551534,2021-11-06 06:42:23 UTC
774795,mainnet,244,105408000,105464916,56917,54964,1953,0.03431312261714426,2021-11-06 06:43:53 UTC
774796,mainnet,244,105408000,105465106,57107,55150,1957,0.03426900379988443,2021-11-06 06:45:25 UTC
774798,mainnet,244,105408000,105465294,57295,55334,1961,0.034226372283794396,2021-11-06 06:46:53 UTC
774799,mainnet,244,105408000,105465475,57476,55506,1970,0.03427517572552022,2021-11-06 06:48:22 UTC
774801,mainnet,244,105408000,105465640,57641,55661,1980,0.034350549088322545,2021-11-06 06:49:57 UTC
774802,mainnet,244,105408000,105465845,57846,55861,1985,0.03431525083843308,2021-11-06 06:51:25 UTC
774804,mainnet,244,105408000,105466022,58023,56034,1989,0.03427950984954242,2021-11-06 06:52:54 UTC
774805,mainnet,244,105408000,105466240,58241,56242,1999,0.034322899675486344,2021-11-06 06:54:32 UTC
774807,mainnet,244,105408000,105466442,58443,56440,2003,0.03427271016203823,2021-11-06 06:56:08 UTC
774808,mainnet,244,105408000,105466724,58725,56717,2008,0.034193273733503615,2021-11-06 06:58:26 UTC
774810,mainnet,244,105408000,105466901,58902,56890,2012,0.03415843265084378,2021-11-06 07:00:01 UTC
774811,mainnet,244,105408000,105467107,59108,57091,2017,0.03412397644988834,2021-11-06 07:01:34 UTC
774813,mainnet,244,105408000,105467322,59323,57300,2023,0.03410144463361597,2021-11-06 07:03:12 UTC
774814,mainnet,244,105408000,105467506,59507,57484,2023,0.03399600047053288,2021-11-06 07:04:40 UTC
774816,mainnet,244,105408000,105467686,59687,57662,2025,0.03392698577579707,2021-11-06 07:06:10 UTC
774818,mainnet,244,105408000,105467908,59909,57882,2027,0.03383464921798061,2021-11-06 07:07:59 UTC
774819,mainnet,244,105408000,105468111,60112,58079,2033,0.03382020228906042,2021-11-06 07:09:39 UTC
774821,mainnet,244,105408000,105468302,60303,58265,2038,0.033795996882410494,2021-11-06 07:11:10 UTC
774822,mainnet,244,105408000,105468503,60504,58462,2042,0.03374983472167129,2021-11-06 07:12:52 UTC
774824,mainnet,244,105408000,105468681,60682,58634,2048,0.03374971161135098,2021-11-06 07:14:21 UTC
774825,mainnet,244,105408000,105468896,60897,58840,2057,0.033778347045010426,2021-11-06 07:16:05 UTC
774827,mainnet,244,105408000,105469082,61083,59022,2061,0.03374097539413585,2021-11-06 07:17:36 UTC
774828,mainnet,244,105408000,105469249,61250,59188,2062,0.03366530612244898,2021-11-06 07:19:16 UTC
774830,mainnet,244,105408000,105469487,61488,59409,2079,0.03381147540983607,2021-11-06 07:20:59 UTC
774831,mainnet,244,105408000,105469665,61666,59584,2082,0.03376252716245581,2021-11-06 07:22:31 UTC
774833,mainnet,244,105408000,105469884,61885,59794,2091,0.03378847862971641,2021-11-06 07:24:14 UTC
774834,mainnet,244,105408000,105470077,62078,59983,2095,0.03374786558845324,2021-11-06 07:25:46 UTC
774836,mainnet,244,105408000,105470242,62243,60135,2108,0.03386726218209277,2021-11-06 07:27:12 UTC
774837,mainnet,244,105408000,105470411,62412,60295,2117,0.03391975902070115,2021-11-06 07:28:39 UTC
774839,mainnet,244,105408000,105470585,62586,60456,2130,0.03403317035758796,2021-11-06 07:30:07 UTC
774840,mainnet,244,105408000,105470762,62763,60625,2138,0.03406465592785558,2021-11-06 07:31:36 UTC
774842,mainnet,244,105408000,105470934,62935,60792,2143,0.03405100500516406,2021-11-06 07:33:03 UTC
774843,mainnet,244,105408000,105471104,63105,60953,2152,0.034101893669281354,2021-11-06 07:34:28 UTC
774845,mainnet,244,105408000,105471287,63288,61127,2161,0.03414549361648338,2021-11-06 07:35:55 UTC
774846,mainnet,244,105408000,105471459,63460,61286,2174,0.034257800189095494,2021-11-06 07:37:23 UTC
774848,mainnet,244,105408000,105471668,63669,61485,2184,0.03430240776516044,2021-11-06 07:39:04 UTC
774849,mainnet,244,105408000,105471854,63855,61659,2196,0.03439041578576462,2021-11-06 07:40:33 UTC
774851,mainnet,244,105408000,105472038,64039,61830,2209,0.034494604850169426,2021-11-06 07:42:00 UTC
774852,mainnet,244,105408000,105472217,64218,62009,2209,0.03439845526176461,2021-11-06 07:43:27 UTC
774854,mainnet,244,105408000,105472386,64387,62177,2210,0.034323698883314956,2021-11-06 07:44:56 UTC
774855,mainnet,244,105408000,105472576,64577,62357,2220,0.03437756476764173,2021-11-06 07:46:25 UTC
774857,mainnet,244,105408000,105472788,64789,62560,2229,0.034403988331352546,2021-11-06 07:48:06 UTC
774858,mainnet,244,105408000,105472964,64965,62729,2236,0.034418533056261066,2021-11-06 07:49:35 UTC
774860,mainnet,244,105408000,105473142,65143,62907,2236,0.03432448613051287,2021-11-06 07:51:06 UTC
774861,mainnet,244,105408000,105473339,65340,63093,2247,0.03438934802571166,2021-11-06 07:52:41 UTC
774863,mainnet,244,105408000,105473521,65522,63263,2259,0.03447696956747352,2021-11-06 07:54:10 UTC
774864,mainnet,244,105408000,105473725,65726,63459,2267,0.03449167757052004,2021-11-06 07:55:52 UTC
774866,mainnet,244,105408000,105473929,65930,63654,2276,0.03452146215683301,2021-11-06 07:57:29 UTC
774867,mainnet,244,105408000,105474112,66113,63828,2285,0.03456203772329194,2021-11-06 07:59:08 UTC
774869,mainnet,244,105408000,105474346,66347,64048,2299,0.034651152275159386,2021-11-06 08:01:04 UTC
774870,mainnet,244,105408000,105474505,66506,64207,2299,0.03456830962619914,2021-11-06 08:02:30 UTC
774872,mainnet,244,105408000,105474724,66725,64410,2315,0.03469464218808543,2021-11-06 08:04:05 UTC
774873,mainnet,244,105408000,105474906,66907,64582,2325,0.03474972723332387,2021-11-06 08:05:32 UTC
774875,mainnet,244,105408000,105475077,67078,64748,2330,0.03473568084916068,2021-11-06 08:07:01 UTC
774876,mainnet,244,105408000,105475252,67253,64904,2349,0.034927809911825494,2021-11-06 08:08:26 UTC
774878,mainnet,244,105408000,105475432,67433,65068,2365,0.035071849094656916,2021-11-06 08:09:54 UTC
774879,mainnet,244,105408000,105475620,67621,65250,2371,0.03506307212256547,2021-11-06 08:11:24 UTC
774881,mainnet,244,105408000,105475792,67793,65419,2374,0.03501836472792176,2021-11-06 08:12:50 UTC
774882,mainnet,244,105408000,105475997,67998,65622,2376,0.034942204182475955,2021-11-06 08:14:27 UTC
774884,mainnet,244,105408000,105476206,68207,65822,2385,0.03496708548975912,2021-11-06 08:16:05 UTC
774885,mainnet,244,105408000,105476394,68395,66006,2389,0.03492945390744937,2021-11-06 08:17:48 UTC
774887,mainnet,244,105408000,105476610,68611,66207,2404,0.035038113422046026,2021-11-06 08:19:28 UTC
774888,mainnet,244,105408000,105476802,68803,66392,2411,0.03504207665363429,2021-11-06 08:21:00 UTC
774890,mainnet,244,105408000,105476986,68987,66574,2413,0.03497760447620566,2021-11-06 08:22:32 UTC
774891,mainnet,244,105408000,105477178,69179,66762,2417,0.03493834834270516,2021-11-06 08:24:02 UTC
774893,mainnet,244,105408000,105477372,69373,66948,2425,0.03495596269442002,2021-11-06 08:25:31 UTC
774894,mainnet,244,105408000,105477543,69544,67115,2429,0.03492752789600828,2021-11-06 08:26:57 UTC
774896,mainnet,244,105408000,105477714,69715,67280,2435,0.0349279208204834,2021-11-06 08:28:23 UTC
774898,mainnet,244,105408000,105477959,69960,67520,2440,0.03487707261292167,2021-11-06 08:30:33 UTC
774899,mainnet,244,105408000,105478178,70179,67730,2449,0.03489647900369056,2021-11-06 08:32:09 UTC
774901,mainnet,244,105408000,105478356,70357,67908,2449,0.03480819250394417,2021-11-06 08:33:36 UTC
774902,mainnet,244,105408000,105478544,70545,68094,2451,0.034743780565596426,2021-11-06 08:35:12 UTC
774904,mainnet,244,105408000,105478738,70739,68284,2455,0.034705042480102914,2021-11-06 08:36:41 UTC
774905,mainnet,244,105408000,105478946,70947,68490,2457,0.03463148547507294,2021-11-06 08:38:22 UTC
774907,mainnet,244,105408000,105479112,71113,68651,2462,0.034620955380872696,2021-11-06 08:39:48 UTC
774908,mainnet,244,105408000,105479281,71282,68817,2465,0.03458096013018715,2021-11-06 08:41:13 UTC
774910,mainnet,244,105408000,105479446,71447,68982,2465,0.034501098716531134,2021-11-06 08:42:40 UTC
774911,mainnet,244,105408000,105479628,71629,69157,2472,0.03451116168032501,2021-11-06 08:44:08 UTC
774913,mainnet,244,105408000,105479816,71817,69336,2481,0.03454613810100673,2021-11-06 08:45:35 UTC
774914,mainnet,244,105408000,105479991,71992,69508,2484,0.03450383375930659,2021-11-06 08:47:03 UTC
774916,mainnet,244,105408000,105480176,72177,69687,2490,0.03449852446070078,2021-11-06 08:48:38 UTC
774917,mainnet,244,105408000,105480385,72386,69892,2494,0.034454176221921366,2021-11-06 08:50:17 UTC
774919,mainnet,244,105408000,105480580,72581,70082,2499,0.0344304983397859,2021-11-06 08:51:55 UTC
774920,mainnet,244,105408000,105480752,72753,70243,2510,0.034500295520459634,2021-11-06 08:53:33 UTC
774922,mainnet,244,105408000,105480931,72932,70405,2527,0.03464871387045467,2021-11-06 08:54:56 UTC
774923,mainnet,244,105408000,105481131,73132,70599,2533,0.03463600065634743,2021-11-06 08:56:37 UTC
774925,mainnet,244,105408000,105481315,73316,70781,2535,0.03457635441104261,2021-11-06 08:58:06 UTC
774926,mainnet,244,105408000,105481522,73523,70982,2541,0.03456061368551338,2021-11-06 08:59:43 UTC
774928,mainnet,244,105408000,105481711,73712,71165,2547,0.034553397004558284,2021-11-06 09:01:18 UTC
774929,mainnet,244,105408000,105481898,73899,71336,2563,0.03468247202262548,2021-11-06 09:02:50 UTC
774931,mainnet,244,105408000,105482072,74073,71506,2567,0.03465500249753621,2021-11-06 09:04:16 UTC
774932,mainnet,244,105408000,105482240,74241,71670,2571,0.034630460257809026,2021-11-06 09:05:44 UTC
774934,mainnet,244,105408000,105482424,74425,71838,2587,0.034759825327510915,2021-11-06 09:07:11 UTC
774935,mainnet,244,105408000,105482630,74631,72028,2603,0.03487826774396698,2021-11-06 09:08:47 UTC
774937,mainnet,244,105408000,105482792,74793,72179,2614,0.03494979476688995,2021-11-06 09:10:18 UTC
774938,mainnet,244,105408000,105482999,75000,72369,2631,0.03508,2021-11-06 09:11:50 UTC
774940,mainnet,244,105408000,105483180,75181,72534,2647,0.03520836381532568,2021-11-06 09:13:18 UTC
774941,mainnet,244,105408000,105483380,75381,72733,2648,0.035128215332776165,2021-11-06 09:15:07 UTC
774943,mainnet,244,105408000,105483597,75598,72942,2656,0.0351332045821318,2021-11-06 09:16:45 UTC
774945,mainnet,244,105408000,105483796,75797,73139,2658,0.035067350950565325,2021-11-06 09:18:21 UTC
774946,mainnet,244,105408000,105483978,75979,73321,2658,0.03498335066268311,2021-11-06 09:19:48 UTC
774948,mainnet,244,105408000,105484169,76170,73512,2658,0.03489562820007877,2021-11-06 09:21:21 UTC
774949,mainnet,244,105408000,105484348,76349,73678,2671,0.034984086235576105,2021-11-06 09:22:46 UTC
774950,mainnet,244,105408000,105484532,76533,73857,2676,0.03496530908235663,2021-11-06 09:24:13 UTC
774952,mainnet,244,105408000,105484715,76716,74039,2677,0.03489493717086396,2021-11-06 09:25:40 UTC
774953,mainnet,244,105408000,105484920,76921,74235,2686,0.03491894281145591,2021-11-06 09:27:18 UTC
774954,mainnet,244,105408000,105485100,77101,74407,2694,0.03494118104823543,2021-11-06 09:28:45 UTC
774956,mainnet,244,105408000,105485340,77341,74646,2695,0.03484568340207652,2021-11-06 09:30:36 UTC
774958,mainnet,244,105408000,105485526,77527,74828,2699,0.03481367781547074,2021-11-06 09:32:11 UTC
774959,mainnet,244,105408000,105485745,77746,75043,2703,0.03476706197103388,2021-11-06 09:33:57 UTC
774961,mainnet,244,105408000,105485976,77977,75269,2708,0.0347281890813958,2021-11-06 09:35:37 UTC
774962,mainnet,244,105408000,105486156,78157,75446,2711,0.034686592371764524,2021-11-06 09:37:04 UTC
774964,mainnet,244,105408000,105486388,78389,75678,2711,0.03458393397032747,2021-11-06 09:38:54 UTC
774965,mainnet,244,105408000,105486592,78593,75879,2714,0.0345323374855267,2021-11-06 09:40:32 UTC
774967,mainnet,244,105408000,105486772,78773,76045,2728,0.03463115534510556,2021-11-06 09:41:57 UTC
774968,mainnet,244,105408000,105486958,78959,76221,2738,0.03467622436960954,2021-11-06 09:43:25 UTC
774970,mainnet,244,105408000,105487128,79129,76388,2741,0.03463963907037875,2021-11-06 09:44:52 UTC
774971,mainnet,244,105408000,105487321,79322,76580,2742,0.034567963490582686,2021-11-06 09:46:40 UTC
774973,mainnet,244,105408000,105487554,79555,76812,2743,0.03447929105650179,2021-11-06 09:48:22 UTC
774974,mainnet,244,105408000,105487736,79737,76989,2748,0.03446329809247903,2021-11-06 09:49:52 UTC
774976,mainnet,244,105408000,105487936,79937,77184,2753,0.03443962120169634,2021-11-06 09:51:33 UTC
774977,mainnet,244,105408000,105488125,80126,77367,2759,0.03443326760352445,2021-11-06 09:53:05 UTC
774979,mainnet,244,105408000,105488304,80305,77544,2761,0.034381420833073904,2021-11-06 09:54:35 UTC
774980,mainnet,244,105408000,105488534,80535,77766,2769,0.03438256658595642,2021-11-06 09:56:24 UTC
774982,mainnet,244,105408000,105488735,80736,77958,2778,0.034408442330558855,2021-11-06 09:58:00 UTC
774983,mainnet,244,105408000,105488913,80914,78127,2787,0.034443977556417926,2021-11-06 09:59:36 UTC
774985,mainnet,244,105408000,105489101,81102,78315,2787,0.03436413405341422,2021-11-06 10:01:10 UTC
774986,mainnet,244,105408000,105489269,81270,78476,2794,0.03437922972806694,2021-11-06 10:02:38 UTC
774988,mainnet,244,105408000,105489458,81459,78659,2800,0.03437312021998797,2021-11-06 10:04:13 UTC
774989,mainnet,244,105408000,105489666,81667,78867,2800,0.03428557434459451,2021-11-06 10:05:50 UTC
774991,mainnet,244,105408000,105489847,81848,79042,2806,0.03428306128433193,2021-11-06 10:07:17 UTC
774992,mainnet,244,105408000,105489999,82000,79190,2810,0.03426829268292683,2021-11-06 10:08:44 UTC
774994,mainnet,244,105408000,105490201,82202,79375,2827,0.03439089073258558,2021-11-06 10:10:16 UTC
774995,mainnet,244,105408000,105490405,82406,79569,2837,0.03442710482246438,2021-11-06 10:11:56 UTC
774997,mainnet,244,105408000,105490612,82613,79764,2849,0.034486097829639406,2021-11-06 10:13:32 UTC
774998,mainnet,244,105408000,105490792,82793,79941,2852,0.03444735666058725,2021-11-06 10:14:58 UTC
775000,mainnet,244,105408000,105491002,83003,80145,2858,0.034432490391913546,2021-11-06 10:16:38 UTC
775001,mainnet,244,105408000,105491210,83211,80345,2866,0.034442561680547046,2021-11-06 10:18:17 UTC
775003,mainnet,244,105408000,105491412,83413,80546,2867,0.03437114118902329,2021-11-06 10:19:54 UTC
775004,mainnet,244,105408000,105491608,83609,80737,2872,0.03435036897941609,2021-11-06 10:21:26 UTC
775006,mainnet,244,105408000,105491802,83803,80931,2872,0.03427084949226161,2021-11-06 10:23:00 UTC
775007,mainnet,244,105408000,105491967,83968,81095,2873,0.034215415396341466,2021-11-06 10:24:28 UTC
775009,mainnet,244,105408000,105492149,84150,81260,2890,0.03434343434343434,2021-11-06 10:25:55 UTC
775010,mainnet,244,105408000,105492348,84349,81456,2893,0.03429797626527878,2021-11-06 10:27:32 UTC
775012,mainnet,244,105408000,105492517,84518,81620,2898,0.03428855391750869,2021-11-06 10:28:59 UTC
775013,mainnet,244,105408000,105492686,84687,81785,2902,0.034267360988109154,2021-11-06 10:30:29 UTC
775015,mainnet,244,105408000,105492865,84866,81956,2910,0.034289350269837156,2021-11-06 10:31:55 UTC
775016,mainnet,244,105408000,105493042,85043,82129,2914,0.034265018872805524,2021-11-06 10:33:24 UTC
775018,mainnet,244,105408000,105493199,85200,82283,2917,0.034237089201877936,2021-11-06 10:34:49 UTC
775019,mainnet,244,105408000,105493386,85387,82453,2934,0.03436120252497453,2021-11-06 10:36:17 UTC
775021,mainnet,244,105408000,105493587,85588,82651,2937,0.034315558255830256,2021-11-06 10:37:55 UTC
775022,mainnet,244,105408000,105493780,85781,82837,2944,0.03431995430223476,2021-11-06 10:39:35 UTC
775024,mainnet,244,105408000,105493934,85935,82991,2944,0.034258451154942686,2021-11-06 10:40:57 UTC
775025,mainnet,244,105408000,105494116,86117,83153,2964,0.03441829139426594,2021-11-06 10:42:25 UTC
775027,mainnet,244,105408000,105494300,86301,83328,2973,0.03444919525845587,2021-11-06 10:43:57 UTC
775028,mainnet,244,105408000,105494472,86473,83477,2996,0.03464665271240734,2021-11-06 10:45:29 UTC
775030,mainnet,244,105408000,105494648,86649,83640,3009,0.034726309593878756,2021-11-06 10:47:01 UTC
775031,mainnet,244,105408000,105494816,86817,83808,3009,0.03465911054286603,2021-11-06 10:48:31 UTC
775033,mainnet,244,105408000,105495009,87010,83990,3020,0.03470865417768073,2021-11-06 10:50:02 UTC
775034,mainnet,244,105408000,105495191,87192,84171,3021,0.03464767409854115,2021-11-06 10:51:34 UTC
775036,mainnet,244,105408000,105495366,87367,84340,3027,0.03464694907688257,2021-11-06 10:53:03 UTC
775037,mainnet,244,105408000,105495545,87546,84504,3042,0.03474744705640463,2021-11-06 10:54:40 UTC
775039,mainnet,244,105408000,105495722,87723,84657,3066,0.03495092507096201,2021-11-06 10:56:10 UTC
775040,mainnet,244,105408000,105495908,87909,84834,3075,0.03497935364979695,2021-11-06 10:57:36 UTC
775042,mainnet,244,105408000,105496136,88137,85051,3086,0.035013671897160106,2021-11-06 10:59:33 UTC
775043,mainnet,244,105408000,105496337,88338,85247,3091,0.034990604269963095,2021-11-06 11:01:13 UTC
775045,mainnet,244,105408000,105496514,88515,85416,3099,0.035011015082189456,2021-11-06 11:02:43 UTC
775046,mainnet,244,105408000,105496691,88692,85584,3108,0.035042619401975374,2021-11-06 11:04:20 UTC
775048,mainnet,244,105408000,105496911,88912,85791,3121,0.03510212344790355,2021-11-06 11:06:17 UTC
775050,mainnet,244,105408000,105497104,89105,85969,3136,0.03519443353347175,2021-11-06 11:07:52 UTC
775051,mainnet,244,105408000,105497365,89366,86207,3159,0.035349014166461516,2021-11-06 11:09:58 UTC
775053,mainnet,244,105408000,105497569,89570,86407,3163,0.035313162889360275,2021-11-06 11:11:35 UTC
775054,mainnet,244,105408000,105497737,89738,86574,3164,0.03525819608192739,2021-11-06 11:13:01 UTC
775056,mainnet,244,105408000,105497925,89926,86752,3174,0.035295687565331496,2021-11-06 11:14:33 UTC
775057,mainnet,244,105408000,105498104,90105,86927,3178,0.0352699628211531,2021-11-06 11:16:02 UTC
775059,mainnet,244,105408000,105498338,90339,87148,3191,0.03532250744418247,2021-11-06 11:17:52 UTC
775060,mainnet,244,105408000,105498529,90530,87335,3195,0.035292168341986084,2021-11-06 11:19:22 UTC
775062,mainnet,244,105408000,105498731,90732,87525,3207,0.0353458537230525,2021-11-06 11:21:06 UTC
775063,mainnet,244,105408000,105498916,90917,87706,3211,0.035317927340321395,2021-11-06 11:22:46 UTC
775065,mainnet,244,105408000,105499096,91097,87880,3217,0.035314005949701965,2021-11-06 11:24:14 UTC
775066,mainnet,244,105408000,105499294,91295,88075,3220,0.03527027767128539,2021-11-06 11:25:55 UTC
775068,mainnet,244,105408000,105499478,91479,88250,3229,0.03529771860208354,2021-11-06 11:27:26 UTC
775069,mainnet,244,105408000,105499666,91667,88425,3242,0.03536714411947593,2021-11-06 11:28:56 UTC
775071,mainnet,244,105408000,105499848,91849,88600,3249,0.03537327570251173,2021-11-06 11:30:29 UTC
775072,mainnet,244,105408000,105500030,92031,88769,3262,0.035444578457258964,2021-11-06 11:31:57 UTC
775074,mainnet,244,105408000,105500221,92222,88958,3264,0.0353928563683286,2021-11-06 11:33:29 UTC
775075,mainnet,244,105408000,105500418,92419,89149,3270,0.03538233480128545,2021-11-06 11:35:06 UTC
775076,mainnet,244,105408000,105500596,92597,89326,3271,0.03532511852435824,2021-11-06 11:36:34 UTC
775077,mainnet,244,105408000,105500798,92799,89520,3279,0.035334432483108656,2021-11-06 11:38:13 UTC
775079,mainnet,244,105408000,105500965,92966,89681,3285,0.03533549899963428,2021-11-06 11:39:44 UTC
775080,mainnet,244,105408000,105501140,93141,89849,3292,0.03534426299910888,2021-11-06 11:41:20 UTC
775082,mainnet,244,105408000,105501314,93315,90021,3294,0.035299791030380966,2021-11-06 11:42:51 UTC
775083,mainnet,244,105408000,105501479,93480,90174,3306,0.03536585365853658,2021-11-06 11:44:19 UTC
775085,mainnet,244,105408000,105501652,93653,90347,3306,0.035300524275784013,2021-11-06 11:45:46 UTC
775086,mainnet,244,105408000,105501826,93827,90516,3311,0.03528834983533524,2021-11-06 11:47:10 UTC
775088,mainnet,244,105408000,105502002,94003,90692,3311,0.03522228013999553,2021-11-06 11:48:38 UTC
775089,mainnet,244,105408000,105502184,94185,90861,3324,0.03529224398789616,2021-11-06 11:50:08 UTC
775091,mainnet,244,105408000,105502371,94372,91043,3329,0.035275293519264186,2021-11-06 11:51:40 UTC
775092,mainnet,244,105408000,105502578,94579,91248,3331,0.03521923471383711,2021-11-06 11:53:23 UTC
775094,mainnet,244,105408000,105502776,94777,91436,3341,0.035251168532449854,2021-11-06 11:54:56 UTC
775095,mainnet,244,105408000,105502927,94928,91585,3343,0.03521616382942862,2021-11-06 11:56:24 UTC
775097,mainnet,244,105408000,105503124,95125,91766,3359,0.03531143232588699,2021-11-06 11:57:56 UTC
775098,mainnet,244,105408000,105503303,95304,91939,3365,0.03530806681776211,2021-11-06 11:59:22 UTC
775100,mainnet,244,105408000,105503486,95487,92112,3375,0.03534512551446794,2021-11-06 12:00:54 UTC
775101,mainnet,244,105408000,105503652,95653,92269,3384,0.03537787628197756,2021-11-06 12:02:32 UTC
775103,mainnet,244,105408000,105503854,95855,92456,3399,0.03545980908664128,2021-11-06 12:04:10 UTC
775104,mainnet,244,105408000,105504007,96008,92604,3404,0.03545537871844013,2021-11-06 12:05:38 UTC
775106,mainnet,244,105408000,105504191,96192,92770,3422,0.03557468396540253,2021-11-06 12:07:15 UTC
775108,mainnet,244,105408000,105504344,96345,92914,3431,0.035611604130987594,2021-11-06 12:08:43 UTC
775109,mainnet,244,105408000,105504536,96537,93091,3446,0.03569615794980163,2021-11-06 12:10:23 UTC
775111,mainnet,244,105408000,105504794,96795,93329,3466,0.03580763469187458,2021-11-06 12:12:18 UTC
775112,mainnet,244,105408000,105504950,96951,93484,3467,0.0357603325391177,2021-11-06 12:13:42 UTC
775114,mainnet,244,105408000,105505156,97157,93675,3482,0.03583889992486388,2021-11-06 12:15:18 UTC
775115,mainnet,244,105408000,105505314,97315,93816,3499,0.035955402558701124,2021-11-06 12:16:44 UTC
775117,mainnet,244,105408000,105505468,97469,93963,3506,0.0359704111050693,2021-11-06 12:18:10 UTC
775118,mainnet,244,105408000,105505601,97602,94095,3507,0.0359316407450667,2021-11-06 12:19:40 UTC
775120,mainnet,244,105408000,105505800,97801,94269,3532,0.036114150162063784,2021-11-06 12:21:09 UTC
775121,mainnet,244,105408000,105505976,97977,94444,3533,0.03605948334813273,2021-11-06 12:22:34 UTC
775123,mainnet,244,105408000,105506164,98165,94623,3542,0.036082106657158865,2021-11-06 12:24:44 UTC
775125,mainnet,244,105408000,105506441,98442,94877,3565,0.0362142175087869,2021-11-06 12:26:30 UTC
775126,mainnet,244,105408000,105506648,98649,95075,3574,0.036229460004663,2021-11-06 12:28:10 UTC
775128,mainnet,244,105408000,105506836,98837,95258,3579,0.036211135505934015,2021-11-06 12:29:40 UTC
775129,mainnet,244,105408000,105507032,99033,95448,3585,0.036200054527278785,2021-11-06 12:31:27 UTC
775131,mainnet,244,105408000,105507270,99271,95672,3599,0.03625429380181523,2021-11-06 12:33:25 UTC
775132,mainnet,244,105408000,105507466,99467,95855,3612,0.036313551228045485,2021-11-06 12:34:54 UTC
775134,mainnet,244,105408000,105507636,99637,96013,3624,0.03637203047060831,2021-11-06 12:36:20 UTC
775135,mainnet,244,105408000,105507809,99810,96186,3624,0.03630898707544334,2021-11-06 12:38:00 UTC
775137,mainnet,244,105408000,105508008,100009,96369,3640,0.036396724294813464,2021-11-06 12:39:28 UTC
775138,mainnet,244,105408000,105508187,100188,96536,3652,0.03645147123407993,2021-11-06 12:40:55 UTC
775140,mainnet,244,105408000,105508366,100367,96706,3661,0.03647613259338229,2021-11-06 12:42:24 UTC
775141,mainnet,244,105408000,105508553,100554,96889,3665,0.03644807764982,2021-11-06 12:43:51 UTC
775143,mainnet,244,105408000,105508724,100725,97058,3667,0.036406056093323404,2021-11-06 12:45:18 UTC
775144,mainnet,244,105408000,105508926,100927,97254,3673,0.0363926402251132,2021-11-06 12:46:57 UTC
775146,mainnet,244,105408000,105509121,101122,97437,3685,0.0364411305156148,2021-11-06 12:48:25 UTC
775147,mainnet,244,105408000,105509297,101298,97612,3686,0.03638768781219767,2021-11-06 12:49:55 UTC
775149,mainnet,244,105408000,105509478,101479,97786,3693,0.03639176578405384,2021-11-06 12:51:23 UTC
775150,mainnet,244,105408000,105509662,101663,97966,3697,0.03636524595969035,2021-11-06 12:52:49 UTC
775152,mainnet,244,105408000,105509848,101849,98152,3697,0.03629883454918556,2021-11-06 12:54:18 UTC
775153,mainnet,244,105408000,105510032,102033,98332,3701,0.03627257847951153,2021-11-06 12:55:45 UTC
775155,mainnet,244,105408000,105510218,102219,98509,3710,0.036294622330486505,2021-11-06 12:57:30 UTC
775156,mainnet,244,105408000,105510446,102447,98735,3712,0.03623336944956904,2021-11-06 12:59:13 UTC
775158,mainnet,244,105408000,105510620,102621,98902,3719,0.03624014577912903,2021-11-06 13:00:49 UTC
775159,mainnet,244,105408000,105510818,102819,99079,3740,0.036374600025287154,2021-11-06 13:02:27 UTC
775161,mainnet,244,105408000,105511019,103020,99272,3748,0.036381285187342266,2021-11-06 13:04:06 UTC
775162,mainnet,244,105408000,105511203,103204,99447,3757,0.036403627766365645,2021-11-06 13:05:40 UTC
775164,mainnet,244,105408000,105511406,103407,99630,3777,0.03652557370390786,2021-11-06 13:07:16 UTC
775165,mainnet,244,105408000,105511594,103595,99817,3778,0.03646894155123317,2021-11-06 13:08:51 UTC
775167,mainnet,244,105408000,105511778,103779,99995,3784,0.036462097341466,2021-11-06 13:10:22 UTC
775168,mainnet,244,105408000,105511973,103974,100187,3787,0.036422567180256604,2021-11-06 13:11:57 UTC
775170,mainnet,244,105408000,105512167,104168,100373,3795,0.03643153367636894,2021-11-06 13:13:33 UTC
775171,mainnet,244,105408000,105512372,104373,100566,3807,0.0364749504182116,2021-11-06 13:15:19 UTC
775173,mainnet,244,105408000,105512581,104582,100769,3813,0.036459428964831425,2021-11-06 13:16:52 UTC
775174,mainnet,244,105408000,105512778,104779,100961,3818,0.03643859933765354,2021-11-06 13:18:24 UTC
775176,mainnet,244,105408000,105512924,104925,101102,3823,0.036435549201810816,2021-11-06 13:20:01 UTC
775177,mainnet,244,105408000,105513174,105175,101334,3841,0.03652008557166627,2021-11-06 13:21:37 UTC
775179,mainnet,244,105408000,105513356,105357,101502,3855,0.03658988012187135,2021-11-06 13:23:13 UTC
775180,mainnet,244,105408000,105513530,105531,101674,3857,0.03654850233580654,2021-11-06 13:24:44 UTC
775182,mainnet,244,105408000,105513718,105719,101849,3870,0.03660647565716664,2021-11-06 13:26:13 UTC
775183,mainnet,244,105408000,105513933,105934,102055,3879,0.03661713897332301,2021-11-06 13:28:02 UTC
775185,mainnet,244,105408000,105514127,106128,102244,3884,0.03659731644806272,2021-11-06 13:29:41 UTC
775186,mainnet,244,105408000,105514317,106318,102425,3893,0.03661656539814519,2021-11-06 13:31:10 UTC
775188,mainnet,244,105408000,105514502,106503,102609,3894,0.03656235035632799,2021-11-06 13:32:39 UTC
775189,mainnet,244,105408000,105514684,106685,102790,3895,0.0365093499554764,2021-11-06 13:34:06 UTC
775191,mainnet,244,105408000,105514869,106870,102974,3896,0.03645550669037148,2021-11-06 13:35:33 UTC
775192,mainnet,244,105408000,105515066,107067,103161,3906,0.0364818291350276,2021-11-06 13:37:31 UTC
775194,mainnet,244,105408000,105515316,107317,103403,3914,0.03647138850321943,2021-11-06 13:39:18 UTC
775195,mainnet,244,105408000,105515532,107533,103612,3921,0.0364632252424837,2021-11-06 13:40:50 UTC
775197,mainnet,244,105408000,105515710,107711,103788,3923,0.036421535404926146,2021-11-06 13:42:21 UTC
775198,mainnet,244,105408000,105515902,107903,103971,3932,0.03644013604811729,2021-11-06 13:43:50 UTC
775200,mainnet,244,105408000,105516079,108080,104144,3936,0.036417468541820874,2021-11-06 13:45:16 UTC
775201,mainnet,244,105408000,105516277,108278,104330,3948,0.036461700437762055,2021-11-06 13:47:04 UTC
775203,mainnet,244,105408000,105516520,108521,104568,3953,0.03642612950488845,2021-11-06 13:48:51 UTC
775204,mainnet,244,105408000,105516740,108741,104780,3961,0.03642600307151856,2021-11-06 13:50:35 UTC
775206,mainnet,244,105408000,105516916,108917,104947,3970,0.03644977368087626,2021-11-06 13:52:01 UTC
775208,mainnet,244,105408000,105517182,109183,105207,3976,0.03641592555617633,2021-11-06 13:54:31 UTC
775209,mainnet,244,105408000,105517426,109427,105439,3988,0.036444387582589305,2021-11-06 13:56:18 UTC
775211,mainnet,244,105408000,105517582,109583,105591,3992,0.03642900814907422,2021-11-06 13:57:51 UTC
775212,mainnet,244,105408000,105517767,109768,105765,4003,0.03646782304496757,2021-11-06 13:59:32 UTC
775214,mainnet,244,105408000,105517949,109950,105938,4012,0.03648931332423829,2021-11-06 14:01:03 UTC
775215,mainnet,244,105408000,105518104,110105,106077,4028,0.0365832614322692,2021-11-06 14:02:33 UTC
775217,mainnet,244,105408000,105518284,110285,106248,4037,0.03660515935984041,2021-11-06 14:04:01 UTC
775218,mainnet,244,105408000,105518470,110471,106430,4041,0.03657973585827955,2021-11-06 14:05:27 UTC
775220,mainnet,244,105408000,105518643,110644,106599,4045,0.036558692744297024,2021-11-06 14:07:04 UTC
775221,mainnet,244,105408000,105518845,110846,106796,4050,0.036537177706006535,2021-11-06 14:08:32 UTC
775223,mainnet,244,105408000,105519025,111026,106964,4062,0.036586024895069624,2021-11-06 14:10:01 UTC
775224,mainnet,244,105408000,105519210,111211,107148,4063,0.036534155793941245,2021-11-06 14:11:37 UTC
775226,mainnet,244,105408000,105519395,111396,107329,4067,0.03650938992423426,2021-11-06 14:13:04 UTC
775227,mainnet,244,105408000,105519578,111579,107506,4073,0.03650328466826195,2021-11-06 14:14:31 UTC
775229,mainnet,244,105408000,105519756,111757,107675,4082,0.036525676243993666,2021-11-06 14:16:01 UTC
775230,mainnet,244,105408000,105519962,111963,107873,4090,0.03652992506453025,2021-11-06 14:17:38 UTC
775232,mainnet,244,105408000,105520142,112143,108046,4097,0.03653371142202367,2021-11-06 14:19:08 UTC
775234,mainnet,244,105408000,105520339,112340,108243,4097,0.036469645718354995,2021-11-06 14:21:01 UTC
775235,mainnet,244,105408000,105520560,112561,108455,4106,0.03647799859631667,2021-11-06 14:22:35 UTC
775237,mainnet,244,105408000,105520730,112731,108623,4108,0.03644073058874666,2021-11-06 14:24:01 UTC
775238,mainnet,244,105408000,105520912,112913,108805,4108,0.03638199321601587,2021-11-06 14:25:29 UTC
775240,mainnet,244,105408000,105521117,113118,108999,4119,0.03641330292261179,2021-11-06 14:27:10 UTC
775241,mainnet,244,105408000,105521328,113329,109204,4125,0.036398450528990815,2021-11-06 14:28:50 UTC
775243,mainnet,244,105408000,105521548,113549,109424,4125,0.036327928911747354,2021-11-06 14:30:35 UTC
775244,mainnet,244,105408000,105521720,113721,109592,4129,0.03630815768415684,2021-11-06 14:32:03 UTC
775246,mainnet,244,105408000,105521896,113897,109754,4143,0.03637497036796404,2021-11-06 14:33:31 UTC
775247,mainnet,244,105408000,105522090,114091,109945,4146,0.03633941327536791,2021-11-06 14:35:10 UTC
775249,mainnet,244,105408000,105522300,114301,110152,4149,0.036298895022790705,2021-11-06 14:36:48 UTC
775250,mainnet,244,105408000,105522468,114469,110294,4175,0.03647275681625593,2021-11-06 14:38:15 UTC
775252,mainnet,244,105408000,105522619,114620,110435,4185,0.03651195253882394,2021-11-06 14:39:44 UTC
775253,mainnet,244,105408000,105522807,114808,110605,4203,0.036608947111699534,2021-11-06 14:41:13 UTC
775255,mainnet,244,105408000,105522989,114990,110772,4218,0.036681450560918344,2021-11-06 14:42:41 UTC
775256,mainnet,244,105408000,105523165,115166,110948,4218,0.036625392911102235,2021-11-06 14:44:09 UTC
775258,mainnet,244,105408000,105523376,115377,111143,4234,0.036697088674519186,2021-11-06 14:45:46 UTC
775259,mainnet,244,105408000,105523604,115605,111347,4258,0.036832316941308764,2021-11-06 14:47:41 UTC
775261,mainnet,244,105408000,105523894,115895,111624,4271,0.036852323223607576,2021-11-06 14:50:03 UTC
775263,mainnet,244,105408000,105524069,116070,111783,4287,0.03693460842594986,2021-11-06 14:51:33 UTC
775264,mainnet,244,105408000,105524247,116248,111949,4299,0.03698128139838965,2021-11-06 14:52:58 UTC
775266,mainnet,244,105408000,105524424,116425,112123,4302,0.03695082671247584,2021-11-06 14:54:24 UTC
775267,mainnet,244,105408000,105524604,116605,112299,4306,0.03692809056215428,2021-11-06 14:55:57 UTC
775269,mainnet,244,105408000,105524786,116787,112476,4311,0.03691335508232937,2021-11-06 14:57:26 UTC
775270,mainnet,244,105408000,105524968,116969,112648,4321,0.03694141182706529,2021-11-06 14:58:53 UTC
775272,mainnet,244,105408000,105525244,117245,112919,4326,0.03689709582498187,2021-11-06 15:01:07 UTC
775273,mainnet,244,105408000,105525446,117447,113112,4335,0.03691026590717515,2021-11-06 15:02:43 UTC
775275,mainnet,244,105408000,105525630,117631,113292,4339,0.03688653501202914,2021-11-06 15:04:12 UTC
775276,mainnet,244,105408000,105525847,117848,113503,4345,0.03686952684814337,2021-11-06 15:06:11 UTC
775278,mainnet,244,105408000,105526037,118038,113679,4359,0.036928785645300666,2021-11-06 15:07:42 UTC
775279,mainnet,244,105408000,105526231,118232,113864,4368,0.03694431287637864,2021-11-06 15:09:17 UTC
775281,mainnet,244,105408000,105526440,118441,114071,4370,0.03689600729477124,2021-11-06 15:11:06 UTC
775283,mainnet,244,105408000,105526657,118658,114282,4376,0.03687909791164523,2021-11-06 15:12:41 UTC
775284,mainnet,244,105408000,105526914,118915,114529,4386,0.03688348820586133,2021-11-06 15:14:44 UTC
775286,mainnet,244,105408000,105527097,119098,114707,4391,0.036868797125056675,2021-11-06 15:16:15 UTC
775287,mainnet,244,105408000,105527271,119272,114880,4392,0.03682339526460527,2021-11-06 15:17:51 UTC
775289,mainnet,244,105408000,105527496,119497,115095,4402,0.03683774488062462,2021-11-06 15:19:35 UTC
775290,mainnet,244,105408000,105527677,119678,115267,4411,0.03685723357676432,2021-11-06 15:21:04 UTC
775292,mainnet,244,105408000,105527865,119866,115453,4413,0.036816111324312145,2021-11-06 15:22:36 UTC
775293,mainnet,244,105408000,105528037,120038,115616,4422,0.03683833452739966,2021-11-06 15:24:04 UTC
775295,mainnet,244,105408000,105528229,120230,115800,4430,0.03684604508026283,2021-11-06 15:25:35 UTC
775296,mainnet,244,105408000,105528300,120301,115867,4434,0.03685754898130523,2021-11-06 15:27:03 UTC
775298,mainnet,244,105408000,105528533,120534,116080,4454,0.036952229246519655,2021-11-06 15:28:09 UTC
775299,mainnet,244,105408000,105528676,120677,116206,4471,0.037049313456582446,2021-11-06 15:29:37 UTC
775301,mainnet,244,105408000,105528854,120855,116366,4489,0.037143684580695877,2021-11-06 15:31:15 UTC
775302,mainnet,244,105408000,105529009,121010,116502,4508,0.03725311957689447,2021-11-06 15:32:43 UTC
775304,mainnet,244,105408000,105529171,121172,116634,4538,0.03745089624665764,2021-11-06 15:34:12 UTC
775305,mainnet,244,105408000,105529340,121341,116796,4545,0.03745642445669642,2021-11-06 15:35:50 UTC
775307,mainnet,244,105408000,105529497,121498,116937,4561,0.037539712587861526,2021-11-06 15:37:17 UTC
775308,mainnet,244,105408000,105529653,121654,117080,4574,0.037598434905551814,2021-11-06 15:38:52 UTC
775310,mainnet,244,105408000,105529852,121853,117255,4598,0.037733990956316216,2021-11-06 15:40:24 UTC
775311,mainnet,244,105408000,105530035,122036,117432,4604,0.03772657248680717,2021-11-06 15:41:54 UTC
775312,mainnet,244,105408000,105530212,122213,117608,4605,0.037680115863287865,2021-11-06 15:43:21 UTC
775314,mainnet,244,105408000,105530392,122393,117776,4617,0.03772274558185517,2021-11-06 15:44:49 UTC
775315,mainnet,244,105408000,105530564,122565,117944,4621,0.037702443601354385,2021-11-06 15:46:20 UTC
775317,mainnet,244,105408000,105530729,122730,118107,4623,0.03766805182107064,2021-11-06 15:47:46 UTC
775318,mainnet,244,105408000,105530909,122910,118278,4632,0.037686111789113984,2021-11-06 15:49:28 UTC
775320,mainnet,244,105408000,105531108,123109,118456,4653,0.03779577447627712,2021-11-06 15:50:57 UTC
775321,mainnet,244,105408000,105531280,123281,118623,4658,0.03778360006813702,2021-11-06 15:52:23 UTC
775323,mainnet,244,105408000,105531466,123467,118809,4658,0.0377266800035637,2021-11-06 15:53:50 UTC
775324,mainnet,244,105408000,105531635,123636,118973,4663,0.037715552104565016,2021-11-06 15:55:17 UTC
775326,mainnet,244,105408000,105531824,123825,119139,4686,0.03784373107207753,2021-11-06 15:56:48 UTC
775327,mainnet,244,105408000,105531962,123963,119265,4698,0.03789840516928438,2021-11-06 15:58:23 UTC
775329,mainnet,244,105408000,105532184,124185,119466,4719,0.03799975842493055,2021-11-06 15:59:53 UTC
775330,mainnet,244,105408000,105532372,124373,119646,4727,0.03800664131282513,2021-11-06 16:01:30 UTC
775332,mainnet,244,105408000,105532556,124557,119828,4729,0.03796655346548167,2021-11-06 16:03:01 UTC
775333,mainnet,244,105408000,105532720,124721,119984,4737,0.037980773085526894,2021-11-06 16:04:44 UTC
775335,mainnet,244,105408000,105532908,124909,120148,4761,0.03811574826473673,2021-11-06 16:06:12 UTC
775336,mainnet,244,105408000,105533086,125087,120324,4763,0.0380774980613493,2021-11-06 16:07:43 UTC
775338,mainnet,244,105408000,105533334,125335,120563,4772,0.03807396178242311,2021-11-06 16:09:51 UTC
775340,mainnet,244,105408000,105533572,125573,120772,4801,0.03823274111473008,2021-11-06 16:11:50 UTC
775341,mainnet,244,105408000,105533737,125738,120923,4815,0.038293912739187835,2021-11-06 16:13:17 UTC
775343,mainnet,244,105408000,105533910,125911,121068,4843,0.03846367672403523,2021-11-06 16:14:42 UTC
775344,mainnet,244,105408000,105534099,126100,121246,4854,0.038493259318001585,2021-11-06 16:16:21 UTC
775346,mainnet,244,105408000,105534289,126290,121427,4863,0.038506611766569006,2021-11-06 16:17:57 UTC
775347,mainnet,244,105408000,105534542,126543,121673,4870,0.038484941877464575,2021-11-06 16:20:06 UTC
775349,mainnet,244,105408000,105534740,126741,121866,4875,0.038464269652283,2021-11-06 16:21:47 UTC
775351,mainnet,244,105408000,105534932,126933,122048,4885,0.03848486997077198,2021-11-06 16:23:16 UTC
775352,mainnet,244,105408000,105535148,127149,122259,4890,0.038458816034730905,2021-11-06 16:25:03 UTC
775354,mainnet,244,105408000,105535356,127357,122457,4900,0.03847452436850742,2021-11-06 16:26:44 UTC
775355,mainnet,244,105408000,105535558,127559,122647,4912,0.03850767096010473,2021-11-06 16:28:16 UTC
775357,mainnet,244,105408000,105535759,127760,122847,4913,0.038454915466499685,2021-11-06 16:29:53 UTC
775358,mainnet,244,105408000,105535924,127925,123011,4914,0.03841313269493844,2021-11-06 16:31:19 UTC
775360,mainnet,244,105408000,105536111,128112,123184,4928,0.038466341950793057,2021-11-06 16:32:49 UTC
775361,mainnet,244,105408000,105536292,128293,123360,4933,0.03845104565330922,2021-11-06 16:34:20 UTC
775363,mainnet,244,105408000,105536474,128475,123539,4936,0.03841992605565285,2021-11-06 16:35:48 UTC
775364,mainnet,244,105408000,105536659,128660,123717,4943,0.03841908907197264,2021-11-06 16:37:18 UTC
775366,mainnet,244,105408000,105536831,128832,123885,4947,0.03839884500745157,2021-11-06 16:38:44 UTC
775367,mainnet,244,105408000,105537018,129019,124059,4960,0.038443950115874405,2021-11-06 16:40:26 UTC
775369,mainnet,244,105408000,105537178,129179,124209,4970,0.03847374573266553,2021-11-06 16:41:55 UTC
775370,mainnet,244,105408000,105537374,129375,124396,4979,0.03848502415458937,2021-11-06 16:43:31 UTC
775372,mainnet,244,105408000,105537552,129553,124565,4988,0.038501617098793545,2021-11-06 16:44:58 UTC
775373,mainnet,244,105408000,105537721,129722,124731,4991,0.03847458411063659,2021-11-06 16:46:37 UTC
775375,mainnet,244,105408000,105537914,129915,124899,5016,0.038609860293268676,2021-11-06 16:48:05 UTC
775376,mainnet,244,105408000,105538087,130088,125068,5020,0.03858926265297337,2021-11-06 16:49:33 UTC
775378,mainnet,244,105408000,105538268,130269,125236,5033,0.038635438976272175,2021-11-06 16:51:02 UTC
775379,mainnet,244,105408000,105538451,130452,125402,5050,0.03871155674117683,2021-11-06 16:52:33 UTC
775381,mainnet,244,105408000,105538659,130660,125609,5051,0.03865758457064136,2021-11-06 16:54:13 UTC
775382,mainnet,244,105408000,105538864,130865,125806,5059,0.03865815917166546,2021-11-06 16:55:47 UTC
775384,mainnet,244,105408000,105539034,131035,125975,5060,0.03861563704353799,2021-11-06 16:57:16 UTC
775385,mainnet,244,105408000,105539213,131214,126141,5073,0.03866203301476977,2021-11-06 16:58:42 UTC
775387,mainnet,244,105408000,105539379,131380,126302,5078,0.03865124067590196,2021-11-06 17:00:11 UTC
775388,mainnet,244,105408000,105539552,131553,126474,5079,0.03860801350026225,2021-11-06 17:01:43 UTC
775390,mainnet,244,105408000,105539726,131727,126633,5094,0.03867088751736546,2021-11-06 17:03:15 UTC
775391,mainnet,244,105408000,105539902,131903,126804,5099,0.038657195060006214,2021-11-06 17:04:42 UTC
775393,mainnet,244,105408000,105540132,132133,127029,5104,0.038627746285939166,2021-11-06 17:06:34 UTC
775394,mainnet,244,105408000,105540341,132342,127233,5109,0.03860452464070363,2021-11-06 17:08:22 UTC
775396,mainnet,244,105408000,105540510,132511,127385,5126,0.038683580985729486,2021-11-06 17:09:49 UTC
775397,mainnet,244,105408000,105540690,132691,127564,5127,0.03863864165617864,2021-11-06 17:11:33 UTC
775399,mainnet,244,105408000,105540855,132856,127711,5145,0.03872613957969531,2021-11-06 17:13:00 UTC
775400,mainnet,244,105408000,105541036,133037,127870,5167,0.038838819275840555,2021-11-06 17:14:28 UTC
775402,mainnet,244,105408000,105541191,133192,128018,5174,0.03884617694756442,2021-11-06 17:15:56 UTC
775403,mainnet,244,105408000,105541356,133357,128163,5194,0.03894808671460816,2021-11-06 17:17:36 UTC
775405,mainnet,244,105408000,105541551,133552,128333,5219,0.03907841140529532,2021-11-06 17:19:21 UTC
775406,mainnet,244,105408000,105541729,133730,128495,5235,0.03914604052942496,2021-11-06 17:20:56 UTC
775408,mainnet,244,105408000,105541904,133905,128657,5248,0.03919196445241029,2021-11-06 17:22:23 UTC
775409,mainnet,244,105408000,105542108,134109,128848,5261,0.03922928364241028,2021-11-06 17:24:01 UTC
775411,mainnet,244,105408000,105542292,134293,129028,5265,0.03920531971137736,2021-11-06 17:25:39 UTC
775413,mainnet,244,105408000,105542464,134465,129191,5274,0.03922210240583052,2021-11-06 17:27:05 UTC
775414,mainnet,244,105408000,105542655,134656,129379,5277,0.03918874762357415,2021-11-06 17:28:42 UTC
775416,mainnet,244,105408000,105542860,134861,129574,5287,0.039203327870918944,2021-11-06 17:30:31 UTC
775417,mainnet,244,105408000,105543034,135035,129718,5317,0.03937497685785167,2021-11-06 17:31:55 UTC
775419,mainnet,244,105408000,105543213,135214,129889,5325,0.03938201665508009,2021-11-06 17:33:35 UTC
775420,mainnet,244,105408000,105543440,135441,130110,5331,0.039360311870113185,2021-11-06 17:35:35 UTC
775422,mainnet,244,105408000,105543663,135664,130312,5352,0.03945040688760467,2021-11-06 17:37:14 UTC
775423,mainnet,244,105408000,105543853,135854,130478,5376,0.03957189335610287,2021-11-06 17:38:42 UTC
775425,mainnet,244,105408000,105544032,136033,130652,5381,0.03955657818323495,2021-11-06 17:40:12 UTC
775426,mainnet,244,105408000,105544252,136253,130861,5392,0.039573440584794464,2021-11-06 17:42:01 UTC
775428,mainnet,244,105408000,105544436,136437,131030,5407,0.03963001238666931,2021-11-06 17:43:29 UTC
775429,mainnet,244,105408000,105544638,136639,131214,5425,0.039703159420077724,2021-11-06 17:45:08 UTC
775431,mainnet,244,105408000,105544909,136910,131470,5440,0.03973413191147469,2021-11-06 17:47:28 UTC
775433,mainnet,244,105408000,105545087,137088,131639,5449,0.03974819094304388,2021-11-06 17:48:59 UTC
775435,mainnet,244,105408000,105545449,137450,131988,5462,0.039738086576937066,2021-11-06 17:51:59 UTC
775436,mainnet,244,105408000,105545638,137639,132177,5462,0.03968351993257725,2021-11-06 17:53:28 UTC
775438,mainnet,244,105408000,105545824,137825,132358,5467,0.03966624342463269,2021-11-06 17:54:58 UTC
775439,mainnet,244,105408000,105546031,138032,132564,5468,0.0396140025501333,2021-11-06 17:56:57 UTC
775441,mainnet,244,105408000,105546224,138225,132746,5479,0.039638270935069636,2021-11-06 17:58:23 UTC
775442,mainnet,244,105408000,105546396,138397,132915,5482,0.03961068520271393,2021-11-06 17:59:52 UTC
775444,mainnet,244,105408000,105546585,138586,133098,5488,0.03959995959187797,2021-11-06 18:01:28 UTC
775445,mainnet,244,105408000,105546750,138751,133260,5491,0.03957448955322845,2021-11-06 18:02:59 UTC
775447,mainnet,244,105408000,105546901,138902,133405,5497,0.03957466415170408,2021-11-06 18:04:26 UTC
775448,mainnet,244,105408000,105547105,139106,133594,5512,0.039624459045619884,2021-11-06 18:05:54 UTC
775450,mainnet,244,105408000,105547282,139283,133770,5513,0.039581284148101345,2021-11-06 18:07:24 UTC
775451,mainnet,244,105408000,105547460,139461,133948,5513,0.03953076487333376,2021-11-06 18:08:51 UTC
775453,mainnet,244,105408000,105547626,139627,134112,5515,0.03949809134336482,2021-11-06 18:10:20 UTC
775454,mainnet,244,105408000,105547815,139816,134295,5521,0.039487612290438866,2021-11-06 18:11:54 UTC
775456,mainnet,244,105408000,105548006,140007,134476,5531,0.03950516759876292,2021-11-06 18:13:35 UTC
775457,mainnet,244,105408000,105548162,140163,134630,5533,0.039475467848148225,2021-11-06 18:15:03 UTC
775459,mainnet,244,105408000,105548346,140347,134802,5545,0.039509216442104214,2021-11-06 18:16:32 UTC
775460,mainnet,244,105408000,105548545,140546,135000,5546,0.039460390192534826,2021-11-06 18:18:12 UTC
775462,mainnet,244,105408000,105548731,140732,135180,5552,0.03945087115936674,2021-11-06 18:19:42 UTC
775463,mainnet,244,105408000,105548942,140943,135389,5554,0.03940600100749948,2021-11-06 18:21:25 UTC
775465,mainnet,244,105408000,105549130,141131,135575,5556,0.03936767967349484,2021-11-06 18:22:56 UTC
775466,mainnet,244,105408000,105549318,141319,135758,5561,0.03935068886703132,2021-11-06 18:24:29 UTC
775468,mainnet,244,105408000,105549515,141516,135947,5569,0.039352440713417564,2021-11-06 18:26:04 UTC
775469,mainnet,244,105408000,105549724,141725,136151,5574,0.039329687775621805,2021-11-06 18:27:48 UTC
775471,mainnet,244,105408000,105549913,141914,136337,5577,0.03929844835604662,2021-11-06 18:29:19 UTC
775472,mainnet,244,105408000,105550112,142113,136528,5585,0.03929971220085425,2021-11-06 18:30:59 UTC
775474,mainnet,244,105408000,105550294,142295,136708,5587,0.0392635018798974,2021-11-06 18:32:40 UTC
775476,mainnet,244,105408000,105550505,142506,136910,5596,0.03926852202714272,2021-11-06 18:34:22 UTC
775477,mainnet,244,105408000,105550698,142699,137081,5618,0.03936958212741505,2021-11-06 18:36:01 UTC
775479,mainnet,244,105408000,105550877,142878,137254,5624,0.03936225311104579,2021-11-06 18:37:31 UTC
775480,mainnet,244,105408000,105551064,143065,137438,5627,0.03933177227134519,2021-11-06 18:39:10 UTC
775482,mainnet,244,105408000,105551257,143258,137615,5643,0.03939047034022533,2021-11-06 18:40:40 UTC
775483,mainnet,244,105408000,105551449,143450,137798,5652,0.03940048797490415,2021-11-06 18:42:14 UTC
775485,mainnet,244,105408000,105551603,143604,137947,5657,0.03939305311829754,2021-11-06 18:43:41 UTC
775486,mainnet,244,105408000,105551830,143831,138162,5669,0.03941431263079587,2021-11-06 18:45:20 UTC
775488,mainnet,244,105408000,105552028,144029,138348,5681,0.03944344541724236,2021-11-06 18:46:52 UTC
775489,mainnet,244,105408000,105552187,144188,138503,5685,0.039427691624823145,2021-11-06 18:48:23 UTC
775491,mainnet,244,105408000,105552332,144333,138626,5707,0.03954050702195617,2021-11-06 18:49:51 UTC
775492,mainnet,244,105408000,105552504,144505,138761,5744,0.03974948963703678,2021-11-06 18:51:26 UTC
775494,mainnet,244,105408000,105552689,144690,138925,5765,0.03984380399474739,2021-11-06 18:53:00 UTC
775495,mainnet,244,105408000,105552845,144846,139077,5769,0.039828507518329816,2021-11-06 18:54:32 UTC
775497,mainnet,244,105408000,105553024,145025,139232,5793,0.03994483709705223,2021-11-06 18:56:15 UTC
775498,mainnet,244,105408000,105553226,145227,139434,5793,0.03988927678737425,2021-11-06 18:58:06 UTC
775500,mainnet,244,105408000,105553364,145365,139550,5815,0.04000275169401163,2021-11-06 18:59:34 UTC
775501,mainnet,244,105408000,105553554,145555,139720,5835,0.04008793926694377,2021-11-06 19:01:06 UTC
775503,mainnet,244,105408000,105553705,145706,139861,5845,0.0401150261485457,2021-11-06 19:02:46 UTC
775504,mainnet,244,105408000,105553903,145904,140020,5884,0.040327886829696236,2021-11-06 19:04:14 UTC
775506,mainnet,244,105408000,105554111,146112,140200,5912,0.04046211125711783,2021-11-06 19:06:04 UTC
775508,mainnet,244,105408000,105554342,146343,140421,5922,0.04046657510096144,2021-11-06 19:08:23 UTC
775509,mainnet,244,105408000,105554548,146549,140627,5922,0.04040969232133962,2021-11-06 19:09:55 UTC
775511,mainnet,244,105408000,105554716,146717,140787,5930,0.04041794747711581,2021-11-06 19:11:29 UTC
775512,mainnet,244,105408000,105554905,146906,140952,5954,0.040529318067335576,2021-11-06 19:13:11 UTC
775514,mainnet,244,105408000,105555088,147089,141131,5958,0.040506088150711474,2021-11-06 19:14:40 UTC
775515,mainnet,244,105408000,105555248,147249,141277,5972,0.040557151491690945,2021-11-06 19:16:11 UTC
775517,mainnet,244,105408000,105555452,147453,141479,5974,0.04051460465368626,2021-11-06 19:17:51 UTC
775518,mainnet,244,105408000,105555657,147658,141680,5978,0.04048544609841661,2021-11-06 19:19:34 UTC
775520,mainnet,244,105408000,105555869,147870,141890,5980,0.0404409278420234,2021-11-06 19:21:16 UTC
775521,mainnet,244,105408000,105556047,148048,142066,5982,0.040405814330487407,2021-11-06 19:22:45 UTC
775523,mainnet,244,105408000,105556230,148231,142248,5983,0.040362677172791114,2021-11-06 19:24:16 UTC
775524,mainnet,244,105408000,105556411,148412,142421,5991,0.04036735573942808,2021-11-06 19:25:50 UTC
775526,mainnet,244,105408000,105556610,148611,142616,5995,0.040340217076797816,2021-11-06 19:27:23 UTC
775527,mainnet,244,105408000,105556804,148805,142794,6011,0.04039514801249958,2021-11-06 19:28:56 UTC
775529,mainnet,244,105408000,105556988,148989,142973,6016,0.04037881991287948,2021-11-06 19:30:29 UTC
775530,mainnet,244,105408000,105557156,149157,143128,6029,0.040420496523797075,2021-11-06 19:31:59 UTC
775532,mainnet,244,105408000,105557332,149333,143279,6054,0.040540269063100584,2021-11-06 19:33:38 UTC
775533,mainnet,244,105408000,105557524,149525,143465,6060,0.040528339742517974,2021-11-06 19:35:16 UTC
775535,mainnet,244,105408000,105557714,149715,143642,6073,0.04056373776842668,2021-11-06 19:36:50 UTC
775537,mainnet,244,105408000,105557916,149917,143844,6073,0.0405090816918695,2021-11-06 19:38:37 UTC
775538,mainnet,244,105408000,105558098,150099,144024,6075,0.04047328763016409,2021-11-06 19:40:11 UTC
775540,mainnet,244,105408000,105558313,150314,144234,6080,0.04044866080338491,2021-11-06 19:41:53 UTC
775541,mainnet,244,105408000,105558501,150502,144413,6089,0.040457934113832375,2021-11-06 19:43:31 UTC
775543,mainnet,244,105408000,105558713,150714,144609,6105,0.04050718579561288,2021-11-06 19:45:16 UTC
775544,mainnet,244,105408000,105558895,150896,144786,6110,0.040491464319796416,2021-11-06 19:46:49 UTC
775546,mainnet,244,105408000,105559118,151119,145001,6118,0.040484651168946326,2021-11-06 19:48:43 UTC
775547,mainnet,244,105408000,105559296,151297,145174,6123,0.04047006880506553,2021-11-06 19:50:19 UTC
775549,mainnet,244,105408000,105559484,151485,145351,6134,0.04049245799914183,2021-11-06 19:51:52 UTC
775550,mainnet,244,105408000,105559677,151678,145527,6151,0.04055301362096019,2021-11-06 19:53:35 UTC
775552,mainnet,244,105408000,105559822,151823,145658,6165,0.040606495721992056,2021-11-06 19:55:13 UTC
775553,mainnet,244,105408000,105560003,152004,145808,6196,0.04076208520828399,2021-11-06 19:56:50 UTC
775555,mainnet,244,105408000,105560214,152215,146015,6200,0.04073185954078113,2021-11-06 19:58:33 UTC
775556,mainnet,244,105408000,105560405,152406,146206,6200,0.04068081309134811,2021-11-06 20:00:09 UTC
775558,mainnet,244,105408000,105560585,152586,146386,6200,0.04063282345693576,2021-11-06 20:01:45 UTC
775559,mainnet,244,105408000,105560759,152760,146555,6205,0.04061927206074889,2021-11-06 20:03:19 UTC
775561,mainnet,244,105408000,105560963,152964,146738,6226,0.0407023874898669,2021-11-06 20:04:54 UTC
775562,mainnet,244,105408000,105561148,153149,146914,6235,0.04071198636621852,2021-11-06 20:06:30 UTC
775564,mainnet,244,105408000,105561325,153326,147086,6240,0.04069759858080169,2021-11-06 20:08:04 UTC
775565,mainnet,244,105408000,105561531,153532,147276,6256,0.04074720579423182,2021-11-06 20:09:48 UTC
775567,mainnet,244,105408000,105561725,153726,147460,6266,0.040760834211519194,2021-11-06 20:11:24 UTC
775568,mainnet,244,105408000,105561940,153941,147666,6275,0.04076236999889568,2021-11-06 20:13:08 UTC
775570,mainnet,244,105408000,105562119,154120,147839,6281,0.04075395795484038,2021-11-06 20:14:52 UTC
775571,mainnet,244,105408000,105562337,154338,148042,6296,0.0407935829154194,2021-11-06 20:16:25 UTC
775573,mainnet,244,105408000,105562552,154553,148252,6301,0.04076918597503769,2021-11-06 20:18:12 UTC
775575,mainnet,244,105408000,105562787,154788,148478,6310,0.040765434012972585,2021-11-06 20:20:05 UTC
775576,mainnet,244,105408000,105563002,155003,148691,6312,0.04072179248143584,2021-11-06 20:21:56 UTC
775578,mainnet,244,105408000,105563198,155199,148875,6324,0.04074768522993061,2021-11-06 20:23:30 UTC
775579,mainnet,244,105408000,105563413,155414,149083,6331,0.04073635579806195,2021-11-06 20:25:26 UTC
775581,mainnet,244,105408000,105563612,155613,149257,6356,0.04084491655581474,2021-11-06 20:27:11 UTC
775582,mainnet,244,105408000,105563810,155811,149454,6357,0.040799430078749255,2021-11-06 20:28:49 UTC
775584,mainnet,244,105408000,105564040,156041,149664,6377,0.0408674643202748,2021-11-06 20:30:43 UTC
775585,mainnet,244,105408000,105564236,156237,149855,6382,0.040848198570121036,2021-11-06 20:32:16 UTC
775587,mainnet,244,105408000,105564408,156409,150014,6395,0.04088639400546004,2021-11-06 20:33:43 UTC
775588,mainnet,244,105408000,105564596,156597,150197,6400,0.04086923759714426,2021-11-06 20:35:14 UTC
775590,mainnet,244,105408000,105564778,156779,150379,6400,0.04082179373513034,2021-11-06 20:36:42 UTC
775591,mainnet,244,105408000,105564968,156969,150568,6401,0.04077875249253037,2021-11-06 20:38:16 UTC
775593,mainnet,244,105408000,105565154,157155,150753,6402,0.040736852152333684,2021-11-06 20:39:47 UTC
775594,mainnet,244,105408000,105565352,157353,150947,6406,0.040711012818312964,2021-11-06 20:41:20 UTC
775596,mainnet,244,105408000,105565534,157535,151128,6407,0.040670327228869776,2021-11-06 20:42:51 UTC
775597,mainnet,244,105408000,105565711,157712,151302,6410,0.04064370498123161,2021-11-06 20:44:24 UTC
775599,mainnet,244,105408000,105565895,157896,151477,6419,0.040653341439935146,2021-11-06 20:45:57 UTC
775600,mainnet,244,105408000,105565987,157988,151559,6429,0.040692964022583995,2021-11-06 20:47:29 UTC
775602,mainnet,244,105408000,105566239,158240,151791,6449,0.040754550050556115,2021-11-06 20:49:00 UTC
775603,mainnet,244,105408000,105566419,158420,151969,6451,0.04072086857719985,2021-11-06 20:50:30 UTC
775605,mainnet,244,105408000,105566616,158617,152157,6460,0.040727034302754435,2021-11-06 20:52:01 UTC
775606,mainnet,244,105408000,105566696,158697,152237,6460,0.04070650358859966,2021-11-06 20:53:32 UTC
775608,mainnet,244,105408000,105566945,158946,152455,6491,0.04083776880198307,2021-11-06 20:54:59 UTC
775609,mainnet,244,105408000,105567094,159095,152581,6514,0.04094409000911405,2021-11-06 20:56:29 UTC
775611,mainnet,244,105408000,105567321,159322,152794,6528,0.040973625739069305,2021-11-06 20:58:20 UTC
775613,mainnet,244,105408000,105567502,159503,152966,6537,0.04098355516824135,2021-11-06 21:00:01 UTC
775614,mainnet,244,105408000,105567720,159721,153170,6551,0.04101527037772115,2021-11-06 21:01:45 UTC
775616,mainnet,244,105408000,105567891,159892,153339,6553,0.04098391414204588,2021-11-06 21:03:14 UTC
775617,mainnet,244,105408000,105568068,160069,153504,6565,0.041013562900998946,2021-11-06 21:04:43 UTC
775619,mainnet,244,105408000,105568235,160236,153667,6569,0.04099578122269652,2021-11-06 21:06:12 UTC
775620,mainnet,244,105408000,105568407,160408,153834,6574,0.04098299336691437,2021-11-06 21:07:41 UTC
775622,mainnet,244,105408000,105568581,160582,154006,6576,0.0409510405898544,2021-11-06 21:09:12 UTC
775623,mainnet,244,105408000,105568768,160769,154182,6587,0.04097182914616624,2021-11-06 21:10:43 UTC
775625,mainnet,244,105408000,105568953,160954,154365,6589,0.040937162170558046,2021-11-06 21:12:15 UTC
775626,mainnet,244,105408000,105569135,161136,154547,6589,0.040890924436500845,2021-11-06 21:13:41 UTC
775628,mainnet,244,105408000,105569320,161321,154727,6594,0.04087502557013656,2021-11-06 21:15:12 UTC
775629,mainnet,244,105408000,105569504,161505,154911,6594,0.04082845732330268,2021-11-06 21:16:46 UTC
775631,mainnet,244,105408000,105569688,161689,155091,6598,0.04080673391510863,2021-11-06 21:18:17 UTC
775632,mainnet,244,105408000,105569869,161870,155266,6604,0.040798171372088715,2021-11-06 21:19:47 UTC
775634,mainnet,244,105408000,105570069,162070,155448,6622,0.040858888134756584,2021-11-06 21:21:20 UTC
775635,mainnet,244,105408000,105570256,162257,155625,6632,0.04087342918949568,2021-11-06 21:23:08 UTC
775637,mainnet,244,105408000,105570476,162477,155839,6638,0.04085501332496292,2021-11-06 21:24:48 UTC
775638,mainnet,244,105408000,105570653,162654,156010,6644,0.04084744303859727,2021-11-06 21:26:19 UTC
775640,mainnet,244,105408000,105570844,162845,156189,6656,0.04087322300346956,2021-11-06 21:27:57 UTC
775641,mainnet,244,105408000,105571034,163035,156365,6670,0.040911460729291256,2021-11-06 21:29:27 UTC
775643,mainnet,244,105408000,105571252,163253,156567,6686,0.040954836970836676,2021-11-06 21:31:30 UTC
775645,mainnet,244,105408000,105571464,163465,156765,6700,0.04098736732633897,2021-11-06 21:33:21 UTC
775646,mainnet,244,105408000,105571633,163634,156906,6728,0.041116149455492135,2021-11-06 21:34:53 UTC
775648,mainnet,244,105408000,105571800,163801,157048,6753,0.04122685453690759,2021-11-06 21:36:23 UTC
775649,mainnet,244,105408000,105571939,163940,157184,6756,0.04121019885323899,2021-11-06 21:37:51 UTC
775651,mainnet,244,105408000,105572123,164124,157351,6773,0.0412675781726012,2021-11-06 21:39:26 UTC
775652,mainnet,244,105408000,105572299,164300,157507,6793,0.041345100426049906,2021-11-06 21:40:55 UTC
775654,mainnet,244,105408000,105572499,164500,157702,6798,0.041325227963525835,2021-11-06 21:42:45 UTC
775655,mainnet,244,105408000,105572668,164669,157853,6816,0.041392126022505756,2021-11-06 21:44:15 UTC
775657,mainnet,244,105408000,105572840,164841,158015,6826,0.041409600766799524,2021-11-06 21:45:42 UTC
775658,mainnet,244,105408000,105573048,165049,158221,6828,0.041369532684233164,2021-11-06 21:47:28 UTC
775660,mainnet,244,105408000,105573299,165300,158456,6844,0.041403508771929824,2021-11-06 21:49:31 UTC
775661,mainnet,244,105408000,105573508,165509,158661,6848,0.04137539348313385,2021-11-06 21:51:10 UTC
775663,mainnet,244,105408000,105573722,165723,158872,6851,0.04134006746196967,2021-11-06 21:53:00 UTC
775665,mainnet,244,105408000,105573895,165896,159023,6873,0.04142957033322081,2021-11-06 21:54:33 UTC
775666,mainnet,244,105408000,105574065,166066,159191,6875,0.04139920272662676,2021-11-06 21:56:04 UTC
775668,mainnet,244,105408000,105574260,166261,159377,6884,0.041404779232652275,2021-11-06 21:57:33 UTC
775669,mainnet,244,105408000,105574469,166470,159578,6892,0.04140085300654773,2021-11-06 21:59:14 UTC
775671,mainnet,244,105408000,105574673,166674,159771,6903,0.04141617768818172,2021-11-06 22:01:03 UTC
775672,mainnet,244,105408000,105574864,166865,159953,6912,0.04142270697869535,2021-11-06 22:02:36 UTC
775674,mainnet,244,105408000,105575047,167048,160135,6913,0.04138331497533643,2021-11-06 22:04:14 UTC
775675,mainnet,244,105408000,105575278,167279,160361,6918,0.04135605784348304,2021-11-06 22:05:55 UTC
775677,mainnet,244,105408000,105575472,167473,160552,6921,0.041326064499949244,2021-11-06 22:07:28 UTC
775678,mainnet,244,105408000,105575672,167673,160748,6925,0.04130062681528928,2021-11-06 22:09:04 UTC
775680,mainnet,244,105408000,105575861,167862,160935,6927,0.04126603996139686,2021-11-06 22:10:38 UTC
775681,mainnet,244,105408000,105576050,168051,161099,6952,0.04136839411845214,2021-11-06 22:12:16 UTC
775683,mainnet,244,105408000,105576240,168241,161287,6954,0.04133356316236827,2021-11-06 22:13:48 UTC
775684,mainnet,244,105408000,105576433,168434,161476,6958,0.041309949297647745,2021-11-06 22:15:23 UTC
775686,mainnet,244,105408000,105576627,168628,161668,6960,0.04127428422326067,2021-11-06 22:17:01 UTC
775687,mainnet,244,105408000,105576813,168814,161852,6962,0.04124065539587949,2021-11-06 22:18:36 UTC
775689,mainnet,244,105408000,105577018,169019,162041,6978,0.0412852992858791,2021-11-06 22:20:09 UTC
775690,mainnet,244,105408000,105577202,169203,162220,6983,0.04126995384242596,2021-11-06 22:21:40 UTC
775692,mainnet,244,105408000,105577385,169386,162391,6995,0.04129621102098166,2021-11-06 22:23:21 UTC
775693,mainnet,244,105408000,105577586,169587,162573,7014,0.041359302305011586,2021-11-06 22:25:05 UTC
775695,mainnet,244,105408000,105577772,169773,162749,7024,0.04137289203819217,2021-11-06 22:26:36 UTC
775696,mainnet,244,105408000,105577959,169960,162934,7026,0.041339138620851965,2021-11-06 22:28:06 UTC
775698,mainnet,244,105408000,105578126,170127,163100,7027,0.0413044372733311,2021-11-06 22:29:34 UTC
775699,mainnet,244,105408000,105578336,170337,163296,7041,0.0413357051022385,2021-11-06 22:31:16 UTC
775701,mainnet,244,105408000,105578521,170522,163465,7057,0.041384689365595057,2021-11-06 22:32:45 UTC
775702,mainnet,244,105408000,105578715,170716,163649,7067,0.04139623702523489,2021-11-06 22:34:16 UTC
775704,mainnet,244,105408000,105578911,170912,163843,7069,0.041360466204830554,2021-11-06 22:35:52 UTC
775705,mainnet,244,105408000,105579091,171092,164005,7087,0.04142215883851963,2021-11-06 22:37:21 UTC
775707,mainnet,244,105408000,105579267,171268,164172,7096,0.041432141439148,2021-11-06 22:38:51 UTC
775708,mainnet,244,105408000,105579460,171461,164362,7099,0.041403001265593924,2021-11-06 22:40:25 UTC
775710,mainnet,244,105408000,105579648,171649,164550,7099,0.041357654282867945,2021-11-06 22:41:52 UTC
775711,mainnet,244,105408000,105579852,171853,164749,7104,0.04133765485618523,2021-11-06 22:43:32 UTC
775713,mainnet,244,105408000,105580032,172033,164913,7120,0.041387408229816375,2021-11-06 22:45:02 UTC
775714,mainnet,244,105408000,105580256,172257,165131,7126,0.04136842044154954,2021-11-06 22:46:51 UTC
775716,mainnet,244,105408000,105580488,172489,165355,7134,0.041359159134785405,2021-11-06 22:49:10 UTC
775718,mainnet,244,105408000,105580688,172689,165535,7154,0.04142707410431469,2021-11-06 22:50:58 UTC
775719,mainnet,244,105408000,105580912,172913,165716,7197,0.041622087408118534,2021-11-06 22:52:37 UTC
775721,mainnet,244,105408000,105581099,173100,165889,7211,0.041658001155401504,2021-11-06 22:54:15 UTC
775723,mainnet,244,105408000,105581351,173352,166135,7217,0.04163205500946052,2021-11-06 22:56:15 UTC
775724,mainnet,244,105408000,105581542,173543,166324,7219,0.04159775963305924,2021-11-06 22:57:50 UTC
775726,mainnet,244,105408000,105581703,173704,166485,7219,0.04155920416340441,2021-11-06 22:59:22 UTC
775727,mainnet,244,105408000,105581910,173911,166686,7225,0.0415442381447982,2021-11-06 23:01:05 UTC
775728,mainnet,244,105408000,105582108,174109,166880,7229,0.04151996737675824,2021-11-06 23:02:47 UTC
775730,mainnet,244,105408000,105582297,174298,167062,7236,0.041515106312177995,2021-11-06 23:04:26 UTC
775731,mainnet,244,105408000,105582485,174486,167246,7240,0.04149330032208888,2021-11-06 23:05:57 UTC
775733,mainnet,244,105408000,105582686,174687,167438,7249,0.041497077630275866,2021-11-06 23:07:55 UTC
775735,mainnet,244,105408000,105582929,174930,167672,7258,0.04149088206711256,2021-11-06 23:09:34 UTC
775736,mainnet,244,105408000,105583124,175125,167866,7259,0.04145039257673091,2021-11-06 23:11:08 UTC
775738,mainnet,244,105408000,105583315,175316,168051,7265,0.041439457893175755,2021-11-06 23:12:56 UTC
775739,mainnet,244,105408000,105583510,175511,168221,7290,0.04153585815134094,2021-11-06 23:14:22 UTC
775741,mainnet,244,105408000,105583700,175701,168401,7300,0.04154785687047882,2021-11-06 23:15:53 UTC
775742,mainnet,244,105408000,105583871,175872,168563,7309,0.04155863355167395,2021-11-06 23:17:27 UTC
775744,mainnet,244,105408000,105584077,176078,168747,7331,0.041634957234861825,2021-11-06 23:19:01 UTC
775745,mainnet,244,105408000,105584272,176273,168928,7345,0.04166832129707896,2021-11-06 23:20:39 UTC
775747,mainnet,244,105408000,105584470,176471,169114,7357,0.04168956939100475,2021-11-06 23:22:19 UTC
775748,mainnet,244,105408000,105584645,176646,169278,7368,0.04171053972351483,2021-11-06 23:23:49 UTC
775750,mainnet,244,105408000,105584839,176840,169468,7372,0.04168740104048858,2021-11-06 23:25:22 UTC
775751,mainnet,244,105408000,105585020,177021,169644,7377,0.04167302184486586,2021-11-06 23:26:50 UTC
775753,mainnet,244,105408000,105585194,177195,169809,7386,0.041682891729450604,2021-11-06 23:28:20 UTC
775754,mainnet,244,105408000,105585384,177385,169993,7392,0.041672069227950505,2021-11-06 23:30:00 UTC
775756,mainnet,244,105408000,105585574,177575,170171,7404,0.04169505842601717,2021-11-06 23:31:30 UTC
775757,mainnet,244,105408000,105585753,177754,170348,7406,0.041664322603148174,2021-11-06 23:33:02 UTC
775759,mainnet,244,105408000,105585930,177931,170524,7407,0.041628496439631096,2021-11-06 23:34:30 UTC
775760,mainnet,244,105408000,105586106,178107,170699,7408,0.04159297500940446,2021-11-06 23:35:58 UTC
775762,mainnet,244,105408000,105586278,178279,170871,7408,0.04155284694215247,2021-11-06 23:37:30 UTC
775763,mainnet,244,105408000,105586462,178463,171049,7414,0.041543625289275646,2021-11-06 23:39:01 UTC
775765,mainnet,244,105408000,105586656,178657,171218,7439,0.04163844685626648,2021-11-06 23:40:33 UTC
775766,mainnet,244,105408000,105586854,178855,171404,7451,0.04165944480165497,2021-11-06 23:42:06 UTC
775768,mainnet,244,105408000,105587038,179039,171587,7452,0.041622216388608066,2021-11-06 23:43:37 UTC
775769,mainnet,244,105408000,105587212,179213,171760,7453,0.041587384843733435,2021-11-06 23:45:06 UTC
775771,mainnet,244,105408000,105587407,179408,171946,7462,0.0415923481673058,2021-11-06 23:46:39 UTC
775772,mainnet,244,105408000,105587598,179599,172132,7467,0.04157595532269111,2021-11-06 23:48:15 UTC
775774,mainnet,244,105408000,105587794,179795,172318,7477,0.04158625100809255,2021-11-06 23:49:57 UTC
775775,mainnet,244,105408000,105587970,179971,172485,7486,0.04159559040067566,2021-11-06 23:51:28 UTC
775777,mainnet,244,105408000,105588104,180105,172607,7498,0.04163127064767774,2021-11-06 23:52:55 UTC
775778,mainnet,244,105408000,105588297,180298,172784,7514,0.04167544842427537,2021-11-06 23:54:25 UTC
775780,mainnet,244,105408000,105588480,180481,172961,7520,0.04166643580210659,2021-11-06 23:56:00 UTC
775781,mainnet,244,105408000,105588656,180657,173136,7521,0.04163137880071074,2021-11-06 23:57:26 UTC
775783,mainnet,244,105408000,105588828,180829,173308,7521,0.04159178007952264,2021-11-06 23:58:52 UTC
775784,mainnet,244,105408000,105589027,181028,173502,7526,0.04157367920984599,2021-11-07 00:00:28 UTC
775786,mainnet,244,105408000,105589222,181223,173692,7531,0.04155653531836467,2021-11-07 00:02:10 UTC
775787,mainnet,244,105408000,105589442,181443,173902,7541,0.04156126166344251,2021-11-07 00:03:48 UTC
775789,mainnet,244,105408000,105589612,181613,174065,7548,0.041560901477317155,2021-11-07 00:05:16 UTC
775790,mainnet,244,105408000,105589788,181789,174232,7557,0.04157017201260802,2021-11-07 00:06:46 UTC
775792,mainnet,244,105408000,105589936,181937,174370,7567,0.04159132007233273,2021-11-07 00:08:23 UTC
775794,mainnet,244,105408000,105590180,182181,174581,7600,0.041716754216960056,2021-11-07 00:10:00 UTC
775795,mainnet,244,105408000,105590374,182375,174761,7614,0.041749143248800545,2021-11-07 00:11:36 UTC
775797,mainnet,244,105408000,105590564,182565,174947,7618,0.04172760386711582,2021-11-07 00:13:07 UTC
775798,mainnet,244,105408000,105590778,182779,175140,7639,0.0417936415014854,2021-11-07 00:14:55 UTC
775800,mainnet,244,105408000,105591038,183039,175383,7656,0.041827151590644616,2021-11-07 00:17:03 UTC
775801,mainnet,244,105408000,105591232,183233,175573,7660,0.04180469675222258,2021-11-07 00:18:36 UTC
775803,mainnet,244,105408000,105591408,183409,175738,7671,0.04182455604686793,2021-11-07 00:20:03 UTC
775804,mainnet,244,105408000,105591564,183565,175889,7676,0.041816250374526735,2021-11-07 00:21:37 UTC
775806,mainnet,244,105408000,105591891,183892,176193,7699,0.041866965392730514,2021-11-07 00:24:18 UTC
775808,mainnet,244,105408000,105592118,184119,176414,7705,0.04184793530271183,2021-11-07 00:26:03 UTC
775809,mainnet,244,105408000,105592355,184356,176627,7729,0.04192432033673978,2021-11-07 00:27:57 UTC
775811,mainnet,244,105408000,105592535,184536,176798,7738,0.04193219751159665,2021-11-07 00:29:25 UTC
775812,mainnet,244,105408000,105592742,184743,177002,7741,0.04190145228777274,2021-11-07 00:31:10 UTC
775814,mainnet,244,105408000,105592917,184918,177172,7746,0.04188883721433284,2021-11-07 00:32:37 UTC
775815,mainnet,244,105408000,105593102,185103,177350,7753,0.041884788469122594,2021-11-07 00:34:07 UTC
775817,mainnet,244,105408000,105593283,185284,177530,7754,0.0418492692299389,2021-11-07 00:35:36 UTC
775818,mainnet,244,105408000,105593484,185485,177715,7770,0.04189017979890557,2021-11-07 00:37:07 UTC
775820,mainnet,244,105408000,105593654,185655,177885,7770,0.04185182192776925,2021-11-07 00:38:33 UTC
775821,mainnet,244,105408000,105593784,185785,178005,7780,0.04187636246198563,2021-11-07 00:40:02 UTC
775823,mainnet,244,105408000,105594026,186027,178235,7792,0.041886392835448615,2021-11-07 00:41:33 UTC
775824,mainnet,244,105408000,105594196,186197,178396,7801,0.041896485979903,2021-11-07 00:43:02 UTC
775826,mainnet,244,105408000,105594375,186376,178573,7803,0.04186697858093317,2021-11-07 00:44:28 UTC
775827,mainnet,244,105408000,105594542,186543,178736,7807,0.04185094053381794,2021-11-07 00:45:56 UTC
775829,mainnet,244,105408000,105594708,186709,178900,7809,0.041824443385160864,2021-11-07 00:47:24 UTC
775830,mainnet,244,105408000,105594907,186908,179082,7826,0.04187086695058531,2021-11-07 00:48:56 UTC
775832,mainnet,244,105408000,105595093,187094,179267,7827,0.0418345858231691,2021-11-07 00:50:27 UTC
775833,mainnet,244,105408000,105595277,187278,179446,7832,0.04182018176187272,2021-11-07 00:51:54 UTC
775835,mainnet,244,105408000,105595466,187467,179634,7833,0.04178335387028117,2021-11-07 00:53:24 UTC
775836,mainnet,244,105408000,105595646,187647,179808,7839,0.04177524820540696,2021-11-07 00:54:52 UTC
775838,mainnet,244,105408000,105595813,187814,179971,7843,0.04175940025770177,2021-11-07 00:56:23 UTC
775839,mainnet,244,105408000,105596008,188009,180156,7853,0.04176927700269668,2021-11-07 00:57:55 UTC
775841,mainnet,244,105408000,105596173,188174,180306,7868,0.04181236515140242,2021-11-07 00:59:24 UTC
775842,mainnet,244,105408000,105596345,188346,180462,7884,0.041859131598228794,2021-11-07 01:01:19 UTC
775844,mainnet,244,105408000,105596544,188545,180646,7899,0.041894507942401016,2021-11-07 01:02:56 UTC
775846,mainnet,244,105408000,105596743,188744,180828,7916,0.04194040605264273,2021-11-07 01:04:31 UTC
775847,mainnet,244,105408000,105596920,188921,180998,7923,0.04193816462966002,2021-11-07 01:06:07 UTC
775849,mainnet,244,105408000,105597112,189113,181169,7944,0.04200663095609503,2021-11-07 01:07:42 UTC
775850,mainnet,244,105408000,105597296,189297,181353,7944,0.04196579977495681,2021-11-07 01:09:15 UTC
775852,mainnet,244,105408000,105597473,189474,181521,7953,0.041974096709838815,2021-11-07 01:10:47 UTC
775853,mainnet,244,105408000,105597671,189672,181704,7968,0.04200936353283563,2021-11-07 01:12:22 UTC
775855,mainnet,244,105408000,105597876,189877,181900,7977,0.04201140738478067,2021-11-07 01:13:59 UTC
775856,mainnet,244,105408000,105598075,190076,182098,7978,0.04197268461036638,2021-11-07 01:15:43 UTC
775858,mainnet,244,105408000,105598249,190250,182261,7989,0.04199211563731932,2021-11-07 01:17:21 UTC
775859,mainnet,244,105408000,105598458,190459,182455,8004,0.042024792737544565,2021-11-07 01:18:59 UTC
775861,mainnet,244,105408000,105598629,190630,182616,8014,0.04203955306090332,2021-11-07 01:20:37 UTC
775862,mainnet,244,105408000,105598797,190798,182761,8037,0.04212308305118502,2021-11-07 01:22:17 UTC
775864,mainnet,244,105408000,105599003,191004,182949,8055,0.042171891688132186,2021-11-07 01:24:02 UTC
775865,mainnet,244,105408000,105599192,191193,183131,8062,0.04216681573070144,2021-11-07 01:25:40 UTC
775867,mainnet,244,105408000,105599394,191395,183328,8067,0.042148436479531856,2021-11-07 01:27:18 UTC
775868,mainnet,244,105408000,105599586,191587,183519,8068,0.04211141674539504,2021-11-07 01:28:58 UTC
775870,mainnet,244,105408000,105599760,191761,183686,8075,0.04210970948211576,2021-11-07 01:30:27 UTC
775871,mainnet,244,105408000,105599947,191948,183868,8080,0.04209473399045575,2021-11-07 01:31:55 UTC
775873,mainnet,244,105408000,105600135,192136,184050,8086,0.04208477328558938,2021-11-07 01:33:25 UTC
775874,mainnet,244,105408000,105600341,192342,184252,8090,0.04206049640744091,2021-11-07 01:35:03 UTC
775876,mainnet,244,105408000,105600518,192519,184421,8098,0.04206338075722396,2021-11-07 01:36:36 UTC
775877,mainnet,244,105408000,105600698,192699,184597,8102,0.0420448471450293,2021-11-07 01:38:04 UTC
775879,mainnet,244,105408000,105600876,192877,184770,8107,0.04203196856027416,2021-11-07 01:39:31 UTC
775880,mainnet,244,105408000,105601093,193094,184981,8113,0.04201580577335391,2021-11-07 01:41:21 UTC
775882,mainnet,244,105408000,105601278,193279,185159,8120,0.042011806766384344,2021-11-07 01:42:51 UTC
775883,mainnet,244,105408000,105601456,193457,185326,8131,0.042030011837255826,2021-11-07 01:44:18 UTC
775885,mainnet,244,105408000,105601672,193673,185539,8134,0.04199862655093895,2021-11-07 01:46:07 UTC
775886,mainnet,244,105408000,105601839,193840,185699,8141,0.04199855550969872,2021-11-07 01:47:35 UTC
775888,mainnet,244,105408000,105602017,194018,185853,8165,0.042083724190539025,2021-11-07 01:49:00 UTC
775889,mainnet,244,105408000,105602215,194216,186043,8173,0.04208201178069778,2021-11-07 01:50:34 UTC
775891,mainnet,244,105408000,105602388,194389,186210,8179,0.04207542607863614,2021-11-07 01:52:01 UTC
775892,mainnet,244,105408000,105602594,194595,186396,8199,0.04213366222153704,2021-11-07 01:53:47 UTC
775894,mainnet,244,105408000,105602790,194791,186591,8200,0.042096400757735214,2021-11-07 01:55:17 UTC
775895,mainnet,244,105408000,105602972,194973,186767,8206,0.04208787883450529,2021-11-07 01:56:55 UTC
775897,mainnet,244,105408000,105603178,195179,186970,8209,0.042058828050148836,2021-11-07 01:58:36 UTC
775898,mainnet,244,105408000,105603389,195390,187172,8218,0.04205947080198577,2021-11-07 02:00:07 UTC
775900,mainnet,244,105408000,105603562,195563,187334,8229,0.04207851178392641,2021-11-07 02:01:38 UTC
775901,mainnet,244,105408000,105603747,195748,187514,8234,0.04206428673600752,2021-11-07 02:03:07 UTC
775903,mainnet,244,105408000,105603923,195924,187688,8236,0.04203670811130847,2021-11-07 02:04:49 UTC
775904,mainnet,244,105408000,105604155,196156,187919,8237,0.04199208793001489,2021-11-07 02:06:29 UTC
775906,mainnet,244,105408000,105604340,196341,188095,8246,0.041998359996129185,2021-11-07 02:07:58 UTC
775907,mainnet,244,105408000,105604556,196557,188302,8255,0.04199799549240169,2021-11-07 02:09:36 UTC
775909,mainnet,244,105408000,105604750,196751,188483,8268,0.04202265808051801,2021-11-07 02:11:18 UTC
775910,mainnet,244,105408000,105604940,196941,188662,8279,0.04203797076281729,2021-11-07 02:12:48 UTC
775912,mainnet,244,105408000,105605121,197122,188840,8282,0.042014589949371454,2021-11-07 02:14:16 UTC
775913,mainnet,244,105408000,105605310,197311,189019,8292,0.04202502648103755,2021-11-07 02:15:44 UTC
775915,mainnet,244,105408000,105605494,197495,189195,8300,0.042026380414694045,2021-11-07 02:17:14 UTC
775917,mainnet,244,105408000,105605694,197695,189390,8305,0.04200915551733731,2021-11-07 02:18:52 UTC
775918,mainnet,244,105408000,105605892,197893,189580,8313,0.04200754953434432,2021-11-07 02:20:26 UTC
775920,mainnet,244,105408000,105606087,198088,189770,8318,0.041991438148701585,2021-11-07 02:22:04 UTC
775921,mainnet,244,105408000,105606282,198283,189954,8329,0.042005618232526236,2021-11-07 02:23:32 UTC
775923,mainnet,244,105408000,105606475,198476,190143,8333,0.04198492512948669,2021-11-07 02:25:02 UTC
775924,mainnet,244,105408000,105606670,198671,190336,8335,0.04195378288728602,2021-11-07 02:26:45 UTC
775926,mainnet,244,105408000,105606870,198871,190534,8337,0.04192164770127369,2021-11-07 02:28:12 UTC
775927,mainnet,244,105408000,105607050,199051,190713,8338,0.04188876217652762,2021-11-07 02:29:43 UTC
775929,mainnet,244,105408000,105607232,199233,190887,8346,0.04189065064522444,2021-11-07 02:31:12 UTC
775930,mainnet,244,105408000,105607414,199415,191068,8347,0.04185743299150014,2021-11-07 02:32:42 UTC
775932,mainnet,244,105408000,105607614,199615,191264,8351,0.041835533401798464,2021-11-07 02:34:16 UTC
775933,mainnet,244,105408000,105607800,199801,191440,8361,0.04184663740421719,2021-11-07 02:35:48 UTC
775935,mainnet,244,105408000,105607989,199990,191628,8362,0.04181209060453023,2021-11-07 02:37:21 UTC
775936,mainnet,244,105408000,105608214,200215,191851,8364,0.04177509177634044,2021-11-07 02:39:06 UTC
775938,mainnet,244,105408000,105608384,200385,192016,8369,0.04176460313895751,2021-11-07 02:40:38 UTC
775939,mainnet,244,105408000,105608577,200578,192195,8383,0.04179421471946076,2021-11-07 02:42:11 UTC
775941,mainnet,244,105408000,105608782,200783,192399,8384,0.041756523211626484,2021-11-07 02:43:46 UTC
775942,mainnet,244,105408000,105608966,200967,192583,8384,0.04171829205790005,2021-11-07 02:45:18 UTC
775944,mainnet,244,105408000,105609168,201169,192772,8397,0.04174102371637777,2021-11-07 02:46:59 UTC
775945,mainnet,244,105408000,105609406,201407,193008,8399,0.04170162903970567,2021-11-07 02:48:52 UTC
775947,mainnet,244,105408000,105609655,201656,193251,8405,0.04167989050660531,2021-11-07 02:50:53 UTC
775948,mainnet,244,105408000,105609842,201843,193427,8416,0.041695773447679635,2021-11-07 02:52:26 UTC
775950,mainnet,244,105408000,105610072,202073,193657,8416,0.04164831521281913,2021-11-07 02:54:17 UTC
775952,mainnet,244,105408000,105610259,202260,193835,8425,0.04165430633837635,2021-11-07 02:55:46 UTC
775953,mainnet,244,105408000,105610469,202470,194040,8430,0.04163579789598459,2021-11-07 02:57:27 UTC
775955,mainnet,244,105408000,105610624,202625,194193,8432,0.041613818630475016,2021-11-07 02:58:56 UTC
775956,mainnet,244,105408000,105610827,202828,194392,8436,0.041591890665983,2021-11-07 03:00:27 UTC
775958,mainnet,244,105408000,105611015,203016,194571,8445,0.04159770658470268,2021-11-07 03:01:57 UTC
775959,mainnet,244,105408000,105611266,203267,194805,8462,0.04162997436868749,2021-11-07 03:03:56 UTC
775961,mainnet,244,105408000,105611479,203480,195018,8462,0.041586396697464126,2021-11-07 03:05:35 UTC
775962,mainnet,244,105408000,105611666,203667,195197,8470,0.04158749331015825,2021-11-07 03:07:04 UTC
775964,mainnet,244,105408000,105611853,203854,195379,8475,0.041573871496266936,2021-11-07 03:08:35 UTC
775965,mainnet,244,105408000,105612038,204039,195564,8475,0.04153617690735595,2021-11-07 03:10:01 UTC
775967,mainnet,244,105408000,105612232,204233,195758,8475,0.04149672188138058,2021-11-07 03:11:34 UTC
775968,mainnet,244,105408000,105612449,204450,195975,8475,0.04145267791636097,2021-11-07 03:13:27 UTC
775970,mainnet,244,105408000,105612653,204654,196177,8477,0.041421130297966326,2021-11-07 03:14:57 UTC
775971,mainnet,244,105408000,105612842,204843,196354,8489,0.04144149421752269,2021-11-07 03:16:28 UTC
775973,mainnet,244,105408000,105613055,205056,196562,8494,0.041422830836454434,2021-11-07 03:18:09 UTC
775974,mainnet,244,105408000,105613248,205249,196755,8494,0.041383880067625174,2021-11-07 03:19:39 UTC
775976,mainnet,244,105408000,105613436,205437,196939,8498,0.041365479441385924,2021-11-07 03:21:19 UTC
775978,mainnet,244,105408000,105613660,205661,197143,8518,0.04141767277218335,2021-11-07 03:22:57 UTC
775979,mainnet,244,105408000,105613835,205836,197317,8519,0.041387318059037295,2021-11-07 03:24:25 UTC
775980,mainnet,244,105408000,105614030,206031,197511,8520,0.0413530002766574,2021-11-07 03:26:06 UTC
775981,mainnet,244,105408000,105614254,206255,197726,8529,0.041351724806671354,2021-11-07 03:27:37 UTC
775983,mainnet,244,105408000,105614466,206467,197937,8530,0.04131410830786518,2021-11-07 03:29:15 UTC
775985,mainnet,244,105408000,105614690,206691,198156,8535,0.041293525117203946,2021-11-07 03:31:04 UTC
775986,mainnet,244,105408000,105614878,206879,198343,8536,0.04126083362738606,2021-11-07 03:32:32 UTC
775988,mainnet,244,105408000,105615068,207069,198533,8536,0.04122297398451724,2021-11-07 03:34:03 UTC
775989,mainnet,244,105408000,105615243,207244,198707,8537,0.041192989905618496,2021-11-07 03:35:30 UTC
775991,mainnet,244,105408000,105615452,207453,198914,8539,0.0411611304729264,2021-11-07 03:37:10 UTC
775992,mainnet,244,105408000,105615641,207642,199095,8547,0.04116219261999018,2021-11-07 03:38:40 UTC
775994,mainnet,244,105408000,105615837,207838,199290,8548,0.041128186375927404,2021-11-07 03:40:11 UTC
775995,mainnet,244,105408000,105616024,208025,199469,8556,0.04112967191443336,2021-11-07 03:41:40 UTC
775997,mainnet,244,105408000,105616210,208211,199646,8565,0.041136155150304256,2021-11-07 03:43:08 UTC
775998,mainnet,244,105408000,105616372,208373,199794,8579,0.04117136097287077,2021-11-07 03:44:36 UTC
776000,mainnet,244,105408000,105616550,208551,199967,8584,0.041160195827399534,2021-11-07 03:46:06 UTC
776001,mainnet,244,105408000,105616736,208737,200137,8600,0.041200170549543204,2021-11-07 03:47:34 UTC
776003,mainnet,244,105408000,105616945,208946,200341,8605,0.04118288935897313,2021-11-07 03:49:15 UTC
776004,mainnet,244,105408000,105617113,209114,200507,8607,0.04115936761766309,2021-11-07 03:50:42 UTC
776006,mainnet,244,105408000,105617321,209322,200707,8615,0.04115668682699382,2021-11-07 03:52:19 UTC
776007,mainnet,244,105408000,105617518,209519,200903,8616,0.04112276213613085,2021-11-07 03:53:51 UTC
776009,mainnet,244,105408000,105617701,209702,201081,8621,0.04111071902032408,2021-11-07 03:55:22 UTC
776010,mainnet,244,105408000,105617890,209891,201260,8631,0.041121343935661844,2021-11-07 03:56:50 UTC
776012,mainnet,244,105408000,105618086,210087,201456,8631,0.04108297990832369,2021-11-07 03:58:22 UTC
776013,mainnet,244,105408000,105618279,210280,201639,8641,0.04109282860947308,2021-11-07 03:59:53 UTC
776015,mainnet,244,105408000,105618474,210475,201825,8650,0.041097517519895474,2021-11-07 04:01:27 UTC
776016,mainnet,244,105408000,105618637,210638,201986,8652,0.041075209601306506,2021-11-07 04:02:56 UTC
776018,mainnet,244,105408000,105618844,210845,202173,8672,0.041129739856292535,2021-11-07 04:04:35 UTC
776019,mainnet,244,105408000,105619061,211062,202383,8679,0.0411206185860079,2021-11-07 04:06:32 UTC
776021,mainnet,244,105408000,105619273,211274,202583,8691,0.04113615494571031,2021-11-07 04:08:12 UTC
776022,mainnet,244,105408000,105619448,211449,202757,8692,0.04110683900136676,2021-11-07 04:09:42 UTC
776024,mainnet,244,105408000,105619617,211618,202914,8704,0.04113071666871438,2021-11-07 04:11:14 UTC
776025,mainnet,244,105408000,105619784,211785,203065,8720,0.04117383195221569,2021-11-07 04:12:40 UTC
776027,mainnet,244,105408000,105619989,211990,203266,8724,0.04115288457002689,2021-11-07 04:14:20 UTC
776028,mainnet,244,105408000,105620180,212181,203447,8734,0.04116296935163846,2021-11-07 04:15:53 UTC
776030,mainnet,244,105408000,105620370,212371,203636,8735,0.04113085119908085,2021-11-07 04:17:33 UTC
776031,mainnet,244,105408000,105620578,212579,203844,8735,0.04109060631576967,2021-11-07 04:19:02 UTC
776033,mainnet,244,105408000,105620765,212766,204029,8737,0.04106389178722164,2021-11-07 04:20:36 UTC
776034,mainnet,244,105408000,105620954,212955,204205,8750,0.04108849287408138,2021-11-07 04:22:04 UTC
776036,mainnet,244,105408000,105621097,213098,204347,8751,0.04106561300434542,2021-11-07 04:23:33 UTC
776038,mainnet,244,105408000,105621372,213373,204601,8772,0.041111105903746024,2021-11-07 04:25:43 UTC
776039,mainnet,244,105408000,105621608,213609,204817,8792,0.04115931444836126,2021-11-07 04:27:21 UTC
776041,mainnet,244,105408000,105621782,213783,204989,8794,0.04113516977495872,2021-11-07 04:28:48 UTC
776042,mainnet,244,105408000,105621973,213974,205176,8798,0.041117145073700546,2021-11-07 04:30:20 UTC
776044,mainnet,244,105408000,105622155,214156,205355,8801,0.04109621023926484,2021-11-07 04:31:49 UTC
776045,mainnet,244,105408000,105622343,214344,205542,8802,0.04106483036614041,2021-11-07 04:33:20 UTC
776047,mainnet,244,105408000,105622550,214551,205739,8812,0.041071819753811446,2021-11-07 04:34:58 UTC
776048,mainnet,244,105408000,105622734,214735,205921,8814,0.04104594034507649,2021-11-07 04:36:28 UTC
776050,mainnet,244,105408000,105622916,214917,206094,8823,0.04105305769203925,2021-11-07 04:38:00 UTC
776051,mainnet,244,105408000,105623127,215128,206304,8824,0.041017440779442936,2021-11-07 04:39:41 UTC
776053,mainnet,244,105408000,105623306,215307,206476,8831,0.041015851783732064,2021-11-07 04:41:09 UTC
776054,mainnet,244,105408000,105623496,215497,206658,8839,0.04101681229901112,2021-11-07 04:42:38 UTC
776056,mainnet,244,105408000,105623691,215692,206848,8844,0.04100291155907498,2021-11-07 04:44:09 UTC
776057,mainnet,244,105408000,105623882,215883,207037,8846,0.040975898982319126,2021-11-07 04:45:39 UTC
776059,mainnet,244,105408000,105624064,216065,207215,8850,0.04095989632749404,2021-11-07 04:47:07 UTC
776060,mainnet,244,105408000,105624254,216255,207404,8851,0.04092853344431343,2021-11-07 04:48:38 UTC
776062,mainnet,244,105408000,105624431,216432,207576,8856,0.04091816367265469,2021-11-07 04:50:06 UTC
776063,mainnet,244,105408000,105624629,216630,207768,8862,0.040908461431934634,2021-11-07 04:51:40 UTC
776065,mainnet,244,105408000,105624816,216817,207953,8864,0.04088240313259569,2021-11-07 04:53:10 UTC
776066,mainnet,244,105408000,105625007,217008,208140,8868,0.04086485290864853,2021-11-07 04:54:42 UTC
776068,mainnet,244,105408000,105625222,217223,208343,8880,0.04087964902427459,2021-11-07 04:56:22 UTC
776069,mainnet,244,105408000,105625375,217376,208489,8887,0.040883078168703076,2021-11-07 04:57:55 UTC
776071,mainnet,244,105408000,105625584,217585,208679,8906,0.0409311303628467,2021-11-07 04:59:33 UTC
776072,mainnet,244,105408000,105625768,217769,208854,8915,0.0409378745367798,2021-11-07 05:01:08 UTC
776074,mainnet,244,105408000,105625948,217949,209023,8926,0.04095453523530734,2021-11-07 05:02:38 UTC
776075,mainnet,244,105408000,105626131,218132,209201,8931,0.04094309867419727,2021-11-07 05:04:07 UTC
776077,mainnet,244,105408000,105626310,218311,209375,8936,0.040932431256326986,2021-11-07 05:05:36 UTC
776078,mainnet,244,105408000,105626485,218486,209544,8942,0.040927107457686074,2021-11-07 05:07:07 UTC
776080,mainnet,244,105408000,105626673,218674,209726,8948,0.040919359411727044,2021-11-07 05:08:47 UTC
776081,mainnet,244,105408000,105626881,218882,209933,8949,0.04088504308257417,2021-11-07 05:10:16 UTC
776083,mainnet,244,105408000,105627074,219075,210126,8949,0.04084902430674427,2021-11-07 05:11:56 UTC
776085,mainnet,244,105408000,105627283,219284,210323,8961,0.04086481457835501,2021-11-07 05:13:34 UTC
776086,mainnet,244,105408000,105627485,219486,210508,8978,0.04090465906709312,2021-11-07 05:15:06 UTC
776088,mainnet,244,105408000,105627661,219662,210678,8984,0.04089919967950761,2021-11-07 05:16:35 UTC
776089,mainnet,244,105408000,105627848,219849,210859,8990,0.04089170294156444,2021-11-07 05:18:02 UTC
776091,mainnet,244,105408000,105628054,220055,211065,8990,0.040853423007884394,2021-11-07 05:19:41 UTC
776092,mainnet,244,105408000,105628234,220235,211235,9000,0.040865439189956186,2021-11-07 05:21:12 UTC
776094,mainnet,244,105408000,105628422,220423,211415,9008,0.04086687868325901,2021-11-07 05:22:42 UTC
776095,mainnet,244,105408000,105628618,220619,211607,9012,0.04084870296755946,2021-11-07 05:24:11 UTC
776097,mainnet,244,105408000,105628790,220791,211777,9014,0.04082593946311217,2021-11-07 05:25:37 UTC
776098,mainnet,244,105408000,105629058,221059,212045,9014,0.040776444297676184,2021-11-07 05:27:47 UTC
776100,mainnet,244,105408000,105629264,221265,212251,9014,0.04073848100693738,2021-11-07 05:29:27 UTC
776101,mainnet,244,105408000,105629454,221455,212435,9020,0.0407306224740918,2021-11-07 05:30:55 UTC
776103,mainnet,244,105408000,105629674,221675,212651,9024,0.04070824405097553,2021-11-07 05:32:43 UTC
776104,mainnet,244,105408000,105629845,221846,212813,9033,0.040717434616806256,2021-11-07 05:34:13 UTC
776106,mainnet,244,105408000,105630035,222036,212998,9038,0.040705110882919886,2021-11-07 05:35:41 UTC
776107,mainnet,244,105408000,105630212,222213,213166,9047,0.04071318959736829,2021-11-07 05:37:11 UTC
776109,mainnet,244,105408000,105630400,222401,213341,9060,0.04073722690095818,2021-11-07 05:38:42 UTC
776110,mainnet,244,105408000,105630584,222585,213525,9060,0.0407035514522542,2021-11-07 05:40:23 UTC
776111,mainnet,244,105408000,105630801,222802,213732,9070,0.04070879076489439,2021-11-07 05:42:08 UTC
776112,mainnet,244,105408000,105631024,223025,213951,9074,0.04068602174644098,2021-11-07 05:44:02 UTC
776113,mainnet,244,105408000,105631254,223255,214171,9084,0.04068889834494188,2021-11-07 05:45:50 UTC
776114,mainnet,244,105408000,105631444,223445,214347,9098,0.04071695495535814,2021-11-07 05:47:27 UTC
776116,mainnet,244,105408000,105631632,223633,214525,9108,0.040727441835507285,2021-11-07 05:48:56 UTC
776117,mainnet,244,105408000,105631810,223811,214697,9114,0.04072185906858912,2021-11-07 05:50:24 UTC
776119,mainnet,244,105408000,105631986,223987,214855,9132,0.04077022327188631,2021-11-07 05:51:51 UTC
776120,mainnet,244,105408000,105632176,224177,215044,9133,0.0407401294512818,2021-11-07 05:53:20 UTC
776122,mainnet,244,105408000,105632368,224369,215236,9133,0.04070526677036489,2021-11-07 05:54:51 UTC
776123,mainnet,244,105408000,105632535,224536,215398,9138,0.040697260127551926,2021-11-07 05:56:21 UTC
776125,mainnet,244,105408000,105632737,224738,215590,9148,0.04070517669463998,2021-11-07 05:57:53 UTC
776127,mainnet,244,105408000,105632900,224901,215750,9151,0.040689014277393167,2021-11-07 05:59:20 UTC
776128,mainnet,244,105408000,105633101,225102,215943,9159,0.04068822133965935,2021-11-07 06:00:52 UTC
776130,mainnet,244,105408000,105633283,225284,216119,9165,0.04068198362955203,2021-11-07 06:02:22 UTC
776131,mainnet,244,105408000,105633468,225469,216301,9168,0.04066190917598428,2021-11-07 06:03:52 UTC
776133,mainnet,244,105408000,105633680,225681,216507,9174,0.04065029843008494,2021-11-07 06:05:35 UTC
776134,mainnet,244,105408000,105633870,225871,216697,9174,0.0406161038823045,2021-11-07 06:07:18 UTC
776136,mainnet,244,105408000,105634099,226100,216925,9175,0.040579389650597084,2021-11-07 06:08:58 UTC
776138,mainnet,244,105408000,105634298,226299,217122,9177,0.04055254331658558,2021-11-07 06:10:34 UTC
776139,mainnet,244,105408000,105634476,226477,217300,9177,0.04052067097321141,2021-11-07 06:12:03 UTC
776141,mainnet,244,105408000,105634640,226641,217446,9195,0.040570770513719934,2021-11-07 06:13:30 UTC
776142,mainnet,244,105408000,105634827,226828,217625,9203,0.040572592448904016,2021-11-07 06:14:57 UTC
776144,mainnet,244,105408000,105634996,226997,217783,9214,0.040590844812927046,2021-11-07 06:16:27 UTC
776145,mainnet,244,105408000,105635180,227181,217957,9224,0.04060198696193784,2021-11-07 06:17:57 UTC
776147,mainnet,244,105408000,105635392,227393,218153,9240,0.040634496224597944,2021-11-07 06:19:29 UTC
776148,mainnet,244,105408000,105635582,227583,218343,9240,0.040600572098970486,2021-11-07 06:20:57 UTC
776150,mainnet,244,105408000,105635758,227759,218513,9246,0.04059554177881006,2021-11-07 06:22:23 UTC
776151,mainnet,244,105408000,105635963,227964,218717,9247,0.0405634222947483,2021-11-07 06:24:03 UTC
776153,mainnet,244,105408000,105636162,228163,218912,9251,0.040545574874103166,2021-11-07 06:25:37 UTC
776155,mainnet,244,105408000,105636351,228352,219096,9256,0.04053391255605381,2021-11-07 06:27:14 UTC
776156,mainnet,244,105408000,105636545,228546,219282,9264,0.04053450946417789,2021-11-07 06:28:46 UTC
776158,mainnet,244,105408000,105636720,228721,219456,9265,0.04050786766409731,2021-11-07 06:30:15 UTC
776159,mainnet,244,105408000,105636899,228900,219632,9268,0.04048929663608563,2021-11-07 06:31:45 UTC
776161,mainnet,244,105408000,105637071,229072,219800,9272,0.04047635677865474,2021-11-07 06:33:15 UTC
776162,mainnet,244,105408000,105637277,229278,219993,9285,0.0404966896082485,2021-11-07 06:34:44 UTC
776164,mainnet,244,105408000,105637468,229469,220184,9285,0.040462981927842104,2021-11-07 06:36:12 UTC
776165,mainnet,244,105408000,105637670,229671,220385,9286,0.040431748022170845,2021-11-07 06:37:52 UTC
776167,mainnet,244,105408000,105637848,229849,220561,9288,0.040409138173322486,2021-11-07 06:39:32 UTC
776168,mainnet,244,105408000,105638055,230056,220768,9288,0.040372778801683065,2021-11-07 06:41:00 UTC
776170,mainnet,244,105408000,105638239,230240,220947,9293,0.04036223071577484,2021-11-07 06:42:32 UTC
776172,mainnet,244,105408000,105638426,230427,221130,9297,0.040346834355348984,2021-11-07 06:44:00 UTC
776173,mainnet,244,105408000,105638604,230605,221308,9297,0.04031569133366579,2021-11-07 06:45:27 UTC
776175,mainnet,244,105408000,105638820,230821,221521,9300,0.0402909613943272,2021-11-07 06:47:08 UTC
776176,mainnet,244,105408000,105638998,230999,221694,9305,0.04028155966043143,2021-11-07 06:48:36 UTC
776178,mainnet,244,105408000,105639205,231206,221884,9322,0.040319022862728475,2021-11-07 06:50:25 UTC
776179,mainnet,244,105408000,105639388,231389,222062,9327,0.040308744149462596,2021-11-07 06:51:55 UTC
776181,mainnet,244,105408000,105639614,231615,222270,9345,0.040347127776698404,2021-11-07 06:53:35 UTC
776182,mainnet,244,105408000,105639830,231831,222481,9350,0.040331103260564806,2021-11-07 06:55:17 UTC
776184,mainnet,244,105408000,105640014,232015,222663,9352,0.04030773872378941,2021-11-07 06:56:44 UTC
776186,mainnet,244,105408000,105640194,232195,222841,9354,0.04028510519175693,2021-11-07 06:58:13 UTC
776187,mainnet,244,105408000,105640383,232384,223018,9366,0.04030397961993941,2021-11-07 06:59:41 UTC
776189,mainnet,244,105408000,105640598,232599,223221,9378,0.04031831607186617,2021-11-07 07:01:25 UTC
776190,mainnet,244,105408000,105640782,232783,223405,9378,0.040286447034362474,2021-11-07 07:02:54 UTC
776192,mainnet,244,105408000,105640961,232962,223583,9379,0.04025978485761626,2021-11-07 07:04:23 UTC
776193,mainnet,244,105408000,105641194,233195,223810,9385,0.04024528827805056,2021-11-07 07:06:11 UTC
776195,mainnet,244,105408000,105641404,233405,224020,9385,0.04020907864013196,2021-11-07 07:07:50 UTC
776196,mainnet,244,105408000,105641590,233591,224202,9389,0.040194185563656136,2021-11-07 07:09:22 UTC
776198,mainnet,244,105408000,105641828,233829,224430,9399,0.04019604069640635,2021-11-07 07:11:22 UTC
776200,mainnet,244,105408000,105642020,234021,224613,9408,0.040201520376376476,2021-11-07 07:12:53 UTC
776201,mainnet,244,105408000,105642214,234215,224803,9412,0.04018529983135154,2021-11-07 07:14:33 UTC
776203,mainnet,244,105408000,105642393,234394,224980,9414,0.04016314410778433,2021-11-07 07:16:05 UTC
776204,mainnet,244,105408000,105642625,234626,225206,9420,0.04014900309428623,2021-11-07 07:17:55 UTC
776206,mainnet,244,105408000,105642804,234805,225384,9421,0.04012265496901685,2021-11-07 07:19:23 UTC
776207,mainnet,244,105408000,105642980,234981,225553,9428,0.0401223928743175,2021-11-07 07:20:55 UTC
776209,mainnet,244,105408000,105643192,235193,225756,9437,0.04012449350108209,2021-11-07 07:22:31 UTC
776211,mainnet,244,105408000,105643382,235383,225942,9441,0.04010909878793286,2021-11-07 07:24:00 UTC
776212,mainnet,244,105408000,105643575,235576,226126,9450,0.040114442897408904,2021-11-07 07:25:31 UTC
776214,mainnet,244,105408000,105643790,235791,226337,9454,0.04009482974328961,2021-11-07 07:27:10 UTC
776215,mainnet,244,105408000,105643976,235977,226517,9460,0.04008865270767914,2021-11-07 07:28:41 UTC
776217,mainnet,244,105408000,105644152,236153,226692,9461,0.040063009997755694,2021-11-07 07:30:14 UTC
776218,mainnet,244,105408000,105644353,236354,226884,9470,0.04006701811689246,2021-11-07 07:31:46 UTC
776220,mainnet,244,105408000,105644562,236563,227092,9471,0.040035846687774504,2021-11-07 07:33:27 UTC
776221,mainnet,244,105408000,105644754,236755,227282,9473,0.040011826571772505,2021-11-07 07:35:07 UTC
776223,mainnet,244,105408000,105644945,236946,227462,9484,0.04002599748465895,2021-11-07 07:36:38 UTC
776224,mainnet,244,105408000,105645156,237157,227664,9493,0.04002833565949983,2021-11-07 07:38:20 UTC
776226,mainnet,244,105408000,105645340,237341,227837,9504,0.04004365027534223,2021-11-07 07:39:48 UTC
776228,mainnet,244,105408000,105645504,237505,227995,9510,0.040041262289214966,2021-11-07 07:41:16 UTC
776229,mainnet,244,105408000,105645678,237679,228166,9513,0.04002457095494343,2021-11-07 07:42:57 UTC
776231,mainnet,244,105408000,105645892,237893,228372,9521,0.04002219485230755,2021-11-07 07:44:26 UTC
776232,mainnet,244,105408000,105646077,238078,228551,9527,0.040016297179915825,2021-11-07 07:45:58 UTC
776234,mainnet,244,105408000,105646287,238288,228753,9535,0.04001460417645874,2021-11-07 07:47:39 UTC
776235,mainnet,244,105408000,105646474,238475,228936,9539,0.04,2021-11-07 07:49:09 UTC
776237,mainnet,244,105408000,105646651,238652,229111,9541,0.03997871377570689,2021-11-07 07:50:37 UTC
776238,mainnet,244,105408000,105646830,238831,229284,9547,0.039973872738463596,2021-11-07 07:52:06 UTC
776240,mainnet,244,105408000,105647020,239021,229473,9548,0.03994628087071847,2021-11-07 07:53:37 UTC
776241,mainnet,244,105408000,105647202,239203,229655,9548,0.039915887342550055,2021-11-07 07:55:06 UTC
776243,mainnet,244,105408000,105647386,239387,229821,9566,0.039960398852067994,2021-11-07 07:56:36 UTC
776244,mainnet,244,105408000,105647563,239564,229989,9575,0.03996844267085205,2021-11-07 07:58:03 UTC
776246,mainnet,244,105408000,105647750,239751,230170,9581,0.03996229421357992,2021-11-07 07:59:32 UTC
776247,mainnet,244,105408000,105647942,239943,230361,9582,0.03993448444005451,2021-11-07 08:01:18 UTC
776248,mainnet,244,105408000,105648137,240138,230526,9612,0.040026984483921745,2021-11-07 08:02:48 UTC
776250,mainnet,244,105408000,105648310,240311,230687,9624,0.04004810433147047,2021-11-07 08:04:16 UTC
776252,mainnet,244,105408000,105648522,240523,230883,9640,0.0400793271329561,2021-11-07 08:05:56 UTC
776253,mainnet,244,105408000,105648699,240700,231047,9653,0.04010386373078521,2021-11-07 08:07:28 UTC
776255,mainnet,244,105408000,105648910,240911,231247,9664,0.040114399093441146,2021-11-07 08:09:17 UTC
776256,mainnet,244,105408000,105649105,241106,231436,9670,0.04010684097450914,2021-11-07 08:10:53 UTC
776258,mainnet,244,105408000,105649302,241303,231631,9672,0.040082386045759894,2021-11-07 08:12:34 UTC
776259,mainnet,244,105408000,105649470,241471,231780,9691,0.04013318369493645,2021-11-07 08:14:04 UTC
776261,mainnet,244,105408000,105649672,241673,231977,9696,0.04012032788106243,2021-11-07 08:15:52 UTC
776263,mainnet,244,105408000,105649900,241901,232175,9726,0.04020653077085254,2021-11-07 08:17:52 UTC
776264,mainnet,244,105408000,105650070,242071,232344,9727,0.04018242581721892,2021-11-07 08:19:22 UTC
776266,mainnet,244,105408000,105650262,242263,232527,9736,0.040187729863825676,2021-11-07 08:20:50 UTC
776267,mainnet,244,105408000,105650508,242509,232764,9745,0.040184075642553475,2021-11-07 08:22:56 UTC
776269,mainnet,244,105408000,105650693,242694,232945,9749,0.040169925914938155,2021-11-07 08:24:35 UTC
776270,mainnet,244,105408000,105650902,242903,233141,9762,0.0401888819816964,2021-11-07 08:26:07 UTC
776272,mainnet,244,105408000,105651096,243097,233335,9762,0.04015680983311189,2021-11-07 08:27:56 UTC
776274,mainnet,244,105408000,105651312,243313,233539,9774,0.04017047999901362,2021-11-07 08:29:25 UTC
776275,mainnet,244,105408000,105651487,243488,233706,9782,0.04017446444999343,2021-11-07 08:31:05 UTC
776277,mainnet,244,105408000,105651685,243686,233898,9788,0.04016644370214128,2021-11-07 08:32:41 UTC
776278,mainnet,244,105408000,105651891,243892,234098,9794,0.04015711872468142,2021-11-07 08:34:10 UTC
776280,mainnet,244,105408000,105652078,244079,234284,9795,0.04013044956755805,2021-11-07 08:35:40 UTC
776281,mainnet,244,105408000,105652257,244258,234461,9797,0.04010922876630448,2021-11-07 08:37:18 UTC
776283,mainnet,244,105408000,105652462,244463,234661,9802,0.040096047254594765,2021-11-07 08:38:47 UTC
776284,mainnet,244,105408000,105652660,244661,234851,9810,0.04009629650822975,2021-11-07 08:40:19 UTC
776286,mainnet,244,105408000,105652837,244838,235019,9819,0.04010406881284768,2021-11-07 08:41:47 UTC
776287,mainnet,244,105408000,105653020,245021,235194,9827,0.0401067663588019,2021-11-07 08:43:14 UTC
776289,mainnet,244,105408000,105653204,245205,235373,9832,0.0400970616422993,2021-11-07 08:44:45 UTC
776290,mainnet,244,105408000,105653375,245376,235539,9837,0.04008949530516432,2021-11-07 08:46:14 UTC
776292,mainnet,244,105408000,105653576,245577,235735,9842,0.04007704304556208,2021-11-07 08:47:51 UTC
776293,mainnet,244,105408000,105653778,245779,235925,9854,0.04009292901346331,2021-11-07 08:49:32 UTC
776295,mainnet,244,105408000,105653966,245967,236104,9863,0.04009887505234442,2021-11-07 08:51:02 UTC
776296,mainnet,244,105408000,105654145,246146,236282,9864,0.040073777351653087,2021-11-07 08:52:33 UTC
776298,mainnet,244,105408000,105654332,246333,236459,9874,0.040083951399122325,2021-11-07 08:54:02 UTC
776299,mainnet,244,105408000,105654520,246521,236642,9879,0.040073665123863685,2021-11-07 08:55:33 UTC
776301,mainnet,244,105408000,105654702,246703,236824,9879,0.040044101612059846,2021-11-07 08:56:59 UTC
776302,mainnet,244,105408000,105654892,246893,237010,9883,0.04002948645769625,2021-11-07 08:58:30 UTC
776304,mainnet,244,105408000,105655073,247074,237187,9887,0.04001635137651068,2021-11-07 08:59:59 UTC
776305,mainnet,244,105408000,105655272,247273,237377,9896,0.040020544094988134,2021-11-07 09:01:35 UTC
776307,mainnet,244,105408000,105655448,247449,237544,9905,0.04002845030693193,2021-11-07 09:03:03 UTC
776308,mainnet,244,105408000,105655613,247614,237703,9911,0.040026008222475304,2021-11-07 09:04:30 UTC
776310,mainnet,244,105408000,105655796,247797,237874,9923,0.04004487544239842,2021-11-07 09:06:07 UTC
776311,mainnet,244,105408000,105655987,247988,238056,9932,0.04005032501572657,2021-11-07 09:07:39 UTC
776313,mainnet,244,105408000,105656177,248178,238242,9936,0.04003578077025361,2021-11-07 09:09:09 UTC
776315,mainnet,244,105408000,105656340,248341,238398,9943,0.04003769011158045,2021-11-07 09:10:40 UTC
776316,mainnet,244,105408000,105656533,248534,238580,9954,0.040050858232676415,2021-11-07 09:12:09 UTC
776318,mainnet,244,105408000,105656715,248716,238755,9961,0.04004969523472555,2021-11-07 09:13:39 UTC
776319,mainnet,244,105408000,105656896,248897,238928,9969,0.04005271256784935,2021-11-07 09:15:08 UTC
776321,mainnet,244,105408000,105657092,249093,239120,9973,0.040037255161726744,2021-11-07 09:16:41 UTC
776322,mainnet,244,105408000,105657272,249273,239296,9977,0.04002439092882101,2021-11-07 09:18:10 UTC
776324,mainnet,244,105408000,105657468,249469,239483,9986,0.04002902164196754,2021-11-07 09:19:38 UTC
776325,mainnet,244,105408000,105657659,249660,239669,9991,0.04001842505807899,2021-11-07 09:21:09 UTC
776327,mainnet,244,105408000,105657847,249848,239856,9992,0.039992315327719255,2021-11-07 09:22:41 UTC
776328,mainnet,244,105408000,105658030,250031,240032,9999,0.03999104111090225,2021-11-07 09:24:08 UTC
776330,mainnet,244,105408000,105658264,250265,240259,10006,0.03998161948334765,2021-11-07 09:26:05 UTC
776331,mainnet,244,105408000,105658488,250489,240468,10021,0.04000574875543437,2021-11-07 09:28:06 UTC
776333,mainnet,244,105408000,105658699,250700,240679,10021,0.03997207818109294,2021-11-07 09:29:37 UTC
776334,mainnet,244,105408000,105658880,250881,240859,10022,0.03994722597566177,2021-11-07 09:31:09 UTC
776336,mainnet,244,105408000,105659066,251067,241041,10026,0.039933563550765334,2021-11-07 09:32:37 UTC
776338,mainnet,244,105408000,105659266,251267,241231,10036,0.0399415760923639,2021-11-07 09:34:17 UTC
776339,mainnet,244,105408000,105659458,251459,241415,10044,0.039942893274847985,2021-11-07 09:35:43 UTC
776341,mainnet,244,105408000,105659652,251653,241608,10045,0.039916074912677374,2021-11-07 09:37:38 UTC
776342,mainnet,244,105408000,105659902,251903,241852,10051,0.039900279075675955,2021-11-07 09:39:27 UTC
776344,mainnet,244,105408000,105660083,252084,242027,10057,0.03989543168150299,2021-11-07 09:40:57 UTC
776345,mainnet,244,105408000,105660256,252257,242195,10062,0.039887892110030645,2021-11-07 09:42:21 UTC
776347,mainnet,244,105408000,105660432,252433,242364,10069,0.039887811815412406,2021-11-07 09:43:49 UTC
776348,mainnet,244,105408000,105660670,252671,242592,10079,0.03988981719310883,2021-11-07 09:45:52 UTC
776350,mainnet,244,105408000,105660871,252872,242788,10084,0.03987788288145781,2021-11-07 09:47:29 UTC
776351,mainnet,244,105408000,105661049,253050,242956,10094,0.039889349930843705,2021-11-07 09:48:57 UTC
776353,mainnet,244,105408000,105661256,253257,243146,10111,0.039923871798212884,2021-11-07 09:50:37 UTC
776354,mainnet,244,105408000,105661431,253432,243319,10113,0.03990419520818208,2021-11-07 09:52:10 UTC
776355,mainnet,244,105408000,105661608,253609,243483,10126,0.039927605092879195,2021-11-07 09:53:39 UTC
776357,mainnet,244,105408000,105661787,253788,243656,10132,0.039923085409869656,2021-11-07 09:55:10 UTC
776358,mainnet,244,105408000,105661993,253994,243857,10137,0.03991039158405316,2021-11-07 09:56:51 UTC
776360,mainnet,244,105408000,105662175,254176,244031,10145,0.039913288430064205,2021-11-07 09:58:22 UTC
776361,mainnet,244,105408000,105662357,254358,244197,10161,0.03994763286391621,2021-11-07 09:59:52 UTC
776363,mainnet,244,105408000,105662531,254532,244367,10165,0.03993603947637232,2021-11-07 10:01:25 UTC
776364,mainnet,244,105408000,105662688,254689,244510,10179,0.039966390381995294,2021-11-07 10:02:52 UTC
776366,mainnet,244,105408000,105662885,254886,244691,10195,0.03999827373806329,2021-11-07 10:04:20 UTC
776367,mainnet,244,105408000,105663058,255059,244853,10206,0.04001427120783819,2021-11-07 10:05:51 UTC
776369,mainnet,244,105408000,105663237,255238,245018,10220,0.04004105971681333,2021-11-07 10:07:20 UTC
776370,mainnet,244,105408000,105663398,255399,245164,10235,0.040074550017815264,2021-11-07 10:08:47 UTC
776372,mainnet,244,105408000,105663570,255571,245318,10253,0.04011801025937998,2021-11-07 10:10:17 UTC
776373,mainnet,244,105408000,105663731,255732,245472,10260,0.0401201257566515,2021-11-07 10:11:46 UTC
776375,mainnet,244,105408000,105663917,255918,245653,10265,0.04011050414585922,2021-11-07 10:13:17 UTC
776376,mainnet,244,105408000,105664096,256097,245830,10267,0.04009027829299055,2021-11-07 10:14:46 UTC
776378,mainnet,244,105408000,105664260,256261,245982,10279,0.040111448874389784,2021-11-07 10:16:14 UTC
776379,mainnet,244,105408000,105664449,256450,246150,10300,0.040163774614934686,2021-11-07 10:17:42 UTC
776381,mainnet,244,105408000,105664626,256627,246317,10310,0.040175040038655324,2021-11-07 10:19:12 UTC
776382,mainnet,244,105408000,105664808,256809,246495,10314,0.04016214385009871,2021-11-07 10:20:44 UTC
776384,mainnet,244,105408000,105664994,256995,246662,10333,0.04020700791844199,2021-11-07 10:22:14 UTC
776385,mainnet,244,105408000,105665186,257187,246845,10342,0.04021198583132118,2021-11-07 10:23:42 UTC
776387,mainnet,244,105408000,105665370,257371,247024,10347,0.04020266463587584,2021-11-07 10:25:11 UTC
776388,mainnet,244,105408000,105665554,257555,247208,10347,0.04017394342955873,2021-11-07 10:26:40 UTC
776390,mainnet,244,105408000,105665742,257743,247389,10354,0.04017179904012912,2021-11-07 10:28:13 UTC
776391,mainnet,244,105408000,105665923,257924,247566,10358,0.040159116639009944,2021-11-07 10:29:41 UTC
776393,mainnet,244,105408000,105666108,258109,247751,10358,0.04013033253392946,2021-11-07 10:31:15 UTC
776394,mainnet,244,105408000,105666279,258280,247912,10368,0.04014248102834134,2021-11-07 10:32:41 UTC
776396,mainnet,244,105408000,105666464,258465,248073,10392,0.04020660437583425,2021-11-07 10:34:10 UTC
776397,mainnet,244,105408000,105666644,258645,248243,10402,0.04021728624175994,2021-11-07 10:35:38 UTC
776399,mainnet,244,105408000,105666822,258823,248416,10407,0.04020894588193476,2021-11-07 10:37:07 UTC
776400,mainnet,244,105408000,105666996,258997,248586,10411,0.04019737680359232,2021-11-07 10:38:36 UTC
776402,mainnet,244,105408000,105667212,259213,248797,10416,0.04018316982558745,2021-11-07 10:40:19 UTC
776403,mainnet,244,105408000,105667387,259388,248972,10416,0.040156059648094745,2021-11-07 10:41:54 UTC
776405,mainnet,244,105408000,105667600,259601,249172,10429,0.04017318885520472,2021-11-07 10:43:26 UTC
776406,mainnet,244,105408000,105667780,259781,249348,10433,0.04016075078623918,2021-11-07 10:45:06 UTC
776408,mainnet,244,105408000,105667984,259985,249543,10442,0.04016385560705425,2021-11-07 10:46:38 UTC
776409,mainnet,244,105408000,105668171,260172,249717,10455,0.040184954568516215,2021-11-07 10:48:04 UTC
776411,mainnet,244,105408000,105668395,260396,249934,10462,0.04017726846802562,2021-11-07 10:50:03 UTC
776412,mainnet,244,105408000,105668600,260601,250133,10468,0.04016868699659633,2021-11-07 10:51:34 UTC
776414,mainnet,244,105408000,105668779,260780,250303,10477,0.040175626965258074,2021-11-07 10:53:07 UTC
776415,mainnet,244,105408000,105668962,260963,250476,10487,0.04018577346213831,2021-11-07 10:54:35 UTC
776417,mainnet,244,105408000,105669136,261137,250644,10493,0.04018197344688803,2021-11-07 10:56:05 UTC
776418,mainnet,244,105408000,105669316,261317,250823,10494,0.04015812212753093,2021-11-07 10:57:37 UTC
776420,mainnet,244,105408000,105669518,261519,251015,10504,0.04016534171513351,2021-11-07 10:59:06 UTC
776421,mainnet,244,105408000,105669709,261710,251201,10509,0.040155133544763286,2021-11-07 11:00:40 UTC
776423,mainnet,244,105408000,105669953,261954,251425,10529,0.04019407987661956,2021-11-07 11:02:50 UTC
776424,mainnet,244,105408000,105670138,262139,251607,10532,0.04017715792003479,2021-11-07 11:04:28 UTC
776426,mainnet,244,105408000,105670330,262331,251791,10540,0.040178248091152016,2021-11-07 11:05:57 UTC
776427,mainnet,244,105408000,105670511,262512,251960,10552,0.04019625769488633,2021-11-07 11:07:27 UTC
776429,mainnet,244,105408000,105670680,262681,252115,10566,0.04022369337713805,2021-11-07 11:08:58 UTC
776430,mainnet,244,105408000,105670866,262867,252288,10579,0.04024468647643105,2021-11-07 11:10:26 UTC
776432,mainnet,244,105408000,105671056,263057,252468,10589,0.04025363324298536,2021-11-07 11:12:00 UTC
776433,mainnet,244,105408000,105671240,263241,252648,10593,0.040240691989469723,2021-11-07 11:13:27 UTC
776435,mainnet,244,105408000,105671450,263451,252846,10605,0.04025416491112199,2021-11-07 11:15:08 UTC
776436,mainnet,244,105408000,105671627,263628,253023,10605,0.04022713824024762,2021-11-07 11:16:35 UTC
776438,mainnet,244,105408000,105671809,263810,253193,10617,0.04024487320419999,2021-11-07 11:18:05 UTC
776439,mainnet,244,105408000,105672032,264033,253410,10623,0.04023360716274102,2021-11-07 11:19:46 UTC
776441,mainnet,244,105408000,105672209,264210,253577,10633,0.040244502479088604,2021-11-07 11:21:21 UTC
776442,mainnet,244,105408000,105672390,264391,253746,10645,0.04026233873316414,2021-11-07 11:22:44 UTC
776444,mainnet,244,105408000,105672573,264574,253925,10649,0.04024960880509801,2021-11-07 11:24:15 UTC
776445,mainnet,244,105408000,105672752,264753,254089,10664,0.040279052550868166,2021-11-07 11:25:46 UTC
776447,mainnet,244,105408000,105672952,264953,254284,10669,0.040267519144904944,2021-11-07 11:27:19 UTC
776448,mainnet,244,105408000,105673132,265133,254457,10676,0.04026658318655166,2021-11-07 11:28:46 UTC
776450,mainnet,244,105408000,105673331,265332,254646,10686,0.040274071729003665,2021-11-07 11:30:22 UTC
776451,mainnet,244,105408000,105673496,265497,254809,10688,0.0402565754038652,2021-11-07 11:31:47 UTC
776453,mainnet,244,105408000,105673678,265679,254982,10697,0.040262873618163275,2021-11-07 11:33:18 UTC
776454,mainnet,244,105408000,105673894,265895,255180,10715,0.040297861937983036,2021-11-07 11:34:58 UTC
776456,mainnet,244,105408000,105674090,266091,255375,10716,0.04027193704409394,2021-11-07 11:36:31 UTC
776457,mainnet,244,105408000,105674270,266271,255553,10718,0.04025222423771271,2021-11-07 11:38:04 UTC
776459,mainnet,244,105408000,105674442,266443,255714,10729,0.04026752438607882,2021-11-07 11:39:32 UTC
776460,mainnet,244,105408000,105674623,266624,255890,10734,0.0402589414306289,2021-11-07 11:41:03 UTC
776462,mainnet,244,105408000,105674797,266798,256060,10738,0.04024767801857585,2021-11-07 11:42:34 UTC
776463,mainnet,244,105408000,105674990,266991,256247,10744,0.040241056814649186,2021-11-07 11:44:05 UTC
776465,mainnet,244,105408000,105675176,267177,256425,10752,0.04024298498748021,2021-11-07 11:45:35 UTC
776466,mainnet,244,105408000,105675337,267338,256577,10761,0.04025241454637949,2021-11-07 11:47:02 UTC
776468,mainnet,244,105408000,105675533,267534,256760,10774,0.04027151689131101,2021-11-07 11:48:35 UTC
776469,mainnet,244,105408000,105675721,267722,256947,10775,0.040246972605912104,2021-11-07 11:50:09 UTC
776471,mainnet,244,105408000,105675893,267894,257111,10783,0.04025099479644934,2021-11-07 11:51:37 UTC
776472,mainnet,244,105408000,105676069,268070,257282,10788,0.04024322005446339,2021-11-07 11:53:07 UTC
776474,mainnet,244,105408000,105676252,268253,257454,10799,0.040256772524445206,2021-11-07 11:54:47 UTC
776475,mainnet,244,105408000,105676485,268486,257680,10806,0.04024790864328121,2021-11-07 11:56:28 UTC
776477,mainnet,244,105408000,105676672,268673,257861,10812,0.040242227540541846,2021-11-07 11:58:01 UTC
776478,mainnet,244,105408000,105676856,268857,258027,10830,0.04028163670650197,2021-11-07 11:59:36 UTC
776480,mainnet,244,105408000,105677040,269041,258207,10834,0.04026895528934252,2021-11-07 12:01:09 UTC
776481,mainnet,244,105408000,105677215,269216,258373,10843,0.04027620943777487,2021-11-07 12:02:40 UTC
776483,mainnet,244,105408000,105677504,269505,258650,10855,0.040277545871134114,2021-11-07 12:04:58 UTC
776485,mainnet,244,105408000,105677757,269758,258896,10862,0.040265719645015165,2021-11-07 12:07:08 UTC
776486,mainnet,244,105408000,105677972,269973,259089,10884,0.04031514262537365,2021-11-07 12:08:46 UTC
776488,mainnet,244,105408000,105678152,270153,259263,10890,0.04031049072192424,2021-11-07 12:10:15 UTC
776490,mainnet,244,105408000,105678368,270369,259467,10902,0.04032267012860202,2021-11-07 12:12:23 UTC
776491,mainnet,244,105408000,105678626,270627,259713,10914,0.04032857032003458,2021-11-07 12:14:02 UTC
776493,mainnet,244,105408000,105678808,270809,259894,10915,0.040305159725119916,2021-11-07 12:15:32 UTC
776494,mainnet,244,105408000,105679018,271019,260094,10925,0.040310826916194066,2021-11-07 12:17:21 UTC
776496,mainnet,244,105408000,105679237,271238,260292,10946,0.04035570237208651,2021-11-07 12:19:00 UTC
776497,mainnet,244,105408000,105679440,271441,260477,10964,0.040391834689674735,2021-11-07 12:20:42 UTC
776499,mainnet,244,105408000,105679626,271627,260655,10972,0.040393628026668925,2021-11-07 12:22:13 UTC
776500,mainnet,244,105408000,105679789,271790,260815,10975,0.040380440781485706,2021-11-07 12:23:41 UTC
776502,mainnet,244,105408000,105679984,271985,261002,10983,0.0403809033586411,2021-11-07 12:25:19 UTC
776504,mainnet,244,105408000,105680179,272180,261185,10995,0.04039606142993607,2021-11-07 12:26:58 UTC
776505,mainnet,244,105408000,105680384,272385,261384,11001,0.040387686546616,2021-11-07 12:28:42 UTC
776507,mainnet,244,105408000,105680577,272578,261562,11016,0.0404141199950106,2021-11-07 12:30:13 UTC
776508,mainnet,244,105408000,105680768,272769,261743,11026,0.04042248202691655,2021-11-07 12:31:42 UTC
776510,mainnet,244,105408000,105680946,272947,261912,11035,0.04042909429303125,2021-11-07 12:33:11 UTC
776511,mainnet,244,105408000,105681149,273150,262107,11043,0.04042833607907743,2021-11-07 12:34:51 UTC
776513,mainnet,244,105408000,105681341,273342,262289,11053,0.04043652274440079,2021-11-07 12:36:25 UTC
776514,mainnet,244,105408000,105681535,273536,262476,11060,0.0404334347215723,2021-11-07 12:37:56 UTC
776516,mainnet,244,105408000,105681715,273716,262655,11061,0.04041049847286969,2021-11-07 12:39:27 UTC
776517,mainnet,244,105408000,105681918,273919,262844,11075,0.0404316604543679,2021-11-07 12:41:06 UTC
776519,mainnet,244,105408000,105682091,274092,263013,11079,0.040420734643842215,2021-11-07 12:42:34 UTC
776520,mainnet,244,105408000,105682259,274260,263168,11092,0.04044337489973018,2021-11-07 12:44:06 UTC
776522,mainnet,244,105408000,105682472,274473,263371,11102,0.0404484229778521,2021-11-07 12:45:48 UTC
776523,mainnet,244,105408000,105682684,274685,263574,11111,0.04044996996559696,2021-11-07 12:47:32 UTC
776525,mainnet,244,105408000,105682870,274871,263747,11124,0.04046989314987758,2021-11-07 12:49:01 UTC
776526,mainnet,244,105408000,105683033,275034,263901,11133,0.040478631732803944,2021-11-07 12:50:30 UTC
776528,mainnet,244,105408000,105683238,275239,264092,11147,0.040499347839514026,2021-11-07 12:52:09 UTC
776529,mainnet,244,105408000,105683420,275421,264265,11156,0.04050526285214272,2021-11-07 12:53:41 UTC
776531,mainnet,244,105408000,105683614,275615,264455,11160,0.04049126498920596,2021-11-07 12:55:13 UTC
776532,mainnet,244,105408000,105683781,275782,264622,11160,0.0404667454728735,2021-11-07 12:56:44 UTC
776534,mainnet,244,105408000,105683977,275978,264800,11178,0.04050322851821522,2021-11-07 12:58:12 UTC
776535,mainnet,244,105408000,105684150,276151,264973,11178,0.04047785450713559,2021-11-07 12:59:38 UTC
776537,mainnet,244,105408000,105684339,276340,265150,11190,0.040493594846927695,2021-11-07 13:01:15 UTC
776538,mainnet,244,105408000,105684569,276570,265375,11195,0.04047799833676827,2021-11-07 13:03:14 UTC
776540,mainnet,244,105408000,105684806,276807,265606,11201,0.04046501714190754,2021-11-07 13:05:02 UTC
776541,mainnet,244,105408000,105685002,277003,265793,11210,0.04046887578834886,2021-11-07 13:06:40 UTC
776543,mainnet,244,105408000,105685200,277201,265985,11216,0.0404616144963402,2021-11-07 13:08:33 UTC
776544,mainnet,244,105408000,105685420,277421,266186,11235,0.04049801565130253,2021-11-07 13:10:13 UTC
776546,mainnet,244,105408000,105685625,277626,266370,11256,0.0405437531066975,2021-11-07 13:12:02 UTC
776548,mainnet,244,105408000,105685856,277857,266588,11269,0.040556833191173876,2021-11-07 13:13:52 UTC
776549,mainnet,244,105408000,105686068,278069,266783,11286,0.04058704853831243,2021-11-07 13:15:37 UTC
776551,mainnet,244,105408000,105686268,278269,266972,11297,0.04059740754449831,2021-11-07 13:17:18 UTC
776552,mainnet,244,105408000,105686468,278469,267162,11307,0.040604160606746174,2021-11-07 13:18:56 UTC
776554,mainnet,244,105408000,105686668,278669,267357,11312,0.04059296154218804,2021-11-07 13:20:32 UTC
776555,mainnet,244,105408000,105686903,278904,267572,11332,0.04063046783122508,2021-11-07 13:22:27 UTC
776557,mainnet,244,105408000,105687113,279114,267769,11345,0.040646474200505885,2021-11-07 13:24:05 UTC
776558,mainnet,244,105408000,105687303,279304,267950,11354,0.04065104688797869,2021-11-07 13:25:38 UTC
776560,mainnet,244,105408000,105687453,279454,268082,11372,0.04069363830898824,2021-11-07 13:27:07 UTC
776561,mainnet,244,105408000,105687745,279746,268359,11387,0.040704782195277144,2021-11-07 13:29:28 UTC
776563,mainnet,244,105408000,105687983,279984,268574,11410,0.0407523287044974,2021-11-07 13:31:26 UTC
776565,mainnet,244,105408000,105688181,280182,268755,11427,0.04078420455275499,2021-11-07 13:33:10 UTC
776566,mainnet,244,105408000,105688365,280366,268930,11436,0.04078953938780023,2021-11-07 13:34:39 UTC
776568,mainnet,244,105408000,105688535,280536,269088,11448,0.04080759688596116,2021-11-07 13:36:10 UTC
776569,mainnet,244,105408000,105688742,280743,269276,11467,0.04084518581050997,2021-11-07 13:37:50 UTC
776571,mainnet,244,105408000,105688972,280973,269498,11475,0.04084022308193314,2021-11-07 13:39:43 UTC
776572,mainnet,244,105408000,105689196,281197,269715,11482,0.04083258356241354,2021-11-07 13:41:36 UTC
776574,mainnet,244,105408000,105689414,281415,269931,11484,0.04080805927189382,2021-11-07 13:43:19 UTC
776576,mainnet,244,105408000,105689601,281602,270117,11485,0.0407845114736401,2021-11-07 13:44:52 UTC
776577,mainnet,244,105408000,105689786,281787,270293,11494,0.04078967447043334,2021-11-07 13:46:25 UTC
776579,mainnet,244,105408000,105690012,282013,270515,11498,0.04077117012336311,2021-11-07 13:48:20 UTC
776580,mainnet,244,105408000,105690178,282179,270679,11500,0.04075427299692748,2021-11-07 13:49:48 UTC
776582,mainnet,244,105408000,105690365,282366,270861,11505,0.04074499054418733,2021-11-07 13:51:21 UTC
776583,mainnet,244,105408000,105690530,282531,271019,11512,0.040745971238554356,2021-11-07 13:52:52 UTC
776585,mainnet,244,105408000,105690722,282723,271195,11528,0.04077489273953658,2021-11-07 13:54:22 UTC
776586,mainnet,244,105408000,105690899,282900,271367,11533,0.040767055496641925,2021-11-07 13:55:54 UTC
776588,mainnet,244,105408000,105691073,283074,271533,11541,0.04077025795375061,2021-11-07 13:57:24 UTC
776589,mainnet,244,105408000,105691261,283262,271713,11549,0.04077144128051062,2021-11-07 13:58:56 UTC
776591,mainnet,244,105408000,105691490,283491,271931,11560,0.040777308627081635,2021-11-07 14:00:44 UTC
776592,mainnet,244,105408000,105691691,283692,272124,11568,0.04077661689437841,2021-11-07 14:02:24 UTC
776594,mainnet,244,105408000,105691866,283867,272294,11573,0.04076909256799839,2021-11-07 14:03:53 UTC
776595,mainnet,244,105408000,105692040,284041,272463,11578,0.04076172101914864,2021-11-07 14:05:23 UTC
776597,mainnet,244,105408000,105692222,284223,272641,11582,0.04074969302273215,2021-11-07 14:07:01 UTC
776598,mainnet,244,105408000,105692411,284412,272825,11587,0.040740193803355695,2021-11-07 14:08:32 UTC
776600,mainnet,244,105408000,105692618,284619,273010,11609,0.04078786026231559,2021-11-07 14:10:10 UTC
776601,mainnet,244,105408000,105692816,284817,273203,11614,0.04077706035805447,2021-11-07 14:11:53 UTC
776603,mainnet,244,105408000,105693034,285035,273401,11634,0.04081604013542196,2021-11-07 14:13:32 UTC
776604,mainnet,244,105408000,105693198,285199,273548,11651,0.04085217690104103,2021-11-07 14:15:01 UTC
776606,mainnet,244,105408000,105693414,285415,273755,11660,0.04085279330098278,2021-11-07 14:16:41 UTC
776608,mainnet,244,105408000,105693597,285598,273927,11671,0.04086513210876827,2021-11-07 14:18:13 UTC
776609,mainnet,244,105408000,105693774,285775,274104,11671,0.04083982153792319,2021-11-07 14:19:43 UTC
776611,mainnet,244,105408000,105693961,285962,274277,11685,0.04086207258307048,2021-11-07 14:21:16 UTC
776612,mainnet,244,105408000,105694145,286146,274455,11691,0.04085676542743914,2021-11-07 14:22:43 UTC
776614,mainnet,244,105408000,105694346,286347,274643,11704,0.04087348566599266,2021-11-07 14:24:24 UTC
776615,mainnet,244,105408000,105694504,286505,274788,11717,0.040896319435960976,2021-11-07 14:25:56 UTC
776617,mainnet,244,105408000,105694715,286716,274974,11742,0.040953417318880005,2021-11-07 14:27:29 UTC
776618,mainnet,244,105408000,105694904,286905,275160,11745,0.040936895488053536,2021-11-07 14:29:07 UTC
776620,mainnet,244,105408000,105695103,287104,275351,11753,0.04093638542131074,2021-11-07 14:30:50 UTC
776621,mainnet,244,105408000,105695290,287291,275529,11762,0.04094106672328754,2021-11-07 14:32:20 UTC
776623,mainnet,244,105408000,105695471,287472,275701,11771,0.040946596538097624,2021-11-07 14:33:51 UTC
776624,mainnet,244,105408000,105695658,287659,275873,11786,0.04097212324314553,2021-11-07 14:35:21 UTC
776626,mainnet,244,105408000,105695859,287860,276068,11792,0.040964357673869245,2021-11-07 14:36:59 UTC
776627,mainnet,244,105408000,105696036,288037,276241,11796,0.04095307200116652,2021-11-07 14:38:27 UTC
776629,mainnet,244,105408000,105696233,288234,276433,11801,0.040942428721108544,2021-11-07 14:40:06 UTC
776630,mainnet,244,105408000,105696395,288396,276585,11811,0.04095410477260433,2021-11-07 14:41:45 UTC
776632,mainnet,244,105408000,105696619,288620,276796,11824,0.04096736192918024,2021-11-07 14:43:14 UTC
776634,mainnet,244,105408000,105696834,288835,276993,11842,0.040999186386691366,2021-11-07 14:45:16 UTC
776635,mainnet,244,105408000,105697054,289055,277189,11866,0.04105101105325976,2021-11-07 14:46:48 UTC
776637,mainnet,244,105408000,105697266,289267,277395,11872,0.04104166738687787,2021-11-07 14:48:31 UTC
776638,mainnet,244,105408000,105697439,289440,277556,11884,0.04105859590934218,2021-11-07 14:50:00 UTC
776640,mainnet,244,105408000,105697616,289617,277730,11887,0.0410438613755408,2021-11-07 14:51:30 UTC
776641,mainnet,244,105408000,105697776,289777,277872,11905,0.041083315791108334,2021-11-07 14:53:00 UTC
776643,mainnet,244,105408000,105697978,289979,278032,11947,0.04119953513875143,2021-11-07 14:54:42 UTC
776644,mainnet,244,105408000,105698150,290151,278192,11959,0.04121647004490765,2021-11-07 14:56:13 UTC
776646,mainnet,244,105408000,105698341,290342,278375,11967,0.0412169097133725,2021-11-07 14:57:52 UTC
776647,mainnet,244,105408000,105698524,290525,278546,11979,0.04123225195766285,2021-11-07 14:59:21 UTC
776649,mainnet,244,105408000,105698758,290759,278771,11988,0.04123002211453472,2021-11-07 15:01:18 UTC
776650,mainnet,244,105408000,105698937,290938,278950,11988,0.04120465528738081,2021-11-07 15:02:58 UTC
776652,mainnet,244,105408000,105699131,291132,279139,11993,0.04119437231221577,2021-11-07 15:04:26 UTC
776654,mainnet,244,105408000,105699344,291345,279340,12005,0.04120544371792892,2021-11-07 15:06:14 UTC
776655,mainnet,244,105408000,105699522,291523,279518,12005,0.04118028423143286,2021-11-07 15:07:42 UTC
776657,mainnet,244,105408000,105699694,291695,279685,12010,0.041173143180376764,2021-11-07 15:09:13 UTC
776658,mainnet,244,105408000,105699882,291883,279866,12017,0.04117060603049852,2021-11-07 15:10:45 UTC
776659,mainnet,244,105408000,105700066,292067,280044,12023,0.04116521209174607,2021-11-07 15:12:16 UTC
776661,mainnet,244,105408000,105700240,292241,280201,12040,0.041198873532461225,2021-11-07 15:13:47 UTC
776663,mainnet,244,105408000,105700428,292429,280380,12049,0.0412031638448991,2021-11-07 15:15:18 UTC
776664,mainnet,244,105408000,105700611,292612,280550,12062,0.04122182275504764,2021-11-07 15:16:59 UTC
776666,mainnet,244,105408000,105700812,292813,280750,12063,0.04119694139262942,2021-11-07 15:18:29 UTC
776667,mainnet,244,105408000,105701014,293015,280944,12071,0.0411958432162176,2021-11-07 15:20:11 UTC
776669,mainnet,244,105408000,105701194,293195,281106,12089,0.04123194461024233,2021-11-07 15:21:45 UTC
776670,mainnet,244,105408000,105701384,293385,281283,12102,0.04124955263561532,2021-11-07 15:23:25 UTC
776672,mainnet,244,105408000,105701571,293572,281466,12106,0.04123690270189255,2021-11-07 15:24:58 UTC
776673,mainnet,244,105408000,105701746,293747,281625,12122,0.04126680442693883,2021-11-07 15:26:29 UTC
776675,mainnet,244,105408000,105701923,293924,281794,12130,0.041269171622596315,2021-11-07 15:27:58 UTC
776676,mainnet,244,105408000,105702096,294097,281966,12131,0.04124829563035325,2021-11-07 15:29:28 UTC
776678,mainnet,244,105408000,105702269,294270,282134,12136,0.04124103714276005,2021-11-07 15:31:00 UTC
776679,mainnet,244,105408000,105702453,294454,282310,12144,0.04124243515116113,2021-11-07 15:32:31 UTC
776681,mainnet,244,105408000,105702648,294649,282492,12157,0.041259261019042995,2021-11-07 15:34:02 UTC
776682,mainnet,244,105408000,105702829,294830,282669,12161,0.04124749855849134,2021-11-07 15:35:32 UTC
776684,mainnet,244,105408000,105703010,295011,282828,12183,0.041296765205365224,2021-11-07 15:37:01 UTC
776685,mainnet,244,105408000,105703193,295194,283003,12191,0.04129826486988218,2021-11-07 15:38:32 UTC
776687,mainnet,244,105408000,105703381,295382,283181,12201,0.04130583447874278,2021-11-07 15:40:02 UTC
776688,mainnet,244,105408000,105703585,295586,283381,12205,0.04129085951296746,2021-11-07 15:41:37 UTC
776690,mainnet,244,105408000,105703772,295773,283560,12213,0.04129180148289398,2021-11-07 15:43:06 UTC
776691,mainnet,244,105408000,105703950,295951,283709,12242,0.04136495568523168,2021-11-07 15:44:36 UTC
776693,mainnet,244,105408000,105704126,296127,283869,12258,0.041394401726286355,2021-11-07 15:46:05 UTC
776694,mainnet,244,105408000,105704318,296319,284047,12272,0.04141482658891262,2021-11-07 15:47:37 UTC
776696,mainnet,244,105408000,105704497,296498,284226,12272,0.04138982387739546,2021-11-07 15:49:16 UTC
776697,mainnet,244,105408000,105704696,296697,284419,12278,0.04138228563146914,2021-11-07 15:50:48 UTC
776699,mainnet,244,105408000,105704878,296879,284601,12278,0.0413569164541783,2021-11-07 15:52:17 UTC
776700,mainnet,244,105408000,105705054,297055,284768,12287,0.04136271060914645,2021-11-07 15:53:49 UTC
776702,mainnet,244,105408000,105705225,297226,284924,12302,0.041389380471425784,2021-11-07 15:55:25 UTC
776703,mainnet,244,105408000,105705388,297389,285068,12321,0.04143058418435114,2021-11-07 15:56:53 UTC
776705,mainnet,244,105408000,105705543,297544,285217,12327,0.04142916677869492,2021-11-07 15:58:20 UTC
776706,mainnet,244,105408000,105705691,297692,285345,12347,0.041475753463311074,2021-11-07 15:59:47 UTC
776708,mainnet,244,105408000,105705863,297864,285503,12361,0.04149880482367792,2021-11-07 16:01:37 UTC
776709,mainnet,244,105408000,105706042,298043,285654,12389,0.04156782746113816,2021-11-07 16:03:05 UTC
776711,mainnet,244,105408000,105706228,298229,285828,12401,0.04158213989920497,2021-11-07 16:04:34 UTC
776712,mainnet,244,105408000,105706375,298376,285970,12406,0.04157841113226265,2021-11-07 16:06:01 UTC
776714,mainnet,244,105408000,105706588,298589,286165,12424,0.04160903449222845,2021-11-07 16:07:48 UTC
776715,mainnet,244,105408000,105706795,298796,286358,12438,0.04162706328063294,2021-11-07 16:09:21 UTC
776717,mainnet,244,105408000,105707061,299062,286598,12464,0.04167697668042078,2021-11-07 16:11:30 UTC
776718,mainnet,244,105408000,105707257,299258,286778,12480,0.04170314578056393,2021-11-07 16:13:17 UTC
776720,mainnet,244,105408000,105707466,299467,286982,12485,0.041690737209776035,2021-11-07 16:14:48 UTC
776721,mainnet,244,105408000,105707642,299643,287141,12502,0.04172298368391719,2021-11-07 16:16:28 UTC
776723,mainnet,244,105408000,105707815,299816,287299,12517,0.041748939349467676,2021-11-07 16:18:07 UTC
776724,mainnet,244,105408000,105707991,299992,287473,12519,0.04173111282967546,2021-11-07 16:19:31 UTC
776726,mainnet,244,105408000,105708211,300212,287677,12535,0.04175382729537793,2021-11-07 16:21:23 UTC
776728,mainnet,244,105408000,105708411,300412,287852,12560,0.04180924863187889,2021-11-07 16:23:10 UTC
776729,mainnet,244,105408000,105708590,300591,288019,12572,0.04182427284915383,2021-11-07 16:24:45 UTC
776731,mainnet,244,105408000,105708756,300757,288177,12580,0.04182778788191131,2021-11-07 16:26:17 UTC
776732,mainnet,244,105408000,105708960,300961,288368,12593,0.04184263077275793,2021-11-07 16:27:47 UTC
776734,mainnet,244,105408000,105709140,301141,288543,12598,0.04183422383534623,2021-11-07 16:29:21 UTC
776735,mainnet,244,105408000,105709344,301345,288736,12609,0.041842406543994425,2021-11-07 16:30:55 UTC
776737,mainnet,244,105408000,105709524,301525,288912,12613,0.04183069397230744,2021-11-07 16:32:23 UTC
776738,mainnet,244,105408000,105709693,301694,289076,12618,0.04182383474646496,2021-11-07 16:33:47 UTC
776740,mainnet,244,105408000,105709902,301903,289267,12636,0.041854502936373605,2021-11-07 16:35:31 UTC
776741,mainnet,244,105408000,105710090,302091,289454,12637,0.04183176592483722,2021-11-07 16:37:12 UTC
776743,mainnet,244,105408000,105710280,302281,289636,12645,0.04183193783267886,2021-11-07 16:38:43 UTC
776744,mainnet,244,105408000,105710434,302435,289788,12647,0.04181724998760064,2021-11-07 16:40:14 UTC
776746,mainnet,244,105408000,105710618,302619,289968,12651,0.041805041983484184,2021-11-07 16:41:38 UTC
776747,mainnet,244,105408000,105710812,302813,290153,12660,0.04180798050281857,2021-11-07 16:43:12 UTC
776749,mainnet,244,105408000,105711007,303008,290347,12661,0.04178437533002429,2021-11-07 16:44:54 UTC
776750,mainnet,244,105408000,105711225,303226,290549,12677,0.04180710097419087,2021-11-07 16:46:35 UTC
776752,mainnet,244,105408000,105711373,303374,290688,12686,0.04181637187102388,2021-11-07 16:48:03 UTC
776753,mainnet,244,105408000,105711576,303577,290877,12700,0.04183452633104616,2021-11-07 16:49:39 UTC
776755,mainnet,244,105408000,105711765,303766,291058,12708,0.04183483339149213,2021-11-07 16:51:12 UTC
776757,mainnet,244,105408000,105711972,303973,291243,12730,0.04187871949153379,2021-11-07 16:52:53 UTC
776758,mainnet,244,105408000,105712172,304173,291427,12746,0.041903785017079094,2021-11-07 16:54:39 UTC
776760,mainnet,244,105408000,105712367,304368,291621,12747,0.04188022393944173,2021-11-07 16:56:08 UTC
776761,mainnet,244,105408000,105712558,304559,291800,12759,0.04189336056396298,2021-11-07 16:57:41 UTC
776763,mainnet,244,105408000,105712743,304744,291980,12764,0.04188433570472265,2021-11-07 16:59:16 UTC
776764,mainnet,244,105408000,105712932,304933,292155,12778,0.041904287171280245,2021-11-07 17:00:48 UTC
776766,mainnet,244,105408000,105713096,305097,292311,12786,0.041907983362668266,2021-11-07 17:02:18 UTC
776767,mainnet,244,105408000,105713275,305276,292480,12796,0.041916167664670656,2021-11-07 17:03:47 UTC
776769,mainnet,244,105408000,105713470,305471,292663,12808,0.04192869372215366,2021-11-07 17:05:20 UTC
776770,mainnet,244,105408000,105713657,305658,292842,12816,0.04192921500500559,2021-11-07 17:06:54 UTC
776772,mainnet,244,105408000,105713818,305819,292995,12824,0.04193330041625929,2021-11-07 17:08:23 UTC
776773,mainnet,244,105408000,105713983,305984,293152,12832,0.04193683329847312,2021-11-07 17:09:48 UTC
776775,mainnet,244,105408000,105714163,306164,293326,12838,0.041931775127056085,2021-11-07 17:11:30 UTC
776776,mainnet,244,105408000,105714392,306393,293548,12845,0.041923281537110835,2021-11-07 17:13:15 UTC
776778,mainnet,244,105408000,105714549,306550,293699,12851,0.041921383134888274,2021-11-07 17:14:43 UTC
776779,mainnet,244,105408000,105714704,306705,293839,12866,0.04194910418806345,2021-11-07 17:16:13 UTC
776781,mainnet,244,105408000,105714898,306899,294028,12871,0.04193887891456147,2021-11-07 17:17:51 UTC
776782,mainnet,244,105408000,105715097,307098,294207,12891,0.04197682824375281,2021-11-07 17:19:31 UTC
776784,mainnet,244,105408000,105715268,307269,294373,12896,0.041969739869625634,2021-11-07 17:21:03 UTC
776785,mainnet,244,105408000,105715448,307449,294540,12909,0.04198745157733478,2021-11-07 17:22:29 UTC
776787,mainnet,244,105408000,105715593,307594,294673,12921,0.04200667113142649,2021-11-07 17:23:57 UTC
776788,mainnet,244,105408000,105715787,307788,294851,12937,0.04203217799264429,2021-11-07 17:25:46 UTC
776790,mainnet,244,105408000,105715981,307982,295033,12949,0.042044664947951504,2021-11-07 17:27:27 UTC
776791,mainnet,244,105408000,105716150,308151,295200,12951,0.042028096614971235,2021-11-07 17:28:55 UTC
776793,mainnet,244,105408000,105716338,308339,295384,12955,0.042015444040487904,2021-11-07 17:30:47 UTC
776795,mainnet,244,105408000,105716528,308529,295552,12977,0.04206087596303751,2021-11-07 17:32:12 UTC
776796,mainnet,244,105408000,105716700,308701,295718,12983,0.042056877042834326,2021-11-07 17:33:42 UTC
776798,mainnet,244,105408000,105716918,308919,295929,12990,0.04204985772969613,2021-11-07 17:36:01 UTC
776799,mainnet,244,105408000,105717156,309157,296156,13001,0.04205306688834476,2021-11-07 17:37:41 UTC
776801,mainnet,244,105408000,105717348,309349,296342,13007,0.04204636187606878,2021-11-07 17:39:10 UTC
776802,mainnet,244,105408000,105717541,309542,296531,13011,0.04203306821045286,2021-11-07 17:40:45 UTC
776804,mainnet,244,105408000,105717722,309723,296695,13028,0.04206339212780452,2021-11-07 17:42:10 UTC
776805,mainnet,244,105408000,105717890,309891,296858,13033,0.042056723170405076,2021-11-07 17:43:38 UTC
776807,mainnet,244,105408000,105718072,310073,297036,13037,0.042044937804968506,2021-11-07 17:45:17 UTC
776808,mainnet,244,105408000,105718238,310239,297196,13043,0.0420417806916603,2021-11-07 17:46:44 UTC
776810,mainnet,244,105408000,105718459,310460,297396,13064,0.04207949494298782,2021-11-07 17:48:23 UTC
776811,mainnet,244,105408000,105718632,310633,297556,13077,0.04209790975202248,2021-11-07 17:49:54 UTC
776813,mainnet,244,105408000,105718819,310820,297731,13089,0.04211118975612895,2021-11-07 17:51:24 UTC
776814,mainnet,244,105408000,105718976,310977,297871,13106,0.04214459590259087,2021-11-07 17:52:50 UTC
776816,mainnet,244,105408000,105719134,311135,298019,13116,0.04215533450110081,2021-11-07 17:54:29 UTC
776817,mainnet,244,105408000,105719299,311300,298159,13141,0.04221329906842274,2021-11-07 17:55:57 UTC
776819,mainnet,244,105408000,105719468,311469,298314,13155,0.04223534284310798,2021-11-07 17:57:27 UTC
776820,mainnet,244,105408000,105719528,311529,298362,13167,0.04226572807025991,2021-11-07 17:58:58 UTC
776822,mainnet,244,105408000,105719790,311791,298594,13197,0.04232643020484876,2021-11-07 18:00:28 UTC
776823,mainnet,244,105408000,105719923,311924,298704,13220,0.04238211872122696,2021-11-07 18:01:59 UTC
776825,mainnet,244,105408000,105720075,312076,298836,13240,0.04242556300388367,2021-11-07 18:03:27 UTC
776826,mainnet,244,105408000,105720223,312224,298972,13252,0.04244388644050425,2021-11-07 18:04:54 UTC
776828,mainnet,244,105408000,105720397,312398,299145,13253,0.042423447013105076,2021-11-07 18:06:21 UTC
776829,mainnet,244,105408000,105720586,312587,299322,13265,0.042436185765882775,2021-11-07 18:07:53 UTC
776831,mainnet,244,105408000,105720763,312764,299497,13267,0.04241856479645995,2021-11-07 18:09:28 UTC
776832,mainnet,244,105408000,105720949,312950,299654,13296,0.04248602013101135,2021-11-07 18:10:58 UTC
776834,mainnet,244,105408000,105721143,313144,299839,13305,0.04248843982321232,2021-11-07 18:12:31 UTC
776835,mainnet,244,105408000,105721281,313282,299971,13311,0.04248887583710523,2021-11-07 18:14:06 UTC
776837,mainnet,244,105408000,105721485,313486,300152,13334,0.042534594846340826,2021-11-07 18:15:41 UTC
776838,mainnet,244,105408000,105721651,313652,300311,13341,0.04253440118347723,2021-11-07 18:17:11 UTC
776840,mainnet,244,105408000,105721812,313813,300465,13348,0.04253488542539666,2021-11-07 18:18:39 UTC
776841,mainnet,244,105408000,105721998,313999,300647,13352,0.042522428415377116,2021-11-07 18:20:21 UTC
776843,mainnet,244,105408000,105722194,314195,300826,13369,0.0425500087525263,2021-11-07 18:22:03 UTC
776844,mainnet,244,105408000,105722400,314401,301024,13377,0.042547574594228386,2021-11-07 18:23:40 UTC
776846,mainnet,244,105408000,105722577,314578,301199,13379,0.042529992561463295,2021-11-07 18:25:11 UTC
776847,mainnet,244,105408000,105722773,314774,301386,13388,0.042532102397275506,2021-11-07 18:26:52 UTC
776849,mainnet,244,105408000,105722954,314955,301556,13399,0.04254258544871489,2021-11-07 18:28:21 UTC
776850,mainnet,244,105408000,105723134,315135,301729,13406,0.0425404985165088,2021-11-07 18:29:51 UTC
776852,mainnet,244,105408000,105723307,315308,301897,13411,0.0425330153373844,2021-11-07 18:31:23 UTC
776853,mainnet,244,105408000,105723510,315511,302090,13421,0.04253734418134392,2021-11-07 18:33:02 UTC
776855,mainnet,244,105408000,105723709,315710,302289,13421,0.042510531817173985,2021-11-07 18:34:41 UTC
776856,mainnet,244,105408000,105723883,315884,302458,13426,0.042502944118727126,2021-11-07 18:36:12 UTC
776858,mainnet,244,105408000,105724082,316083,302643,13440,0.04252047721642733,2021-11-07 18:38:04 UTC
776860,mainnet,244,105408000,105724305,316306,302858,13448,0.04251579167009162,2021-11-07 18:39:42 UTC
776861,mainnet,244,105408000,105724508,316509,303056,13453,0.042504320572242814,2021-11-07 18:41:11 UTC
776863,mainnet,244,105408000,105724690,316691,303233,13458,0.042495681910758434,2021-11-07 18:42:40 UTC
776864,mainnet,244,105408000,105724884,316885,303420,13465,0.04249175568423876,2021-11-07 18:44:18 UTC
776866,mainnet,244,105408000,105725070,317071,303606,13465,0.0424668291959845,2021-11-07 18:45:50 UTC
776867,mainnet,244,105408000,105725296,317297,303823,13474,0.042464946091516784,2021-11-07 18:47:36 UTC
776869,mainnet,244,105408000,105725498,317499,304018,13481,0.042459976251893704,2021-11-07 18:49:13 UTC
776871,mainnet,244,105408000,105725728,317729,304235,13494,0.04247015538399076,2021-11-07 18:51:12 UTC
776872,mainnet,244,105408000,105725945,317946,304444,13502,0.0424663307605694,2021-11-07 18:53:08 UTC
776874,mainnet,244,105408000,105726166,318167,304639,13528,0.04251855157825921,2021-11-07 18:54:54 UTC
776875,mainnet,244,105408000,105726331,318332,304780,13552,0.04257190606033952,2021-11-07 18:56:23 UTC
776877,mainnet,244,105408000,105726500,318501,304936,13565,0.04259013315499794,2021-11-07 18:57:50 UTC
776878,mainnet,244,105408000,105726722,318723,305145,13578,0.0426012556357715,2021-11-07 18:59:41 UTC
776880,mainnet,244,105408000,105726915,318916,305323,13593,0.042622508748385156,2021-11-07 19:01:24 UTC
776881,mainnet,244,105408000,105726962,318963,305370,13593,0.0426162282145578,2021-11-07 19:02:51 UTC
776883,mainnet,244,105408000,105727240,319241,305623,13618,0.04265742808724443,2021-11-07 19:04:21 UTC
776884,mainnet,244,105408000,105727412,319413,305783,13630,0.042672026498608386,2021-11-07 19:05:56 UTC
776886,mainnet,244,105408000,105727600,319601,305965,13636,0.04266569879318275,2021-11-07 19:07:31 UTC
776888,mainnet,244,105408000,105727805,319806,306154,13652,0.0426883798302721,2021-11-07 19:09:13 UTC
776889,mainnet,244,105408000,105728028,320029,306357,13672,0.04272112839773896,2021-11-07 19:10:49 UTC
776891,mainnet,244,105408000,105728202,320203,306523,13680,0.0427228976617958,2021-11-07 19:12:20 UTC
776892,mainnet,244,105408000,105728398,320399,306710,13689,0.042724852449601905,2021-11-07 19:13:54 UTC
776894,mainnet,244,105408000,105728561,320562,306863,13699,0.04273432284550258,2021-11-07 19:15:22 UTC
776895,mainnet,244,105408000,105728739,320740,307031,13709,0.04274178462305918,2021-11-07 19:16:52 UTC
776897,mainnet,244,105408000,105728903,320904,307195,13709,0.04271994116620547,2021-11-07 19:18:21 UTC
776898,mainnet,244,105408000,105729076,321077,307359,13718,0.04272495382727508,2021-11-07 19:19:52 UTC
776900,mainnet,244,105408000,105729265,321266,307540,13726,0.04272472032521338,2021-11-07 19:21:23 UTC
776901,mainnet,244,105408000,105729436,321437,307703,13734,0.0427268796062681,2021-11-07 19:22:55 UTC
776903,mainnet,244,105408000,105729608,321609,307866,13743,0.04273201309664842,2021-11-07 19:24:21 UTC
776904,mainnet,244,105408000,105729796,321797,308053,13744,0.04271015578143985,2021-11-07 19:25:56 UTC
776906,mainnet,244,105408000,105729972,321973,308223,13750,0.042705444245324915,2021-11-07 19:27:28 UTC
776907,mainnet,244,105408000,105730152,322153,308399,13754,0.04269399943505105,2021-11-07 19:28:56 UTC
776909,mainnet,244,105408000,105730326,322327,308573,13754,0.04267095216969103,2021-11-07 19:30:26 UTC
776910,mainnet,244,105408000,105730536,322537,308777,13760,0.04266177213777024,2021-11-07 19:32:00 UTC
776912,mainnet,244,105408000,105730762,322763,308988,13775,0.04267837391522572,2021-11-07 19:33:47 UTC
776913,mainnet,244,105408000,105730981,322982,309195,13787,0.042686589345536284,2021-11-07 19:35:34 UTC
776915,mainnet,244,105408000,105731243,323244,309455,13789,0.04265817772332974,2021-11-07 19:37:24 UTC
776916,mainnet,244,105408000,105731434,323435,309635,13800,0.04266699645987602,2021-11-07 19:38:55 UTC
776918,mainnet,244,105408000,105731639,323640,309840,13800,0.04263997033741194,2021-11-07 19:40:36 UTC
776919,mainnet,244,105408000,105731864,323865,310043,13822,0.0426782764423448,2021-11-07 19:42:25 UTC
776921,mainnet,244,105408000,105732044,324045,310222,13823,0.042657655572528506,2021-11-07 19:44:00 UTC
776922,mainnet,244,105408000,105732242,324243,310417,13826,0.04264085886202632,2021-11-07 19:45:35 UTC
776924,mainnet,244,105408000,105732412,324413,310585,13828,0.042624679035673664,2021-11-07 19:47:07 UTC
776925,mainnet,244,105408000,105732604,324605,310772,13833,0.042614870380924506,2021-11-07 19:48:41 UTC
776927,mainnet,244,105408000,105732810,324811,310964,13847,0.04263094538054438,2021-11-07 19:50:19 UTC
776928,mainnet,244,105408000,105732983,324984,311129,13855,0.042632868079659304,2021-11-07 19:51:52 UTC
776930,mainnet,244,105408000,105733186,325187,311323,13864,0.04263393063068327,2021-11-07 19:53:27 UTC
776931,mainnet,244,105408000,105733372,325373,311507,13866,0.04261570566703445,2021-11-07 19:55:00 UTC
776933,mainnet,244,105408000,105733562,325563,311691,13872,0.04260926456630514,2021-11-07 19:56:35 UTC
776934,mainnet,244,105408000,105733755,325756,311883,13873,0.0425870897235968,2021-11-07 19:58:18 UTC
776936,mainnet,244,105408000,105734000,326001,312117,13884,0.0425888264146429,2021-11-07 20:00:12 UTC
776937,mainnet,244,105408000,105734190,326191,312290,13901,0.042616135944891186,2021-11-07 20:01:48 UTC
776939,mainnet,244,105408000,105734408,326409,312495,13914,0.04262750107993346,2021-11-07 20:03:31 UTC
776941,mainnet,244,105408000,105734623,326624,312697,13927,0.042639242676594497,2021-11-07 20:05:16 UTC
776942,mainnet,244,105408000,105734864,326865,312933,13932,0.0426231012803451,2021-11-07 20:07:12 UTC
776944,mainnet,244,105408000,105735062,327063,313111,13952,0.042658448066580444,2021-11-07 20:08:57 UTC
776945,mainnet,244,105408000,105735257,327258,313285,13973,0.042697199151739605,2021-11-07 20:10:32 UTC
776947,mainnet,244,105408000,105735467,327468,313484,13984,0.04270340918807334,2021-11-07 20:12:11 UTC
776948,mainnet,244,105408000,105735717,327718,313725,13993,0.042698295485753,2021-11-07 20:14:11 UTC
776950,mainnet,244,105408000,105735908,327909,313908,14001,0.04269782165173874,2021-11-07 20:15:44 UTC
776951,mainnet,244,105408000,105736155,328156,314155,14001,0.04266568339448311,2021-11-07 20:17:48 UTC
776953,mainnet,244,105408000,105736339,328340,314328,14012,0.04267527562892124,2021-11-07 20:19:22 UTC
776954,mainnet,244,105408000,105736511,328512,314485,14027,0.0426985924410676,2021-11-07 20:20:57 UTC
776956,mainnet,244,105408000,105736727,328728,314690,14038,0.04270399844248132,2021-11-07 20:22:35 UTC
776957,mainnet,244,105408000,105736914,328915,314871,14044,0.042697961479409574,2021-11-07 20:24:10 UTC
776959,mainnet,244,105408000,105737088,329089,315033,14056,0.04271184998587008,2021-11-07 20:25:41 UTC
776960,mainnet,244,105408000,105737266,329267,315206,14061,0.042703945430304285,2021-11-07 20:27:16 UTC
776962,mainnet,244,105408000,105737473,329474,315405,14069,0.042701396771824184,2021-11-07 20:28:51 UTC
776963,mainnet,244,105408000,105737675,329676,315601,14075,0.042693432339630424,2021-11-07 20:30:39 UTC
776965,mainnet,244,105408000,105737875,329876,315801,14075,0.0426675478058422,2021-11-07 20:32:16 UTC
776966,mainnet,244,105408000,105738066,330067,315978,14089,0.0426852729900293,2021-11-07 20:33:48 UTC
776968,mainnet,244,105408000,105738250,330251,316161,14090,0.04266451880539347,2021-11-07 20:35:21 UTC
776969,mainnet,244,105408000,105738441,330442,316344,14098,0.04266406812693302,2021-11-07 20:36:54 UTC
776971,mainnet,244,105408000,105738621,330622,316516,14106,0.042665037414328144,2021-11-07 20:38:25 UTC
776972,mainnet,244,105408000,105738805,330806,316695,14111,0.04265642098389993,2021-11-07 20:39:54 UTC
776974,mainnet,244,105408000,105738975,330976,316863,14113,0.042640553997872956,2021-11-07 20:41:27 UTC
776975,mainnet,244,105408000,105739153,331154,317016,14138,0.04269312766869795,2021-11-07 20:42:57 UTC
776977,mainnet,244,105408000,105739331,331332,317190,14142,0.04268226431494694,2021-11-07 20:44:29 UTC
776978,mainnet,244,105408000,105739503,331504,317360,14144,0.04266615184130508,2021-11-07 20:46:09 UTC
776980,mainnet,244,105408000,105739715,331716,317547,14169,0.04271424953876207,2021-11-07 20:47:42 UTC
776981,mainnet,244,105408000,105739884,331885,317712,14173,0.04270455127529114,2021-11-07 20:49:11 UTC
776983,mainnet,244,105408000,105740060,332061,317882,14179,0.042699985845974085,2021-11-07 20:50:41 UTC
776984,mainnet,244,105408000,105740256,332257,318065,14192,0.04271392325820073,2021-11-07 20:52:25 UTC
776986,mainnet,244,105408000,105740463,332464,318268,14196,0.04269935993069927,2021-11-07 20:54:02 UTC
776988,mainnet,244,105408000,105740658,332659,318454,14205,0.04270138490165605,2021-11-07 20:55:36 UTC
776989,mainnet,244,105408000,105740839,332840,318634,14206,0.04268116812883067,2021-11-07 20:57:06 UTC
776991,mainnet,244,105408000,105741025,333026,318815,14211,0.04267234390107679,2021-11-07 20:58:37 UTC
776992,mainnet,244,105408000,105741195,333196,318983,14213,0.04265657450869759,2021-11-07 21:00:06 UTC
776994,mainnet,244,105408000,105741379,333380,319153,14227,0.0426750254964305,2021-11-07 21:01:43 UTC
776995,mainnet,244,105408000,105741556,333557,319327,14230,0.04266137421789979,2021-11-07 21:03:13 UTC
776997,mainnet,244,105408000,105741731,333732,319501,14231,0.042642000167799315,2021-11-07 21:04:42 UTC
776998,mainnet,244,105408000,105741908,333909,319671,14238,0.042640360098110563,2021-11-07 21:06:11 UTC
776999,mainnet,244,105408000,105742079,334080,319833,14247,0.04264547413793104,2021-11-07 21:07:37 UTC
777001,mainnet,244,105408000,105742252,334253,320001,14252,0.042638360762655834,2021-11-07 21:09:07 UTC
777002,mainnet,244,105408000,105742428,334429,320158,14271,0.04267273472097217,2021-11-07 21:10:33 UTC
777004,mainnet,244,105408000,105742602,334603,320323,14280,0.042677441624850945,2021-11-07 21:12:02 UTC
777005,mainnet,244,105408000,105742770,334771,320487,14284,0.04266797303231164,2021-11-07 21:13:30 UTC
777007,mainnet,244,105408000,105742968,334969,320682,14287,0.042651708068507835,2021-11-07 21:15:11 UTC
777009,mainnet,244,105408000,105743164,335165,320868,14297,0.042656601972162964,2021-11-07 21:16:48 UTC
777010,mainnet,244,105408000,105743317,335318,321013,14305,0.04266099642727202,2021-11-07 21:18:14 UTC
777012,mainnet,244,105408000,105743506,335507,321188,14319,0.04267869224785176,2021-11-07 21:19:54 UTC
777013,mainnet,244,105408000,105743706,335707,321379,14328,0.04268007518461039,2021-11-07 21:21:27 UTC
777015,mainnet,244,105408000,105743970,335971,321629,14342,0.042688208208446564,2021-11-07 21:23:37 UTC
777016,mainnet,244,105408000,105744233,336234,321878,14356,0.04269645544472005,2021-11-07 21:25:42 UTC
777018,mainnet,244,105408000,105744477,336478,322113,14365,0.04269224139468256,2021-11-07 21:27:52 UTC
777020,mainnet,244,105408000,105744675,336676,322302,14374,0.042693865912628165,2021-11-07 21:29:38 UTC
777021,mainnet,244,105408000,105744877,336878,322498,14380,0.04268607626499801,2021-11-07 21:31:10 UTC
777023,mainnet,244,105408000,105745068,337069,322670,14399,0.0427182564994111,2021-11-07 21:32:44 UTC
777024,mainnet,244,105408000,105745259,337260,322849,14411,0.0427296447844393,2021-11-07 21:34:13 UTC
777026,mainnet,244,105408000,105745460,337461,323048,14413,0.04271012057689629,2021-11-07 21:35:50 UTC
777027,mainnet,244,105408000,105745654,337655,323234,14421,0.042709274259229095,2021-11-07 21:37:31 UTC
777029,mainnet,244,105408000,105745830,337831,323399,14432,0.0427195846443932,2021-11-07 21:38:56 UTC
777030,mainnet,244,105408000,105746011,338012,323579,14433,0.04269966746742719,2021-11-07 21:40:27 UTC
777032,mainnet,244,105408000,105746222,338223,323787,14436,0.042681899220336876,2021-11-07 21:42:13 UTC
777034,mainnet,244,105408000,105746408,338409,323955,14454,0.042711630009840164,2021-11-07 21:43:46 UTC
777035,mainnet,244,105408000,105746579,338580,324121,14459,0.04270482603815937,2021-11-07 21:45:12 UTC
777037,mainnet,244,105408000,105746768,338769,324300,14469,0.04271051955757463,2021-11-07 21:46:42 UTC
777038,mainnet,244,105408000,105746945,338946,324465,14481,0.0427236196916323,2021-11-07 21:48:10 UTC
777040,mainnet,244,105408000,105747154,339155,324672,14483,0.04270318880747741,2021-11-07 21:49:53 UTC
777041,mainnet,244,105408000,105747335,339336,324849,14487,0.04269219888252351,2021-11-07 21:51:21 UTC
777043,mainnet,244,105408000,105747510,339511,325015,14496,0.04269670202143672,2021-11-07 21:52:46 UTC
777044,mainnet,244,105408000,105747690,339691,325195,14496,0.042674077323214335,2021-11-07 21:54:17 UTC
777046,mainnet,244,105408000,105747872,339873,325377,14496,0.04265122560485828,2021-11-07 21:55:45 UTC
777047,mainnet,244,105408000,105748047,340048,325548,14500,0.04264103891215358,2021-11-07 21:57:14 UTC
777049,mainnet,244,105408000,105748249,340250,325746,14504,0.04262747979426892,2021-11-07 21:58:51 UTC
777050,mainnet,244,105408000,105748452,340453,325930,14523,0.042657870543070554,2021-11-07 22:00:35 UTC
777052,mainnet,244,105408000,105748623,340624,326092,14532,0.042662877542392785,2021-11-07 22:02:16 UTC
777053,mainnet,244,105408000,105748819,340820,326264,14556,0.04270876122293293,2021-11-07 22:03:41 UTC
777055,mainnet,244,105408000,105749004,341005,326441,14564,0.042709051186932745,2021-11-07 22:05:13 UTC
777056,mainnet,244,105408000,105749248,341249,326675,14574,0.04270781745880574,2021-11-07 22:07:14 UTC
777058,mainnet,244,105408000,105749427,341428,326848,14580,0.042703000339749525,2021-11-07 22:08:45 UTC
777059,mainnet,244,105408000,105749618,341619,327034,14585,0.04269376117838879,2021-11-07 22:10:23 UTC
777061,mainnet,244,105408000,105749783,341784,327199,14585,0.04267315029375278,2021-11-07 22:11:51 UTC
777062,mainnet,244,105408000,105749992,341993,327402,14591,0.04266461594243157,2021-11-07 22:13:32 UTC
777064,mainnet,244,105408000,105750153,342154,327555,14599,0.04266792146226553,2021-11-07 22:14:59 UTC
777065,mainnet,244,105408000,105750398,342399,327795,14604,0.04265199372661719,2021-11-07 22:17:04 UTC
777067,mainnet,244,105408000,105750595,342596,327987,14609,0.042642062370839125,2021-11-07 22:18:42 UTC
777069,mainnet,244,105408000,105750781,342782,328162,14620,0.04265101434731112,2021-11-07 22:20:25 UTC
777070,mainnet,244,105408000,105750971,342972,328347,14625,0.04264196494174451,2021-11-07 22:21:59 UTC
777072,mainnet,244,105408000,105751158,343159,328533,14626,0.04262164186280995,2021-11-07 22:23:39 UTC
777073,mainnet,244,105408000,105751360,343361,328717,14644,0.042648990421160236,2021-11-07 22:25:04 UTC
777075,mainnet,244,105408000,105751570,343571,328917,14654,0.0426520282561683,2021-11-07 22:26:47 UTC
777076,mainnet,244,105408000,105751769,343770,329109,14661,0.042647700497425604,2021-11-07 22:28:25 UTC
777078,mainnet,244,105408000,105751951,343952,329291,14661,0.04262513373959157,2021-11-07 22:29:54 UTC
777079,mainnet,244,105408000,105752134,344135,329469,14666,0.0426169962369419,2021-11-07 22:31:21 UTC
777081,mainnet,244,105408000,105752326,344327,329654,14673,0.042613562108112346,2021-11-07 22:32:53 UTC
777082,mainnet,244,105408000,105752530,344531,329857,14674,0.04259123271926184,2021-11-07 22:34:29 UTC
777084,mainnet,244,105408000,105752742,344743,330052,14691,0.0426143533008647,2021-11-07 22:36:10 UTC
777085,mainnet,244,105408000,105752931,344932,330229,14703,0.04262579290990688,2021-11-07 22:37:38 UTC
777087,mainnet,244,105408000,105753121,345122,330416,14706,0.0426110187122235,2021-11-07 22:39:17 UTC
777088,mainnet,244,105408000,105753300,345301,330585,14716,0.04261788989895772,2021-11-07 22:40:46 UTC
777090,mainnet,244,105408000,105753488,345489,330768,14721,0.042609171348436566,2021-11-07 22:42:18 UTC
777091,mainnet,244,105408000,105753693,345694,330969,14725,0.04259547461049367,2021-11-07 22:43:56 UTC
777093,mainnet,244,105408000,105753878,345879,331151,14728,0.04258136515949219,2021-11-07 22:45:26 UTC
777094,mainnet,244,105408000,105754068,346069,331332,14737,0.04258399336548492,2021-11-07 22:46:55 UTC
777096,mainnet,244,105408000,105754249,346250,331503,14747,0.04259061371841155,2021-11-07 22:48:33 UTC
777097,mainnet,244,105408000,105754450,346451,331692,14759,0.04260054091343365,2021-11-07 22:50:22 UTC
777099,mainnet,244,105408000,105754634,346635,331867,14768,0.04260389170164582,2021-11-07 22:51:50 UTC
777100,mainnet,244,105408000,105754816,346817,332045,14772,0.04259306781386149,2021-11-07 22:53:19 UTC
777102,mainnet,244,105408000,105755028,347029,332240,14789,0.04261603497114074,2021-11-07 22:55:02 UTC
777103,mainnet,244,105408000,105755213,347214,332421,14793,0.042604848882821546,2021-11-07 22:56:35 UTC
777105,mainnet,244,105408000,105755382,347383,332584,14799,0.042601393850591425,2021-11-07 22:58:03 UTC
777106,mainnet,244,105408000,105755558,347559,332751,14808,0.042605715864069124,2021-11-07 22:59:31 UTC
777108,mainnet,244,105408000,105755810,347811,332983,14828,0.0426323491781456,2021-11-07 23:01:41 UTC
777110,mainnet,244,105408000,105755994,347995,333159,14836,0.04263279644822483,2021-11-07 23:03:14 UTC
777111,mainnet,244,105408000,105756191,348192,333346,14846,0.04263739545997611,2021-11-07 23:04:50 UTC
777113,mainnet,244,105408000,105756459,348460,333597,14863,0.04265338919818631,2021-11-07 23:06:58 UTC
777114,mainnet,244,105408000,105756656,348657,333786,14871,0.04265223414415887,2021-11-07 23:08:42 UTC
777116,mainnet,244,105408000,105756867,348868,333987,14881,0.04265510164302831,2021-11-07 23:10:32 UTC
777117,mainnet,244,105408000,105757048,349049,334156,14893,0.04266736188901845,2021-11-07 23:12:11 UTC
777119,mainnet,244,105408000,105757226,349227,334319,14908,0.042688566462501465,2021-11-07 23:13:42 UTC
777120,mainnet,244,105408000,105757402,349403,334488,14915,0.04268709770665965,2021-11-07 23:15:15 UTC
777122,mainnet,244,105408000,105757591,349592,334672,14920,0.042678322158401796,2021-11-07 23:16:48 UTC
777123,mainnet,244,105408000,105757776,349777,334836,14941,0.042715787487456296,2021-11-07 23:18:17 UTC
777125,mainnet,244,105408000,105757926,349927,334981,14946,0.04271176559682448,2021-11-07 23:19:47 UTC
777126,mainnet,244,105408000,105758116,350117,335161,14956,0.04271714883881674,2021-11-07 23:21:17 UTC
777128,mainnet,244,105408000,105758304,350305,335332,14973,0.04274275274403734,2021-11-07 23:22:45 UTC
777129,mainnet,244,105408000,105758484,350485,335500,14985,0.04275503944534003,2021-11-07 23:24:15 UTC
777131,mainnet,244,105408000,105758649,350650,335660,14990,0.04274918009411094,2021-11-07 23:25:44 UTC
777132,mainnet,244,105408000,105758826,350827,335825,15002,0.042761817077933,2021-11-07 23:27:16 UTC
777134,mainnet,244,105408000,105758998,350999,335985,15014,0.04277505064116992,2021-11-07 23:28:58 UTC
777135,mainnet,244,105408000,105759214,351215,336194,15021,0.04276867445866492,2021-11-07 23:30:29 UTC
777137,mainnet,244,105408000,105759393,351394,336369,15025,0.042758271342140164,2021-11-07 23:31:59 UTC
777138,mainnet,244,105408000,105759576,351577,336543,15034,0.042761614098760725,2021-11-07 23:33:33 UTC
777140,mainnet,244,105408000,105759763,351764,336725,15039,0.042753095825610356,2021-11-07 23:35:02 UTC
777141,mainnet,244,105408000,105759948,351949,336905,15044,0.04274482950654782,2021-11-07 23:36:36 UTC
777143,mainnet,244,105408000,105760138,352139,337083,15056,0.04275584357313447,2021-11-07 23:38:08 UTC
777144,mainnet,244,105408000,105760330,352331,337267,15064,0.04275525003476844,2021-11-07 23:39:42 UTC
777146,mainnet,244,105408000,105760552,352553,337481,15072,0.04275101899572546,2021-11-07 23:41:26 UTC
777147,mainnet,244,105408000,105760730,352731,337651,15080,0.04275212555743612,2021-11-07 23:42:58 UTC
777149,mainnet,244,105408000,105760940,352941,337846,15095,0.04276918805126069,2021-11-07 23:44:42 UTC
777150,mainnet,244,105408000,105761118,353119,338023,15096,0.04275046089278685,2021-11-07 23:46:11 UTC
777152,mainnet,244,105408000,105761292,353293,338189,15104,0.042752049998160166,2021-11-07 23:47:51 UTC
777153,mainnet,244,105408000,105761460,353461,338341,15120,0.042776996613487765,2021-11-07 23:49:22 UTC
777155,mainnet,244,105408000,105761634,353635,338507,15128,0.0427785711255956,2021-11-07 23:50:51 UTC
777156,mainnet,244,105408000,105761804,353805,338671,15134,0.04277497491556083,2021-11-07 23:52:21 UTC
777158,mainnet,244,105408000,105761981,353982,338841,15141,0.042773361357357154,2021-11-07 23:53:50 UTC
777159,mainnet,244,105408000,105762156,354157,339010,15147,0.042769167346685226,2021-11-07 23:55:20 UTC
777161,mainnet,244,105408000,105762335,354336,339181,15155,0.042770139077034225,2021-11-07 23:56:48 UTC
777162,mainnet,244,105408000,105762543,354544,339377,15167,0.042778893451870574,2021-11-07 23:58:25 UTC
777164,mainnet,244,105408000,105762718,354719,339543,15176,0.04278316075541485,2021-11-07 23:59:56 UTC
777165,mainnet,244,105408000,105762903,354904,339709,15195,0.04281439487861506,2021-11-08 00:01:38 UTC
777167,mainnet,244,105408000,105763136,355137,339928,15209,0.04282572640980804,2021-11-08 00:03:30 UTC
777169,mainnet,244,105408000,105763268,355269,340051,15218,0.04283514745164931,2021-11-08 00:05:17 UTC
777170,mainnet,244,105408000,105763522,355523,340279,15244,0.04287767598720758,2021-11-08 00:06:56 UTC
777172,mainnet,244,105408000,105763740,355741,340480,15261,0.042899187892314915,2021-11-08 00:08:47 UTC
777173,mainnet,244,105408000,105763916,355917,340639,15278,0.042925738304155185,2021-11-08 00:10:20 UTC
777175,mainnet,244,105408000,105764075,356076,340789,15287,0.04293184601040227,2021-11-08 00:11:47 UTC
777176,mainnet,244,105408000,105764259,356260,340966,15294,0.04292932128220962,2021-11-08 00:13:27 UTC
777178,mainnet,244,105408000,105764453,356454,341144,15310,0.04295084358711082,2021-11-08 00:15:04 UTC
777179,mainnet,244,105408000,105764628,356629,341313,15316,0.042946591555930676,2021-11-08 00:16:35 UTC
777181,mainnet,244,105408000,105764799,356800,341476,15324,0.04294843049327354,2021-11-08 00:18:07 UTC
777182,mainnet,244,105408000,105764973,356974,341644,15330,0.04294430406696286,2021-11-08 00:19:36 UTC
777184,mainnet,244,105408000,105765147,357148,341813,15335,0.0429373817017035,2021-11-08 00:21:06 UTC
777185,mainnet,244,105408000,105765308,357309,341968,15341,0.0429348267186105,2021-11-08 00:22:36 UTC
777187,mainnet,244,105408000,105765471,357472,342120,15352,0.042946020947095154,2021-11-08 00:24:16 UTC
777188,mainnet,244,105408000,105765644,357645,342271,15374,0.0429867606145759,2021-11-08 00:25:44 UTC
777190,mainnet,244,105408000,105765825,357826,342442,15384,0.042992963060258335,2021-11-08 00:27:23 UTC
777192,mainnet,244,105408000,105765985,357986,342591,15395,0.043004475035336574,2021-11-08 00:28:54 UTC
777193,mainnet,244,105408000,105766169,358170,342759,15411,0.043027054192143394,2021-11-08 00:30:31 UTC
777195,mainnet,244,105408000,105766347,358348,342916,15432,0.04306428388047373,2021-11-08 00:32:05 UTC
777196,mainnet,244,105408000,105766504,358505,343059,15446,0.043084475809263466,2021-11-08 00:33:36 UTC
777198,mainnet,244,105408000,105766677,358678,343217,15461,0.04310551525323549,2021-11-08 00:35:03 UTC
777199,mainnet,244,105408000,105766838,358839,343373,15466,0.043100108962515225,2021-11-08 00:36:34 UTC
777201,mainnet,244,105408000,105767005,359006,343526,15480,0.043119056506019396,2021-11-08 00:38:04 UTC
777202,mainnet,244,105408000,105767180,359181,343694,15487,0.04311753684075717,2021-11-08 00:39:36 UTC
777204,mainnet,244,105408000,105767345,359346,343855,15491,0.04310887000272717,2021-11-08 00:41:06 UTC
777205,mainnet,244,105408000,105767509,359510,344010,15500,0.04311423882506745,2021-11-08 00:42:30 UTC
777207,mainnet,244,105408000,105767677,359678,344165,15513,0.04313024427404512,2021-11-08 00:43:58 UTC
777208,mainnet,244,105408000,105767861,359862,344332,15530,0.04315543180441391,2021-11-08 00:45:37 UTC
777210,mainnet,244,105408000,105768041,360042,344493,15549,0.04318662822670689,2021-11-08 00:47:13 UTC
777211,mainnet,244,105408000,105768214,360215,344651,15564,0.043207528836944606,2021-11-08 00:48:49 UTC
777213,mainnet,244,105408000,105768369,360370,344769,15601,0.04329161694924661,2021-11-08 00:50:30 UTC
777214,mainnet,244,105408000,105768517,360518,344902,15616,0.04331545165567323,2021-11-08 00:51:54 UTC
777216,mainnet,244,105408000,105768706,360707,345060,15647,0.04337869794597832,2021-11-08 00:53:28 UTC
777217,mainnet,244,105408000,105768828,360829,345170,15659,0.04339728791200264,2021-11-08 00:54:54 UTC
777219,mainnet,244,105408000,105769031,361032,345344,15688,0.04345321190365397,2021-11-08 00:56:36 UTC
777220,mainnet,244,105408000,105769201,361202,345501,15701,0.043468751557300345,2021-11-08 00:58:10 UTC
777222,mainnet,244,105408000,105769372,361373,345656,15717,0.04349245793127876,2021-11-08 00:59:45 UTC
777223,mainnet,244,105408000,105769563,361564,345832,15732,0.04351096901240168,2021-11-08 01:01:27 UTC
777225,mainnet,244,105408000,105769752,361753,346018,15735,0.0434965293998944,2021-11-08 01:03:12 UTC
777226,mainnet,244,105408000,105769929,361930,346187,15743,0.043497361368220376,2021-11-08 01:04:44 UTC
777228,mainnet,244,105408000,105770128,362129,346379,15750,0.04349278848145274,2021-11-08 01:06:29 UTC
777229,mainnet,244,105408000,105770289,362290,346535,15755,0.04348726158602225,2021-11-08 01:08:10 UTC
777231,mainnet,244,105408000,105770456,362457,346676,15781,0.04353895772464044,2021-11-08 01:09:43 UTC
777232,mainnet,244,105408000,105770631,362632,346832,15800,0.043570341282622604,2021-11-08 01:11:14 UTC
777234,mainnet,244,105408000,105770800,362801,346987,15814,0.043588633989432225,2021-11-08 01:12:49 UTC
777235,mainnet,244,105408000,105770983,362984,347165,15819,0.04358043329733542,2021-11-08 01:14:26 UTC
777237,mainnet,244,105408000,105771174,363175,347336,15839,0.04361258346527156,2021-11-08 01:16:02 UTC
777238,mainnet,244,105408000,105771356,363357,347517,15840,0.04359349069922969,2021-11-08 01:17:41 UTC
777240,mainnet,244,105408000,105771553,363554,347707,15847,0.04358912293634508,2021-11-08 01:19:21 UTC
777241,mainnet,244,105408000,105771733,363734,347875,15859,0.043600543254136266,2021-11-08 01:20:55 UTC
777243,mainnet,244,105408000,105771923,363924,348040,15884,0.04364647563777052,2021-11-08 01:22:33 UTC
777244,mainnet,244,105408000,105772116,364117,348222,15895,0.04365355091907271,2021-11-08 01:24:08 UTC
777246,mainnet,244,105408000,105772292,364293,348397,15896,0.04363520572725801,2021-11-08 01:25:39 UTC
777247,mainnet,244,105408000,105772506,364507,348597,15910,0.043647995786089154,2021-11-08 01:27:30 UTC
777249,mainnet,244,105408000,105772688,364689,348779,15910,0.043626213019860756,2021-11-08 01:28:57 UTC
777251,mainnet,244,105408000,105772879,364880,348959,15921,0.04363352335014251,2021-11-08 01:30:37 UTC
777252,mainnet,244,105408000,105773077,365078,349141,15937,0.04365368496595248,2021-11-08 01:32:08 UTC
777254,mainnet,244,105408000,105773258,365259,349320,15939,0.0436375284387243,2021-11-08 01:33:40 UTC
777255,mainnet,244,105408000,105773434,365435,349492,15943,0.04362745768741363,2021-11-08 01:35:10 UTC
777257,mainnet,244,105408000,105773606,365607,349646,15961,0.043656166320666726,2021-11-08 01:36:39 UTC
777258,mainnet,244,105408000,105773769,365770,349797,15973,0.04366951909670011,2021-11-08 01:38:19 UTC
777260,mainnet,244,105408000,105773955,365956,349975,15981,0.04366918427351922,2021-11-08 01:39:49 UTC
777261,mainnet,244,105408000,105774226,366227,350236,15991,0.043664175497710435,2021-11-08 01:42:08 UTC
777263,mainnet,244,105408000,105774397,366398,350398,16000,0.043668360635156306,2021-11-08 01:43:41 UTC
777265,mainnet,244,105408000,105774642,366643,350635,16008,0.04366099993726868,2021-11-08 01:45:41 UTC
777266,mainnet,244,105408000,105774832,366833,350779,16054,0.043763783520021374,2021-11-08 01:47:25 UTC
777268,mainnet,244,105408000,105775012,367013,350950,16063,0.04376684204646702,2021-11-08 01:48:55 UTC
777269,mainnet,244,105408000,105775180,367181,351114,16067,0.04375771077479499,2021-11-08 01:50:26 UTC
777271,mainnet,244,105408000,105775368,367369,351287,16082,0.0437761487768429,2021-11-08 01:51:55 UTC
777272,mainnet,244,105408000,105775606,367607,351509,16098,0.04379133150348062,2021-11-08 01:53:48 UTC
777274,mainnet,244,105408000,105775791,367792,351693,16099,0.043772023317527296,2021-11-08 01:55:28 UTC
777275,mainnet,244,105408000,105775976,367977,351869,16108,0.04377447503512448,2021-11-08 01:56:56 UTC
777277,mainnet,244,105408000,105776168,368169,352052,16117,0.043776091957769395,2021-11-08 01:58:25 UTC
777278,mainnet,244,105408000,105776366,368367,352249,16118,0.043755276667019574,2021-11-08 02:00:09 UTC
777280,mainnet,244,105408000,105776568,368569,352444,16125,0.0437502882770933,2021-11-08 02:01:46 UTC
777281,mainnet,244,105408000,105776741,368742,352616,16126,0.04373247419605036,2021-11-08 02:03:16 UTC
777283,mainnet,244,105408000,105776912,368913,352779,16134,0.04373388847777118,2021-11-08 02:04:45 UTC
777284,mainnet,244,105408000,105777116,369117,352978,16139,0.043723263897355036,2021-11-08 02:06:26 UTC
777286,mainnet,244,105408000,105777288,369289,353148,16141,0.043708315167795414,2021-11-08 02:07:56 UTC
777287,mainnet,244,105408000,105777482,369483,353336,16147,0.04370160467463997,2021-11-08 02:09:29 UTC
777289,mainnet,244,105408000,105777648,369649,353501,16148,0.04368468466031289,2021-11-08 02:10:59 UTC
777290,mainnet,244,105408000,105777833,369834,353677,16157,0.043687167756344736,2021-11-08 02:12:31 UTC
777292,mainnet,244,105408000,105778000,370001,353823,16178,0.043724206150794184,2021-11-08 02:14:00 UTC
777293,mainnet,244,105408000,105778173,370174,353991,16183,0.04371727890127346,2021-11-08 02:15:37 UTC
777295,mainnet,244,105408000,105778354,370355,354166,16189,0.04371211405273319,2021-11-08 02:17:11 UTC
777296,mainnet,244,105408000,105778543,370544,354337,16207,0.043738395440217626,2021-11-08 02:18:42 UTC
777298,mainnet,244,105408000,105778726,370727,354504,16223,0.043759963531115886,2021-11-08 02:20:14 UTC
777299,mainnet,244,105408000,105778912,370913,354686,16227,0.0437488036278049,2021-11-08 02:21:45 UTC
777301,mainnet,244,105408000,105779088,371089,354853,16236,0.04375230739795575,2021-11-08 02:23:15 UTC
777302,mainnet,244,105408000,105779245,371246,354998,16248,0.04376612811989893,2021-11-08 02:24:45 UTC
777304,mainnet,244,105408000,105779448,371449,355184,16265,0.0437879762766894,2021-11-08 02:26:17 UTC
777305,mainnet,244,105408000,105779652,371653,355378,16275,0.043790847914587,2021-11-08 02:27:55 UTC
777307,mainnet,244,105408000,105779840,371841,355553,16288,0.04380366877240541,2021-11-08 02:29:25 UTC
777308,mainnet,244,105408000,105780076,372077,355784,16293,0.04378932317772934,2021-11-08 02:31:32 UTC
777310,mainnet,244,105408000,105780352,372353,356055,16298,0.04377029324323961,2021-11-08 02:33:46 UTC
777311,mainnet,244,105408000,105780613,372614,356304,16310,0.04377183895398455,2021-11-08 02:35:59 UTC
777313,mainnet,244,105408000,105780891,372892,356551,16341,0.043822339980476924,2021-11-08 02:38:16 UTC
777314,mainnet,244,105408000,105781192,373193,356851,16342,0.0437896745115798,2021-11-08 02:40:51 UTC
777316,mainnet,244,105408000,105781505,373506,357155,16351,0.04377707453160056,2021-11-08 02:43:33 UTC
777318,mainnet,244,105408000,105781854,373855,357499,16356,0.04374958205721469,2021-11-08 02:46:06 UTC
777319,mainnet,244,105408000,105782193,374194,357830,16364,0.04373132653115763,2021-11-08 02:48:56 UTC
777321,mainnet,244,105408000,105782457,374458,358074,16384,0.043753905644958846,2021-11-08 02:51:15 UTC
777322,mainnet,244,105408000,105782728,374729,358331,16398,0.04375962362133702,2021-11-08 02:53:29 UTC
777324,mainnet,244,105408000,105782980,374981,358561,16420,0.04378888530352205,2021-11-08 02:56:00 UTC
777325,mainnet,244,105408000,105783294,375295,358864,16431,0.04378155850730758,2021-11-08 02:58:11 UTC
777327,mainnet,244,105408000,105783600,375601,359157,16444,0.04378050111687669,2021-11-08 03:00:46 UTC
777328,mainnet,244,105408000,105783898,375899,359432,16467,0.04380698006645402,2021-11-08 03:03:25 UTC
777330,mainnet,244,105408000,105784084,376085,359598,16487,0.043838493957483016,2021-11-08 03:05:37 UTC
777331,mainnet,244,105408000,105784320,376321,359804,16517,0.04389072095365393,2021-11-08 03:08:01 UTC
777333,mainnet,244,105408000,105784578,376579,360019,16560,0.04397483662126672,2021-11-08 03:10:13 UTC
777334,mainnet,244,105408000,105784853,376854,360250,16604,0.04405950314976092,2021-11-08 03:12:35 UTC
777336,mainnet,244,105408000,105785132,377133,360515,16618,0.04406403046140221,2021-11-08 03:14:47 UTC
777337,mainnet,244,105408000,105785416,377417,360786,16631,0.04406531767249488,2021-11-08 03:17:14 UTC
777339,mainnet,244,105408000,105785688,377689,361027,16662,0.044115661298052104,2021-11-08 03:19:29 UTC
777340,mainnet,244,105408000,105785947,377948,361273,16675,0.0441198260078106,2021-11-08 03:21:48 UTC
777342,mainnet,244,105408000,105786240,378241,361559,16682,0.04410415581600091,2021-11-08 03:24:12 UTC
777343,mainnet,244,105408000,105786513,378514,361821,16693,0.044101407081376116,2021-11-08 03:26:23 UTC
777345,mainnet,244,105408000,105786796,378797,362096,16701,0.04408957832295398,2021-11-08 03:28:44 UTC
777346,mainnet,244,105408000,105787090,379091,362373,16718,0.044100229232558935,2021-11-08 03:31:11 UTC
777348,mainnet,244,105408000,105787354,379355,362636,16719,0.04407217513938132,2021-11-08 03:33:21 UTC
777349,mainnet,244,105408000,105787634,379635,362913,16722,0.04404757200995693,2021-11-08 03:35:50 UTC
777351,mainnet,244,105408000,105787905,379906,363138,16768,0.04413723394734487,2021-11-08 03:38:09 UTC
777352,mainnet,244,105408000,105788184,380185,363401,16784,0.04414692846903481,2021-11-08 03:40:38 UTC
777354,mainnet,244,105408000,105788460,380461,363662,16799,0.044154328564557206,2021-11-08 03:42:57 UTC
777355,mainnet,244,105408000,105788770,380771,363955,16816,0.044163027121288126,2021-11-08 03:45:29 UTC
777357,mainnet,244,105408000,105789048,381049,364228,16821,0.044143928996008386,2021-11-08 03:47:51 UTC
777358,mainnet,244,105408000,105789323,381324,364488,16836,0.044151430279762094,2021-11-08 03:50:06 UTC
777360,mainnet,244,105408000,105789562,381563,364705,16858,0.044181432686083294,2021-11-08 03:52:13 UTC
777361,mainnet,244,105408000,105789845,381846,364971,16875,0.04419320878050313,2021-11-08 03:54:31 UTC
777363,mainnet,244,105408000,105790129,382130,365245,16885,0.04418653337869311,2021-11-08 03:56:45 UTC
777365,mainnet,244,105408000,105790379,382380,365493,16887,0.044162874627334064,2021-11-08 03:59:04 UTC
777366,mainnet,244,105408000,105790684,382685,365775,16910,0.0441877784600912,2021-11-08 04:01:42 UTC
777368,mainnet,244,105408000,105790967,382968,366052,16916,0.04417079233774101,2021-11-08 04:04:06 UTC
777369,mainnet,244,105408000,105791260,383261,366326,16935,0.04418659868862211,2021-11-08 04:06:33 UTC
777371,mainnet,244,105408000,105791515,383516,366572,16944,0.04418068607307127,2021-11-08 04:08:55 UTC
777372,mainnet,244,105408000,105791800,383801,366849,16952,0.044168722853770576,2021-11-08 04:11:16 UTC
777374,mainnet,244,105408000,105792110,384111,367149,16962,0.044159110257191284,2021-11-08 04:13:39 UTC
777375,mainnet,244,105408000,105792388,384389,367414,16975,0.04416099316057431,2021-11-08 04:15:53 UTC
777377,mainnet,244,105408000,105792648,384649,367671,16978,0.04413894225644679,2021-11-08 04:18:08 UTC
777378,mainnet,244,105408000,105792902,384903,367920,16983,0.04412280496644609,2021-11-08 04:20:16 UTC
777380,mainnet,244,105408000,105793192,385193,368197,16996,0.044123335574634014,2021-11-08 04:22:38 UTC
777381,mainnet,244,105408000,105793491,385492,368492,17000,0.044099488445934025,2021-11-08 04:24:59 UTC
777383,mainnet,244,105408000,105793782,385783,368775,17008,0.044086960804390035,2021-11-08 04:27:17 UTC
777384,mainnet,244,105408000,105794052,386053,369034,17019,0.04408462050547464,2021-11-08 04:29:39 UTC
777386,mainnet,244,105408000,105794299,386300,369268,17032,0.04409008542583484,2021-11-08 04:31:54 UTC
777387,mainnet,244,105408000,105794542,386543,369485,17058,0.04412963111477895,2021-11-08 04:34:03 UTC
777389,mainnet,244,105408000,105794807,386808,369739,17069,0.044127836032346796,2021-11-08 04:36:11 UTC
777390,mainnet,244,105408000,105795097,387098,370022,17076,0.044112860309275685,2021-11-08 04:38:47 UTC
777392,mainnet,244,105408000,105795392,387393,370308,17085,0.04410250056144535,2021-11-08 04:40:59 UTC
777393,mainnet,244,105408000,105795680,387681,370589,17092,0.04408779383049466,2021-11-08 04:43:27 UTC
777395,mainnet,244,105408000,105795980,387981,370879,17102,0.04407947811877386,2021-11-08 04:46:05 UTC
777396,mainnet,244,105408000,105796282,388283,371170,17113,0.044073523692770476,2021-11-08 04:48:22 UTC
777398,mainnet,244,105408000,105796506,388507,371387,17120,0.04406613008259826,2021-11-08 04:50:25 UTC
777399,mainnet,244,105408000,105796812,388813,371662,17151,0.04411117941015347,2021-11-08 04:52:50 UTC
777401,mainnet,244,105408000,105797097,389098,371941,17157,0.044094289870418246,2021-11-08 04:55:06 UTC
777402,mainnet,244,105408000,105797372,389373,372213,17160,0.04407085237034925,2021-11-08 04:57:25 UTC
777404,mainnet,244,105408000,105797671,389672,372502,17170,0.044062698885216287,2021-11-08 04:59:55 UTC
777405,mainnet,244,105408000,105797960,389961,372771,17190,0.04408133121004408,2021-11-08 05:02:15 UTC
777407,mainnet,244,105408000,105798244,390245,373050,17195,0.044062063575446196,2021-11-08 05:04:31 UTC
777408,mainnet,244,105408000,105798532,390533,373322,17211,0.0440705394934615,2021-11-08 05:06:52 UTC
777410,mainnet,244,105408000,105798800,390801,373572,17229,0.04408637644223019,2021-11-08 05:09:09 UTC
777411,mainnet,244,105408000,105799109,391110,373876,17234,0.04406432972820946,2021-11-08 05:11:42 UTC
777413,mainnet,244,105408000,105799422,391423,374188,17235,0.04403164862565562,2021-11-08 05:14:19 UTC
777414,mainnet,244,105408000,105799707,391708,374460,17248,0.044032799942814546,2021-11-08 05:16:32 UTC
777416,mainnet,244,105408000,105799938,391939,374689,17250,0.044011950839288765,2021-11-08 05:18:45 UTC
777417,mainnet,244,105408000,105800240,392241,374961,17280,0.04405454809670585,2021-11-08 05:21:06 UTC
777419,mainnet,244,105408000,105800508,392509,375219,17290,0.04404994535157156,2021-11-08 05:23:21 UTC
777420,mainnet,244,105408000,105800804,392805,375502,17303,0.044049846616005396,2021-11-08 05:25:35 UTC
777422,mainnet,244,105408000,105801121,393122,375800,17322,0.0440626573938879,2021-11-08 05:28:09 UTC
777423,mainnet,244,105408000,105801427,393428,376089,17339,0.04407159632766351,2021-11-08 05:30:35 UTC
777425,mainnet,244,105408000,105801692,393693,376345,17348,0.04406479160157788,2021-11-08 05:32:43 UTC
777426,mainnet,244,105408000,105801980,393981,376619,17362,0.04406811495985847,2021-11-08 05:34:58 UTC
777428,mainnet,244,105408000,105802237,394238,376857,17381,0.04408758161313724,2021-11-08 05:37:12 UTC
777429,mainnet,244,105408000,105802513,394514,377124,17390,0.044079551042548556,2021-11-08 05:39:38 UTC
777431,mainnet,244,105408000,105802820,394821,377417,17404,0.04408073532056299,2021-11-08 05:42:04 UTC
777432,mainnet,244,105408000,105803070,395071,377649,17422,0.044098402565614786,2021-11-08 05:44:22 UTC
777434,mainnet,244,105408000,105803334,395335,377895,17440,0.04411448518345201,2021-11-08 05:46:33 UTC
777435,mainnet,244,105408000,105803616,395617,378161,17456,0.044123483065692325,2021-11-08 05:48:52 UTC
777437,mainnet,244,105408000,105803885,395886,378389,17497,0.044197066832370936,2021-11-08 05:51:15 UTC
777438,mainnet,244,105408000,105804152,396153,378652,17501,0.04417737591284176,2021-11-08 05:53:29 UTC
777440,mainnet,244,105408000,105804408,396409,378903,17506,0.04416145950268536,2021-11-08 05:55:42 UTC
777441,mainnet,244,105408000,105804701,396702,379181,17521,0.04416665406274735,2021-11-08 05:58:07 UTC
777443,mainnet,244,105408000,105804971,396972,379444,17528,0.04415424765474643,2021-11-08 06:00:27 UTC
777444,mainnet,244,105408000,105805270,397271,379723,17548,0.0441713590974423,2021-11-08 06:02:55 UTC
777446,mainnet,244,105408000,105805559,397560,379991,17569,0.04419207163698561,2021-11-08 06:05:20 UTC
777448,mainnet,244,105408000,105805820,397821,380242,17579,0.04418821530286234,2021-11-08 06:07:48 UTC
777449,mainnet,244,105408000,105806137,398138,380541,17597,0.04419824282032863,2021-11-08 06:10:11 UTC
777451,mainnet,244,105408000,105806424,398425,380825,17600,0.044173934868544894,2021-11-08 06:12:32 UTC
777452,mainnet,244,105408000,105806691,398692,381086,17606,0.04415940124206154,2021-11-08 06:14:56 UTC
777454,mainnet,244,105408000,105806956,398957,381342,17615,0.0441526279774512,2021-11-08 06:17:02 UTC
777455,mainnet,244,105408000,105807226,399227,381594,17633,0.04416785437858662,2021-11-08 06:19:21 UTC
777457,mainnet,244,105408000,105807486,399487,381847,17640,0.044156630879102446,2021-11-08 06:21:39 UTC
777458,mainnet,244,105408000,105807784,399785,382124,17661,0.044176244731543204,2021-11-08 06:24:05 UTC
777460,mainnet,244,105408000,105808022,400023,382349,17674,0.044182459508578256,2021-11-08 06:26:18 UTC
777461,mainnet,244,105408000,105808332,400333,382650,17683,0.04417072786904902,2021-11-08 06:28:48 UTC
777463,mainnet,244,105408000,105808713,400714,383019,17695,0.04415867676197987,2021-11-08 06:31:49 UTC
777464,mainnet,244,105408000,105808988,400989,383290,17699,0.04413836788540334,2021-11-08 06:34:19 UTC
777466,mainnet,244,105408000,105809281,401282,383568,17714,0.044143520018341216,2021-11-08 06:36:31 UTC
777468,mainnet,244,105408000,105809564,401565,383839,17726,0.04414229327755158,2021-11-08 06:38:57 UTC
777469,mainnet,244,105408000,105809820,401821,384074,17747,0.04416643231687742,2021-11-08 06:41:06 UTC
777470,mainnet,244,105408000,105810080,402081,384314,17767,0.04418761393848503,2021-11-08 06:43:14 UTC
777472,mainnet,244,105408000,105810335,402336,384551,17785,0.04420434661576394,2021-11-08 06:45:31 UTC
777473,mainnet,244,105408000,105810641,402642,384845,17797,0.04420055533203193,2021-11-08 06:48:01 UTC
777475,mainnet,244,105408000,105810942,402943,385136,17807,0.04419235474992741,2021-11-08 06:50:22 UTC
777477,mainnet,244,105408000,105811238,403239,385411,17828,0.04421199338357649,2021-11-08 06:52:51 UTC
777478,mainnet,244,105408000,105811508,403509,385676,17833,0.04419480110728633,2021-11-08 06:55:17 UTC
777480,mainnet,244,105408000,105811796,403797,385942,17855,0.044217762885806484,2021-11-08 06:57:38 UTC
777481,mainnet,244,105408000,105812062,404063,386187,17876,0.04424062584299973,2021-11-08 06:59:56 UTC
777483,mainnet,244,105408000,105812356,404357,386461,17896,0.04425792059986596,2021-11-08 07:02:14 UTC
777484,mainnet,244,105408000,105812618,404619,386708,17911,0.0442663345023343,2021-11-08 07:04:28 UTC
777486,mainnet,244,105408000,105812871,404872,386937,17935,0.044297950957339606,2021-11-08 07:06:42 UTC
777487,mainnet,244,105408000,105813118,405119,387157,17962,0.04433758969586714,2021-11-08 07:09:02 UTC
777489,mainnet,244,105408000,105813364,405365,387382,17983,0.04436248812798342,2021-11-08 07:11:09 UTC
777490,mainnet,244,105408000,105813647,405648,387641,18007,0.04439070326983,2021-11-08 07:13:27 UTC
777492,mainnet,244,105408000,105813930,405931,387898,18033,0.04442380601629341,2021-11-08 07:15:47 UTC
777493,mainnet,244,105408000,105814208,406209,388168,18041,0.04441309769109005,2021-11-08 07:18:02 UTC
777495,mainnet,244,105408000,105814510,406511,388458,18053,0.04440962237184234,2021-11-08 07:20:26 UTC
777496,mainnet,244,105408000,105814776,406777,388700,18077,0.044439582375601375,2021-11-08 07:22:32 UTC
777498,mainnet,244,105408000,105815032,407033,388944,18089,0.044441114111140864,2021-11-08 07:24:58 UTC
777499,mainnet,244,105408000,105815349,407350,389229,18121,0.04448508653492083,2021-11-08 07:27:19 UTC
777501,mainnet,244,105408000,105815630,407631,389492,18139,0.044498578371124864,2021-11-08 07:29:38 UTC
777502,mainnet,244,105408000,105815899,407900,389753,18147,0.04448884530522187,2021-11-08 07:31:55 UTC
777504,mainnet,244,105408000,105816186,408187,390010,18177,0.04453106051883083,2021-11-08 07:34:23 UTC
777505,mainnet,244,105408000,105816462,408463,390268,18195,0.04454503835108688,2021-11-08 07:36:42 UTC
777506,mainnet,244,105408000,105816766,408767,390546,18221,0.04457551612532323,2021-11-08 07:38:58 UTC
777507,mainnet,244,105408000,105817024,409025,390790,18235,0.04458162703991199,2021-11-08 07:41:09 UTC
777509,mainnet,244,105408000,105817302,409303,391063,18240,0.044563562935038346,2021-11-08 07:43:23 UTC
777510,mainnet,244,105408000,105817572,409573,391321,18252,0.04456348440937269,2021-11-08 07:45:34 UTC
777512,mainnet,244,105408000,105817811,409812,391528,18284,0.04461557982684743,2021-11-08 07:47:45 UTC
777513,mainnet,244,105408000,105818136,410137,391837,18300,0.04461923698666543,2021-11-08 07:50:23 UTC
777515,mainnet,244,105408000,105818410,410411,392106,18305,0.04460163104790076,2021-11-08 07:52:36 UTC
777517,mainnet,244,105408000,105818687,410688,392373,18315,0.04459589761570827,2021-11-08 07:55:13 UTC
777518,mainnet,244,105408000,105818997,410998,392657,18341,0.044625521292074415,2021-11-08 07:57:27 UTC
777520,mainnet,244,105408000,105819288,411289,392940,18349,0.04461339836465356,2021-11-08 07:59:41 UTC
777521,mainnet,244,105408000,105819551,411552,393200,18352,0.0445921779021849,2021-11-08 08:01:59 UTC
777523,mainnet,244,105408000,105819844,411845,393481,18364,0.044589590744090614,2021-11-08 08:04:25 UTC
777524,mainnet,244,105408000,105820091,412092,393723,18369,0.044574997816021665,2021-11-08 08:06:35 UTC
777526,mainnet,244,105408000,105820336,412337,393949,18388,0.04459459131729629,2021-11-08 08:08:42 UTC
777527,mainnet,244,105408000,105820589,412590,394200,18390,0.04457209336144841,2021-11-08 08:10:59 UTC
777529,mainnet,244,105408000,105820901,412902,394508,18394,0.04454810100217485,2021-11-08 08:13:19 UTC
777530,mainnet,244,105408000,105821172,413173,394766,18407,0.04455034573895197,2021-11-08 08:15:44 UTC
777532,mainnet,244,105408000,105821472,413473,395047,18426,0.044563973947512894,2021-11-08 08:18:08 UTC
777533,mainnet,244,105408000,105821780,413781,395331,18450,0.04458880422252351,2021-11-08 08:20:32 UTC
777535,mainnet,244,105408000,105822040,414041,395584,18457,0.044577710903026514,2021-11-08 08:22:48 UTC
777536,mainnet,244,105408000,105822332,414333,395868,18465,0.04456560302944733,2021-11-08 08:25:13 UTC
777538,mainnet,244,105408000,105822580,414581,396107,18474,0.04456065280367407,2021-11-08 08:27:22 UTC
777539,mainnet,244,105408000,105822844,414845,396352,18493,0.0445780954332341,2021-11-08 08:29:35 UTC
777541,mainnet,244,105408000,105823124,415125,396626,18499,0.04456248118036736,2021-11-08 08:32:00 UTC
777542,mainnet,244,105408000,105823440,415441,396924,18517,0.044571912738511604,2021-11-08 08:34:24 UTC
777544,mainnet,244,105408000,105823708,415709,397154,18555,0.04463458813737494,2021-11-08 08:36:35 UTC
777545,mainnet,244,105408000,105823984,415985,397412,18573,0.04464824452804789,2021-11-08 08:38:51 UTC
777547,mainnet,244,105408000,105824240,416241,397661,18580,0.04463760177397229,2021-11-08 08:41:02 UTC
777548,mainnet,244,105408000,105824529,416530,397925,18605,0.044666650661416944,2021-11-08 08:43:37 UTC
777550,mainnet,244,105408000,105824816,416817,398198,18619,0.04466948325044324,2021-11-08 08:45:55 UTC
777551,mainnet,244,105408000,105825100,417101,398478,18623,0.04464865823865203,2021-11-08 08:48:15 UTC
777553,mainnet,244,105408000,105825374,417375,398750,18625,0.044624138963761606,2021-11-08 08:50:27 UTC
777554,mainnet,244,105408000,105825633,417634,398999,18635,0.044620409257866936,2021-11-08 08:52:47 UTC
777556,mainnet,244,105408000,105825898,417899,399243,18656,0.04464236573909007,2021-11-08 08:55:00 UTC
777557,mainnet,244,105408000,105826140,418141,399467,18674,0.04465957655432019,2021-11-08 08:57:06 UTC
777559,mainnet,244,105408000,105826410,418411,399721,18690,0.04466899770799525,2021-11-08 08:59:23 UTC
777560,mainnet,244,105408000,105826590,418591,399900,18691,0.04465217837937271,2021-11-08 09:01:44 UTC
777561,mainnet,244,105408000,105826855,418856,400132,18724,0.04470271405924709,2021-11-08 09:03:21 UTC
777562,mainnet,244,105408000,105827107,419108,400356,18752,0.044742643900856104,2021-11-08 09:05:33 UTC
777564,mainnet,244,105408000,105827350,419351,400593,18758,0.04473102484553512,2021-11-08 09:07:41 UTC
777565,mainnet,244,105408000,105827622,419623,400856,18767,0.044723477979043094,2021-11-08 09:09:55 UTC
777567,mainnet,244,105408000,105827882,419883,401102,18781,0.04472912692345248,2021-11-08 09:12:12 UTC
777568,mainnet,244,105408000,105828164,420165,401382,18783,0.04470386633822427,2021-11-08 09:14:37 UTC
777570,mainnet,244,105408000,105828425,420426,401625,18801,0.044718927944513424,2021-11-08 09:16:43 UTC
777571,mainnet,244,105408000,105828674,420675,401869,18806,0.044704344208712186,2021-11-08 09:18:55 UTC
777573,mainnet,244,105408000,105828967,420968,402153,18815,0.044694608616331885,2021-11-08 09:21:24 UTC
777574,mainnet,244,105408000,105829236,421237,402409,18828,0.0446969283325064,2021-11-08 09:23:33 UTC
777576,mainnet,244,105408000,105829488,421489,402635,18854,0.04473189098647889,2021-11-08 09:25:48 UTC
777577,mainnet,244,105408000,105829730,421731,402864,18867,0.04473704802350313,2021-11-08 09:28:07 UTC
777579,mainnet,244,105408000,105830032,422033,403143,18890,0.0447595330222992,2021-11-08 09:30:34 UTC
777580,mainnet,244,105408000,105830316,422317,403409,18908,0.04477205511499655,2021-11-08 09:32:56 UTC
777582,mainnet,244,105408000,105830583,422584,403667,18917,0.044765064460556954,2021-11-08 09:35:15 UTC
777583,mainnet,244,105408000,105830884,422885,403943,18942,0.04479231942490275,2021-11-08 09:37:39 UTC
777585,mainnet,244,105408000,105831161,423162,404215,18947,0.0447748143736914,2021-11-08 09:39:55 UTC
777586,mainnet,244,105408000,105831441,423442,404475,18967,0.04479243910618219,2021-11-08 09:42:16 UTC
777588,mainnet,244,105408000,105831701,423702,404713,18989,0.04481687601191403,2021-11-08 09:44:27 UTC
777589,mainnet,244,105408000,105831967,423968,404969,18999,0.0448123443278738,2021-11-08 09:46:46 UTC
777591,mainnet,244,105408000,105832468,424469,405445,19024,0.04481834951433438,2021-11-08 09:50:54 UTC
777592,mainnet,244,105408000,105832702,424703,405668,19035,0.04481955625460616,2021-11-08 09:52:48 UTC
777594,mainnet,244,105408000,105832975,424976,405938,19038,0.04479782387711306,2021-11-08 09:55:03 UTC
777595,mainnet,244,105408000,105833209,425210,406167,19043,0.04478492979939324,2021-11-08 09:57:00 UTC
777597,mainnet,244,105408000,105833464,425465,406413,19052,0.04477924153573149,2021-11-08 09:58:59 UTC
777598,mainnet,244,105408000,105833715,425716,406652,19064,0.04478102772740512,2021-11-08 10:01:07 UTC
777600,mainnet,244,105408000,105833956,425957,406878,19079,0.0447909061243271,2021-11-08 10:03:13 UTC
777601,mainnet,244,105408000,105834207,426208,407128,19080,0.044766874389969215,2021-11-08 10:05:30 UTC
777603,mainnet,244,105408000,105834457,426458,407353,19105,0.04479925338485853,2021-11-08 10:07:27 UTC
777604,mainnet,244,105408000,105834676,426677,407552,19125,0.04482313318974306,2021-11-08 10:09:22 UTC
777606,mainnet,244,105408000,105834921,426922,407795,19127,0.04480209499627567,2021-11-08 10:11:31 UTC
777607,mainnet,244,105408000,105835154,427155,408018,19137,0.04480106752818064,2021-11-08 10:13:36 UTC
777608,mainnet,244,105408000,105835554,427555,408405,19150,0.04478955923799277,2021-11-08 10:17:00 UTC
777609,mainnet,244,105408000,105835792,427793,408634,19159,0.044785679055057,2021-11-08 10:18:55 UTC
777611,mainnet,244,105408000,105836033,428034,408867,19167,0.04477915305793465,2021-11-08 10:21:01 UTC
777613,mainnet,244,105408000,105836306,428307,409128,19179,0.04477862841373127,2021-11-08 10:23:20 UTC
777614,mainnet,244,105408000,105836540,428541,409349,19192,0.04478451303375873,2021-11-08 10:25:14 UTC
777615,mainnet,244,105408000,105836773,428774,409578,19196,0.044769505613679934,2021-11-08 10:27:14 UTC
777617,mainnet,244,105408000,105836976,428977,409771,19206,0.04477163111308998,2021-11-08 10:29:03 UTC
777618,mainnet,244,105408000,105837202,429203,409991,19212,0.04476203568008611,2021-11-08 10:30:59 UTC
777620,mainnet,244,105408000,105837446,429447,410214,19233,0.04478550321692781,2021-11-08 10:32:56 UTC
777621,mainnet,244,105408000,105837692,429693,410442,19251,0.044801753810278504,2021-11-08 10:34:53 UTC
777623,mainnet,244,105408000,105837942,429943,410686,19257,0.04478965816398918,2021-11-08 10:36:59 UTC
777624,mainnet,244,105408000,105838218,430219,410952,19267,0.04478416806324221,2021-11-08 10:39:15 UTC
777626,mainnet,244,105408000,105838462,430463,411196,19267,0.04475878298483261,2021-11-08 10:41:11 UTC
777627,mainnet,244,105408000,105838739,430740,411465,19275,0.04474857222454381,2021-11-08 10:43:28 UTC
777629,mainnet,244,105408000,105838979,430980,411694,19286,0.0447491762958838,2021-11-08 10:45:27 UTC
777630,mainnet,244,105408000,105839248,431249,411948,19301,0.04475604581112072,2021-11-08 10:47:40 UTC
777632,mainnet,244,105408000,105839459,431460,412154,19306,0.04474574699856302,2021-11-08 10:49:32 UTC
777633,mainnet,244,105408000,105839724,431725,412410,19315,0.04473912791707684,2021-11-08 10:51:44 UTC
777635,mainnet,244,105408000,105839966,431967,412644,19323,0.044732583739035624,2021-11-08 10:53:48 UTC
777636,mainnet,244,105408000,105839966,431967,412644,19323,0.044732583739035624,2021-11-08 10:56:02 UTC
777641,mainnet,245,105840000,105841258,1259,1143,116,0.09213661636219221,2021-11-08 11:06:58 UTC
777642,mainnet,245,105840000,105841483,1484,1365,119,0.08018867924528301,2021-11-08 11:08:49 UTC
777644,mainnet,245,105840000,105841692,1693,1558,135,0.07974010632014177,2021-11-08 11:10:31 UTC
777645,mainnet,245,105840000,105841915,1916,1772,144,0.07515657620041753,2021-11-08 11:12:27 UTC
777647,mainnet,245,105840000,105842123,2124,1970,154,0.07250470809792843,2021-11-08 11:14:16 UTC
777648,mainnet,245,105840000,105842355,2356,2192,164,0.06960950764006792,2021-11-08 11:16:15 UTC
777649,mainnet,245,105840000,105842565,2566,2391,175,0.0681995323460639,2021-11-08 11:17:58 UTC
777651,mainnet,245,105840000,105842780,2781,2597,184,0.06616325062927005,2021-11-08 11:19:45 UTC
777652,mainnet,245,105840000,105842988,2989,2803,186,0.06222816995650719,2021-11-08 11:21:30 UTC
777654,mainnet,245,105840000,105843213,3214,3016,198,0.06160547604231487,2021-11-08 11:23:18 UTC
777655,mainnet,245,105840000,105843470,3471,3262,209,0.06021319504465572,2021-11-08 11:25:20 UTC
777657,mainnet,245,105840000,105843699,3700,3482,218,0.05891891891891892,2021-11-08 11:27:15 UTC
777658,mainnet,245,105840000,105843948,3949,3725,224,0.05672322106862497,2021-11-08 11:29:22 UTC
777659,mainnet,245,105840000,105844185,4186,3955,231,0.05518394648829431,2021-11-08 11:31:08 UTC
777661,mainnet,245,105840000,105844415,4416,4171,245,0.05548007246376811,2021-11-08 11:33:01 UTC
777662,mainnet,245,105840000,105844621,4622,4371,251,0.05430549545651233,2021-11-08 11:34:49 UTC
777664,mainnet,245,105840000,105844850,4851,4591,260,0.05359719645433931,2021-11-08 11:37:11 UTC
777665,mainnet,245,105840000,105845160,5161,4877,284,0.055028095330362334,2021-11-08 11:39:08 UTC
777667,mainnet,245,105840000,105845384,5385,5065,320,0.059424326833797586,2021-11-08 11:41:18 UTC
777668,mainnet,245,105840000,105845614,5615,5282,333,0.059305431878895816,2021-11-08 11:43:12 UTC
777670,mainnet,245,105840000,105845857,5858,5516,342,0.05838170023898941,2021-11-08 11:45:20 UTC
777671,mainnet,245,105840000,105846136,6137,5776,361,0.058823529411764705,2021-11-08 11:47:35 UTC
777673,mainnet,245,105840000,105846357,6358,5985,373,0.05866624724756213,2021-11-08 11:49:24 UTC
777674,mainnet,245,105840000,105846587,6588,6210,378,0.05737704918032787,2021-11-08 11:51:18 UTC
777676,mainnet,245,105840000,105846856,6857,6469,388,0.05658451217733703,2021-11-08 11:53:30 UTC
777677,mainnet,245,105840000,105847098,7099,6702,397,0.05592336948866038,2021-11-08 11:55:31 UTC
777679,mainnet,245,105840000,105847338,7339,6937,402,0.05477585502112004,2021-11-08 11:57:31 UTC
777680,mainnet,245,105840000,105847546,7547,7143,404,0.053531204452100176,2021-11-08 11:59:21 UTC
777682,mainnet,245,105840000,105847794,7795,7368,427,0.054778704297626685,2021-11-08 12:01:19 UTC
777683,mainnet,245,105840000,105848006,8007,7567,440,0.05495191707256151,2021-11-08 12:03:13 UTC
777684,mainnet,245,105840000,105848232,8233,7788,445,0.054050771286286894,2021-11-08 12:05:03 UTC
777686,mainnet,245,105840000,105848474,8475,8016,459,0.05415929203539823,2021-11-08 12:07:13 UTC
777687,mainnet,245,105840000,105848723,8724,8256,468,0.05364511691884457,2021-11-08 12:09:17 UTC
777688,mainnet,245,105840000,105848963,8964,8490,474,0.05287817938420348,2021-11-08 12:11:25 UTC
777690,mainnet,245,105840000,105849224,9225,8748,477,0.05170731707317073,2021-11-08 12:13:27 UTC
777691,mainnet,245,105840000,105849453,9454,8968,486,0.05140681193145758,2021-11-08 12:15:26 UTC
777693,mainnet,245,105840000,105849667,9668,9175,493,0.05099296648738105,2021-11-08 12:17:21 UTC
777694,mainnet,245,105840000,105849887,9888,9373,515,0.052083333333333336,2021-11-08 12:19:21 UTC
777696,mainnet,245,105840000,105850116,10117,9588,529,0.05228822773549471,2021-11-08 12:21:28 UTC
777697,mainnet,245,105840000,105850360,10361,9828,533,0.05144291091593475,2021-11-08 12:23:23 UTC
777699,mainnet,245,105840000,105850611,10612,10077,535,0.05041462495288353,2021-11-08 12:25:30 UTC
777700,mainnet,245,105840000,105850872,10873,10332,541,0.0497562770164628,2021-11-08 12:27:40 UTC
777702,mainnet,245,105840000,105851132,11133,10575,558,0.050121261115602264,2021-11-08 12:29:38 UTC
777703,mainnet,245,105840000,105851376,11377,10790,587,0.051595323899094665,2021-11-08 12:31:46 UTC
777704,mainnet,245,105840000,105851604,11605,11000,605,0.052132701421800945,2021-11-08 12:33:52 UTC
777706,mainnet,245,105840000,105851874,11875,11250,625,0.05263157894736842,2021-11-08 12:35:58 UTC
777707,mainnet,245,105840000,105852127,12128,11498,630,0.051945910290237464,2021-11-08 12:38:07 UTC
777709,mainnet,245,105840000,105852360,12361,11727,634,0.05129034867729148,2021-11-08 12:40:07 UTC
777710,mainnet,245,105840000,105852554,12555,11911,644,0.05129430505774592,2021-11-08 12:42:01 UTC
777711,mainnet,245,105840000,105852760,12761,12095,666,0.05219026722043727,2021-11-08 12:43:59 UTC
777713,mainnet,245,105840000,105852997,12998,12318,680,0.0523157408832128,2021-11-08 12:45:56 UTC
777714,mainnet,245,105840000,105853240,13241,12547,694,0.05241295974624273,2021-11-08 12:47:52 UTC
777716,mainnet,245,105840000,105853466,13467,12764,703,0.05220167817628277,2021-11-08 12:49:49 UTC
777717,mainnet,245,105840000,105853684,13685,12969,716,0.052320058458165876,2021-11-08 12:51:44 UTC
777719,mainnet,245,105840000,105853904,13905,13184,721,0.05185185185185185,2021-11-08 12:53:40 UTC
777720,mainnet,245,105840000,105854150,14151,13412,739,0.05222245777683556,2021-11-08 12:55:36 UTC
777722,mainnet,245,105840000,105854403,14404,13650,754,0.052346570397111915,2021-11-08 12:57:41 UTC
777723,mainnet,245,105840000,105854672,14673,13905,768,0.05234103455326109,2021-11-08 13:00:06 UTC
777725,mainnet,245,105840000,105854931,14932,14143,789,0.052839539244575406,2021-11-08 13:02:24 UTC
777726,mainnet,245,105840000,105855171,15172,14375,797,0.052530978117585024,2021-11-08 13:04:29 UTC
777728,mainnet,245,105840000,105855472,15473,14657,816,0.05273702578685452,2021-11-08 13:07:21 UTC
777729,mainnet,245,105840000,105855784,15785,14942,843,0.053405131453911944,2021-11-08 13:09:37 UTC
777731,mainnet,245,105840000,105856025,16026,15178,848,0.05291401472607014,2021-11-08 13:11:44 UTC
777732,mainnet,245,105840000,105856260,16261,15399,862,0.05301026997109649,2021-11-08 13:13:47 UTC
777734,mainnet,245,105840000,105856525,16526,15656,870,0.05264431804429384,2021-11-08 13:15:51 UTC
777735,mainnet,245,105840000,105856760,16761,15882,879,0.052443171648469664,2021-11-08 13:17:56 UTC
777736,mainnet,245,105840000,105857018,17019,16135,884,0.051941947235442744,2021-11-08 13:20:04 UTC
777738,mainnet,245,105840000,105857263,17264,16361,903,0.05230537534754402,2021-11-08 13:22:06 UTC
777739,mainnet,245,105840000,105857504,17505,16589,916,0.052327906312482145,2021-11-08 13:24:13 UTC
777741,mainnet,245,105840000,105857726,17727,16801,926,0.05223670107745247,2021-11-08 13:26:08 UTC
777742,mainnet,245,105840000,105857960,17961,17020,941,0.05239129224430711,2021-11-08 13:28:04 UTC
777744,mainnet,245,105840000,105858204,18205,17259,946,0.051963746223564956,2021-11-08 13:30:05 UTC
777745,mainnet,245,105840000,105858432,18433,17476,957,0.05191775619812293,2021-11-08 13:32:06 UTC
777747,mainnet,245,105840000,105858693,18694,17716,978,0.05231625120359474,2021-11-08 13:34:16 UTC
777748,mainnet,245,105840000,105858951,18952,17960,992,0.052342760658505696,2021-11-08 13:36:17 UTC
777750,mainnet,245,105840000,105859202,19203,18191,1012,0.05270009894287351,2021-11-08 13:38:17 UTC
777751,mainnet,245,105840000,105859406,19407,18382,1025,0.052815994228886484,2021-11-08 13:40:29 UTC
777753,mainnet,245,105840000,105859669,19670,18614,1056,0.053685815963396034,2021-11-08 13:42:27 UTC
777754,mainnet,245,105840000,105859946,19947,18869,1078,0.05404321451847396,2021-11-08 13:44:41 UTC
777756,mainnet,245,105840000,105860161,20162,19072,1090,0.0540620970141851,2021-11-08 13:46:46 UTC
777757,mainnet,245,105840000,105860388,20389,19274,1115,0.054686350483103635,2021-11-08 13:48:42 UTC
777759,mainnet,245,105840000,105860620,20621,19485,1136,0.055089471897580136,2021-11-08 13:50:52 UTC
777760,mainnet,245,105840000,105860850,20851,19705,1146,0.054961392738957365,2021-11-08 13:52:52 UTC
777762,mainnet,245,105840000,105861112,21113,19949,1164,0.05513190925022498,2021-11-08 13:54:59 UTC
777763,mainnet,245,105840000,105861357,21358,20177,1181,0.055295439647907105,2021-11-08 13:57:07 UTC
777764,mainnet,245,105840000,105861572,21573,20368,1205,0.055856858109674126,2021-11-08 13:59:06 UTC
777766,mainnet,245,105840000,105861805,21806,20583,1223,0.056085481060258645,2021-11-08 14:01:12 UTC
777767,mainnet,245,105840000,105862027,22028,20788,1240,0.05629199201016888,2021-11-08 14:03:12 UTC
777769,mainnet,245,105840000,105862270,22271,21007,1264,0.05675542184904135,2021-11-08 14:05:14 UTC
777770,mainnet,245,105840000,105862499,22500,21218,1282,0.05697777777777778,2021-11-08 14:07:11 UTC
777771,mainnet,245,105840000,105862728,22729,21416,1313,0.05776760966166571,2021-11-08 14:09:11 UTC
777773,mainnet,245,105840000,105862964,22965,21631,1334,0.05808839538428043,2021-11-08 14:11:22 UTC
777774,mainnet,245,105840000,105863240,23241,21854,1387,0.05967901553289445,2021-11-08 14:13:30 UTC
777776,mainnet,245,105840000,105863426,23427,22006,1421,0.060656507448670335,2021-11-08 14:15:36 UTC
777777,mainnet,245,105840000,105863703,23704,22255,1449,0.06112892338845764,2021-11-08 14:17:49 UTC
777779,mainnet,245,105840000,105863950,23951,22489,1462,0.06104129263913824,2021-11-08 14:19:58 UTC
777780,mainnet,245,105840000,105864162,24163,22682,1481,0.06129205810536771,2021-11-08 14:21:57 UTC
777782,mainnet,245,105840000,105864426,24427,22924,1503,0.06153027387726696,2021-11-08 14:24:05 UTC
777783,mainnet,245,105840000,105864663,24664,23139,1525,0.06183100875770354,2021-11-08 14:26:09 UTC
777785,mainnet,245,105840000,105864905,24906,23372,1534,0.06159158435718301,2021-11-08 14:28:19 UTC
777786,mainnet,245,105840000,105865139,25140,23594,1546,0.06149562450278441,2021-11-08 14:30:23 UTC
777788,mainnet,245,105840000,105865356,25357,23806,1551,0.06116654178333399,2021-11-08 14:32:24 UTC
777789,mainnet,245,105840000,105865568,25569,24003,1566,0.061246040126715945,2021-11-08 14:34:22 UTC
777791,mainnet,245,105840000,105865837,25838,24255,1583,0.061266351884820804,2021-11-08 14:36:27 UTC
777792,mainnet,245,105840000,105866063,26064,24475,1589,0.06096531614487415,2021-11-08 14:38:31 UTC
777794,mainnet,245,105840000,105866267,26268,24667,1601,0.06094868280797929,2021-11-08 14:40:33 UTC
777795,mainnet,245,105840000,105866512,26513,24881,1632,0.06155470901067401,2021-11-08 14:42:46 UTC
777797,mainnet,245,105840000,105866690,26691,25041,1650,0.061818590536135774,2021-11-08 14:44:25 UTC
777798,mainnet,245,105840000,105866937,26938,25280,1658,0.06154874155468112,2021-11-08 14:46:47 UTC
777800,mainnet,245,105840000,105867202,27203,25531,1672,0.061463809138697936,2021-11-08 14:48:49 UTC
777801,mainnet,245,105840000,105867428,27429,25749,1680,0.06124904298370338,2021-11-08 14:50:52 UTC
777803,mainnet,245,105840000,105867662,27663,25968,1695,0.06127318078299534,2021-11-08 14:52:56 UTC
777804,mainnet,245,105840000,105867920,27921,26201,1720,0.06160237813831883,2021-11-08 14:55:07 UTC
777806,mainnet,245,105840000,105868155,28156,26420,1736,0.06165648529620685,2021-11-08 14:57:10 UTC
777807,mainnet,245,105840000,105868409,28410,26656,1754,0.061738824357620556,2021-11-08 14:59:14 UTC
777808,mainnet,245,105840000,105868641,28642,26878,1764,0.061587877941484535,2021-11-08 15:01:20 UTC
777810,mainnet,245,105840000,105868863,28864,27077,1787,0.061911031042128604,2021-11-08 15:03:24 UTC
777811,mainnet,245,105840000,105869093,29094,27283,1811,0.062246511308173505,2021-11-08 15:05:26 UTC
777813,mainnet,245,105840000,105869308,29309,27481,1828,0.06236992050223481,2021-11-08 15:07:28 UTC
777814,mainnet,245,105840000,105869543,29544,27698,1846,0.06248307608989981,2021-11-08 15:09:30 UTC
777816,mainnet,245,105840000,105869775,29776,27912,1864,0.06260075228371843,2021-11-08 15:11:33 UTC
777817,mainnet,245,105840000,105870036,30037,28163,1874,0.06238971934613976,2021-11-08 15:13:49 UTC
777819,mainnet,245,105840000,105870251,30252,28360,1892,0.06254131958217639,2021-11-08 15:15:44 UTC
777820,mainnet,245,105840000,105870485,30486,28581,1905,0.06248769927179689,2021-11-08 15:17:43 UTC
777822,mainnet,245,105840000,105870742,30743,28825,1918,0.06238818592850405,2021-11-08 15:19:56 UTC
777823,mainnet,245,105840000,105870978,30979,29046,1933,0.06239710771813164,2021-11-08 15:21:56 UTC
777825,mainnet,245,105840000,105871184,31185,29234,1951,0.06256212922879589,2021-11-08 15:24:05 UTC
777826,mainnet,245,105840000,105871464,31465,29486,1979,0.0628952804703639,2021-11-08 15:26:17 UTC
777828,mainnet,245,105840000,105871716,31717,29726,1991,0.06277390673771163,2021-11-08 15:28:20 UTC
777829,mainnet,245,105840000,105871959,31960,29949,2011,0.06292240300375469,2021-11-08 15:30:27 UTC
777831,mainnet,245,105840000,105872175,32176,30145,2031,0.0631215813028344,2021-11-08 15:32:26 UTC
777832,mainnet,245,105840000,105872402,32403,30363,2040,0.06295713359874086,2021-11-08 15:34:26 UTC
777833,mainnet,245,105840000,105872655,32656,30603,2053,0.06286746692797648,2021-11-08 15:36:36 UTC
777835,mainnet,245,105840000,105872859,32860,30787,2073,0.06308581862446744,2021-11-08 15:38:44 UTC
777836,mainnet,245,105840000,105873105,33106,31019,2087,0.0630399323385489,2021-11-08 15:40:57 UTC
777838,mainnet,245,105840000,105873357,33358,31257,2101,0.06298339228970562,2021-11-08 15:43:11 UTC
777839,mainnet,245,105840000,105873582,33583,31441,2142,0.06378227079176965,2021-11-08 15:45:11 UTC
777841,mainnet,245,105840000,105873843,33844,31685,2159,0.06379269589882992,2021-11-08 15:47:23 UTC
777842,mainnet,245,105840000,105874079,34080,31901,2179,0.06393779342723005,2021-11-08 15:49:47 UTC
777844,mainnet,245,105840000,105874346,34347,32153,2194,0.06387748566104755,2021-11-08 15:51:52 UTC
777845,mainnet,245,105840000,105874586,34587,32384,2203,0.06369445167259374,2021-11-08 15:53:59 UTC
777847,mainnet,245,105840000,105874832,34833,32622,2211,0.0634742916200155,2021-11-08 15:55:57 UTC
777848,mainnet,245,105840000,105875068,35069,32849,2220,0.06330377256266218,2021-11-08 15:58:00 UTC
777850,mainnet,245,105840000,105875306,35307,33063,2244,0.06355680176735491,2021-11-08 16:00:35 UTC
777851,mainnet,245,105840000,105875581,35582,33324,2258,0.0634590523298297,2021-11-08 16:02:51 UTC
777853,mainnet,245,105840000,105875800,35801,33517,2284,0.06379710063964694,2021-11-08 16:04:57 UTC
777854,mainnet,245,105840000,105876028,36029,33734,2295,0.06369868716866968,2021-11-08 16:07:04 UTC
777856,mainnet,245,105840000,105876278,36279,33955,2324,0.06405909754954657,2021-11-08 16:09:07 UTC
777857,mainnet,245,105840000,105876478,36479,34138,2341,0.06417390827599441,2021-11-08 16:11:16 UTC
777859,mainnet,245,105840000,105876701,36702,34352,2350,0.06402920821753583,2021-11-08 16:13:26 UTC
777860,mainnet,245,105840000,105876936,36937,34574,2363,0.063973793215475,2021-11-08 16:15:37 UTC
777862,mainnet,245,105840000,105877151,37152,34781,2371,0.06381890611541774,2021-11-08 16:17:40 UTC
777863,mainnet,245,105840000,105877420,37421,35017,2404,0.06424200315330963,2021-11-08 16:20:08 UTC
777865,mainnet,245,105840000,105877621,37622,35197,2425,0.06445696666843868,2021-11-08 16:22:08 UTC
777866,mainnet,245,105840000,105877894,37895,35431,2464,0.06502177068214804,2021-11-08 16:24:07 UTC
777868,mainnet,245,105840000,105878111,38112,35635,2477,0.06499265323257766,2021-11-08 16:26:10 UTC
777869,mainnet,245,105840000,105878343,38344,35854,2490,0.06493845190903401,2021-11-08 16:28:12 UTC
777871,mainnet,245,105840000,105878576,38577,36061,2516,0.06522020893278378,2021-11-08 16:30:13 UTC
777872,mainnet,245,105840000,105878845,38846,36326,2520,0.06487154404571899,2021-11-08 16:32:30 UTC
777874,mainnet,245,105840000,105879083,39084,36550,2534,0.06483471497287893,2021-11-08 16:34:44 UTC
777875,mainnet,245,105840000,105879282,39283,36723,2560,0.06516813888959601,2021-11-08 16:36:56 UTC
777877,mainnet,245,105840000,105879482,39483,36895,2588,0.06554719752805005,2021-11-08 16:38:53 UTC
777878,mainnet,245,105840000,105879790,39791,37170,2621,0.0658691663944108,2021-11-08 16:41:28 UTC
777880,mainnet,245,105840000,105880046,40047,37409,2638,0.06587259969535796,2021-11-08 16:43:41 UTC
777881,mainnet,245,105840000,105880276,40277,37617,2660,0.0660426546167788,2021-11-08 16:45:39 UTC
777883,mainnet,245,105840000,105880507,40508,37834,2674,0.0660116520193542,2021-11-08 16:47:36 UTC
777884,mainnet,245,105840000,105880760,40761,38072,2689,0.0659699222295822,2021-11-08 16:49:46 UTC
777886,mainnet,245,105840000,105880909,40910,38194,2716,0.06638963578587143,2021-11-08 16:51:59 UTC
777887,mainnet,245,105840000,105881205,41206,38445,2761,0.06700480512546717,2021-11-08 16:54:01 UTC
777889,mainnet,245,105840000,105881430,41431,38650,2781,0.06712365137216095,2021-11-08 16:56:04 UTC
777890,mainnet,245,105840000,105881665,41666,38874,2792,0.06700907214515432,2021-11-08 16:58:34 UTC
777892,mainnet,245,105840000,105881968,41969,39155,2814,0.06704948890848007,2021-11-08 17:01:05 UTC
777893,mainnet,245,105840000,105882274,42275,39439,2836,0.06708456534594914,2021-11-08 17:03:23 UTC
777895,mainnet,245,105840000,105882514,42515,39678,2837,0.0667293896271904,2021-11-08 17:05:21 UTC
777896,mainnet,245,105840000,105882768,42769,39910,2859,0.06684748299001614,2021-11-08 17:07:27 UTC
777898,mainnet,245,105840000,105883036,43037,40173,2864,0.06654738945558474,2021-11-08 17:09:38 UTC
777899,mainnet,245,105840000,105883325,43326,40437,2889,0.0666805151641047,2021-11-08 17:12:06 UTC
777901,mainnet,245,105840000,105883559,43560,40660,2900,0.06657483930211203,2021-11-08 17:14:08 UTC
777902,mainnet,245,105840000,105883792,43793,40885,2908,0.06640330646450346,2021-11-08 17:16:09 UTC
777904,mainnet,245,105840000,105884041,44042,41126,2916,0.06620952726942464,2021-11-08 17:18:19 UTC
777905,mainnet,245,105840000,105884290,44291,41370,2921,0.06595019304147569,2021-11-08 17:20:31 UTC
777907,mainnet,245,105840000,105884517,44518,41575,2943,0.06610809110921426,2021-11-08 17:22:31 UTC
777908,mainnet,245,105840000,105884757,44758,41805,2953,0.0659770320389651,2021-11-08 17:24:38 UTC
777910,mainnet,245,105840000,105885014,45015,42052,2963,0.06582250360990781,2021-11-08 17:26:43 UTC
777911,mainnet,245,105840000,105885258,45259,42286,2973,0.06568859232417862,2021-11-08 17:28:48 UTC
777913,mainnet,245,105840000,105885501,45502,42511,2991,0.06573337435717111,2021-11-08 17:30:56 UTC
777914,mainnet,245,105840000,105885726,45727,42716,3011,0.0658473112165679,2021-11-08 17:33:03 UTC
777915,mainnet,245,105840000,105885979,45980,42958,3022,0.06572422792518487,2021-11-08 17:35:08 UTC
777917,mainnet,245,105840000,105886227,46228,43188,3040,0.06576101064290041,2021-11-08 17:37:21 UTC
777918,mainnet,245,105840000,105886489,46490,43437,3053,0.06567003656700365,2021-11-08 17:39:27 UTC
777920,mainnet,245,105840000,105886732,46733,43670,3063,0.06554255023216998,2021-11-08 17:41:35 UTC
777921,mainnet,245,105840000,105886978,46979,43886,3093,0.06583792758466549,2021-11-08 17:43:46 UTC
777923,mainnet,245,105840000,105887351,47352,44244,3108,0.06563608717688799,2021-11-08 17:47:01 UTC
777925,mainnet,245,105840000,105887619,47620,44491,3129,0.06570768584628307,2021-11-08 17:49:13 UTC
777926,mainnet,245,105840000,105887868,47869,44732,3137,0.06553301719275523,2021-11-08 17:51:22 UTC
777928,mainnet,245,105840000,105888095,48096,44955,3141,0.06530688622754491,2021-11-08 17:53:21 UTC
777929,mainnet,245,105840000,105888355,48356,45201,3155,0.06524526428985028,2021-11-08 17:55:41 UTC
777931,mainnet,245,105840000,105888600,48601,45429,3172,0.06526614678710314,2021-11-08 17:57:44 UTC
777932,mainnet,245,105840000,105888823,48824,45650,3174,0.06500901196133049,2021-11-08 17:59:45 UTC
777934,mainnet,245,105840000,105889142,49143,45962,3181,0.06472946299574711,2021-11-08 18:02:35 UTC
777935,mainnet,245,105840000,105889372,49373,46172,3201,0.06483300589390963,2021-11-08 18:04:40 UTC
777937,mainnet,245,105840000,105889619,49620,46409,3211,0.0647118097541314,2021-11-08 18:06:51 UTC
777938,mainnet,245,105840000,105889867,49868,46650,3218,0.0645303601507981,2021-11-08 18:08:52 UTC
777940,mainnet,245,105840000,105890023,50024,46791,3233,0.06462897809051656,2021-11-08 18:10:57 UTC
777941,mainnet,245,105840000,105890320,50321,47066,3255,0.06468472407146122,2021-11-08 18:13:02 UTC
777942,mainnet,245,105840000,105890544,50545,47279,3266,0.0646156889900089,2021-11-08 18:15:03 UTC
777944,mainnet,245,105840000,105890808,50809,47529,3280,0.06455549213721978,2021-11-08 18:17:14 UTC
777945,mainnet,245,105840000,105891007,51008,47711,3297,0.06463691969887077,2021-11-08 18:19:16 UTC
777947,mainnet,245,105840000,105891234,51235,47930,3305,0.0645066848833805,2021-11-08 18:21:27 UTC
777948,mainnet,245,105840000,105891511,51512,48199,3313,0.06431511104208729,2021-11-08 18:23:42 UTC
777950,mainnet,245,105840000,105891720,51721,48385,3336,0.06449991299472169,2021-11-08 18:25:54 UTC
777951,mainnet,245,105840000,105891962,51963,48601,3362,0.06469988260877932,2021-11-08 18:27:57 UTC
777953,mainnet,245,105840000,105892167,52168,48788,3380,0.06479067627664468,2021-11-08 18:30:04 UTC
777954,mainnet,245,105840000,105892452,52453,49052,3401,0.064838998722666,2021-11-08 18:32:30 UTC
777956,mainnet,245,105840000,105892679,52680,49269,3411,0.06474943052391799,2021-11-08 18:34:33 UTC
777957,mainnet,245,105840000,105892899,52900,49481,3419,0.06463137996219281,2021-11-08 18:36:35 UTC
777959,mainnet,245,105840000,105893149,53150,49716,3434,0.0646095954844779,2021-11-08 18:38:46 UTC
777960,mainnet,245,105840000,105893386,53387,49930,3457,0.06475359169835353,2021-11-08 18:40:57 UTC
777962,mainnet,245,105840000,105893616,53617,50139,3478,0.06486748605852621,2021-11-08 18:43:02 UTC
777963,mainnet,245,105840000,105893818,53819,50338,3481,0.06467975993608205,2021-11-08 18:45:02 UTC
777964,mainnet,245,105840000,105894070,54071,50569,3502,0.06476669564091657,2021-11-08 18:47:14 UTC
777966,mainnet,245,105840000,105894327,54328,50816,3512,0.06464438227065233,2021-11-08 18:49:17 UTC
777967,mainnet,245,105840000,105894573,54574,51051,3523,0.0645545497856122,2021-11-08 18:51:20 UTC
777969,mainnet,245,105840000,105894833,54834,51309,3525,0.06428493270598534,2021-11-08 18:53:36 UTC
777970,mainnet,245,105840000,105895095,55096,51561,3535,0.06416073762160593,2021-11-08 18:55:50 UTC
777972,mainnet,245,105840000,105895392,55393,51843,3550,0.0640875200837651,2021-11-08 18:58:13 UTC
777973,mainnet,245,105840000,105895658,55659,52102,3557,0.06390700515639879,2021-11-08 19:00:23 UTC
777975,mainnet,245,105840000,105895906,55907,52341,3566,0.06378449925769582,2021-11-08 19:02:41 UTC
777976,mainnet,245,105840000,105896181,56182,52596,3586,0.06382827240041294,2021-11-08 19:04:45 UTC
777978,mainnet,245,105840000,105896352,56353,52752,3601,0.06390076837080545,2021-11-08 19:06:22 UTC
777979,mainnet,245,105840000,105896509,56510,52903,3607,0.0638294107237657,2021-11-08 19:07:43 UTC
777981,mainnet,245,105840000,105896667,56668,53060,3608,0.06366909013905556,2021-11-08 19:09:04 UTC
777982,mainnet,245,105840000,105896814,56815,53193,3622,0.06375077004312242,2021-11-08 19:10:23 UTC
777984,mainnet,245,105840000,105896982,56983,53351,3632,0.06373830791639612,2021-11-08 19:11:46 UTC
777985,mainnet,245,105840000,105897137,57138,53496,3642,0.06374041793552453,2021-11-08 19:13:07 UTC
777987,mainnet,245,105840000,105897289,57290,53641,3649,0.06369348926514226,2021-11-08 19:14:27 UTC
777988,mainnet,245,105840000,105897436,57437,53777,3660,0.06372199105106464,2021-11-08 19:15:48 UTC
777990,mainnet,245,105840000,105897597,57598,53921,3677,0.06383902218827042,2021-11-08 19:17:18 UTC
777991,mainnet,245,105840000,105897759,57760,54077,3683,0.06376385041551247,2021-11-08 19:18:41 UTC
777993,mainnet,245,105840000,105897909,57910,54218,3692,0.06375410119150406,2021-11-08 19:20:00 UTC
777994,mainnet,245,105840000,105898066,58067,54358,3709,0.06387448981349131,2021-11-08 19:21:21 UTC
777996,mainnet,245,105840000,105898201,58202,54491,3711,0.0637606955087454,2021-11-08 19:22:39 UTC
777997,mainnet,245,105840000,105898440,58441,54710,3731,0.06384216560291577,2021-11-08 19:24:41 UTC
777999,mainnet,245,105840000,105898606,58607,54863,3744,0.06388315388946712,2021-11-08 19:26:34 UTC
778001,mainnet,245,105840000,105898820,58821,55065,3756,0.06385474575406742,2021-11-08 19:27:57 UTC
778002,mainnet,245,105840000,105898961,58962,55196,3766,0.06387164614497473,2021-11-08 19:29:16 UTC
778004,mainnet,245,105840000,105899118,59119,55334,3785,0.06402341040951301,2021-11-08 19:30:36 UTC
778005,mainnet,245,105840000,105899317,59318,55513,3805,0.06414579048518157,2021-11-08 19:32:21 UTC
778007,mainnet,245,105840000,105899511,59512,55692,3820,0.06418873504503293,2021-11-08 19:34:03 UTC
778008,mainnet,245,105840000,105899688,59689,55854,3835,0.0642496942485215,2021-11-08 19:35:26 UTC
778010,mainnet,245,105840000,105899843,59844,55989,3855,0.06441748546220172,2021-11-08 19:36:56 UTC
778011,mainnet,245,105840000,105900014,60015,56141,3874,0.06455052903440807,2021-11-08 19:38:25 UTC
778013,mainnet,245,105840000,105900166,60167,56277,3890,0.06465338142170958,2021-11-08 19:39:59 UTC
778014,mainnet,245,105840000,105900365,60366,56458,3908,0.06473842891694,2021-11-08 19:41:35 UTC
778016,mainnet,245,105840000,105900521,60522,56598,3924,0.06483592743134728,2021-11-08 19:43:15 UTC
778017,mainnet,245,105840000,105900713,60714,56765,3949,0.06504265902427776,2021-11-08 19:44:52 UTC
778019,mainnet,245,105840000,105900863,60864,56905,3959,0.06504666140904311,2021-11-08 19:46:16 UTC
778020,mainnet,245,105840000,105901052,61053,57071,3982,0.065222020211947,2021-11-08 19:47:58 UTC
778022,mainnet,245,105840000,105901220,61221,57221,4000,0.06533705754561343,2021-11-08 19:49:31 UTC
778023,mainnet,245,105840000,105901396,61397,57387,4010,0.06531263742528137,2021-11-08 19:51:01 UTC
778025,mainnet,245,105840000,105901540,61541,57529,4012,0.06519231081717879,2021-11-08 19:52:26 UTC
778026,mainnet,245,105840000,105901720,61721,57698,4023,0.06518040861295184,2021-11-08 19:53:54 UTC
778028,mainnet,245,105840000,105901893,61894,57851,4043,0.0653213558664814,2021-11-08 19:55:25 UTC
778029,mainnet,245,105840000,105902052,62053,58009,4044,0.06517009653038532,2021-11-08 19:56:50 UTC
778031,mainnet,245,105840000,105902228,62229,58175,4054,0.06514647511610343,2021-11-08 19:58:21 UTC
778032,mainnet,245,105840000,105902400,62401,58347,4054,0.06496690758160927,2021-11-08 19:59:43 UTC
778034,mainnet,245,105840000,105902567,62568,58509,4059,0.06487341772151899,2021-11-08 20:01:12 UTC
778035,mainnet,245,105840000,105902728,62729,58660,4069,0.06486632976773103,2021-11-08 20:02:41 UTC
778037,mainnet,245,105840000,105902905,62906,58826,4080,0.06485867802753315,2021-11-08 20:04:16 UTC
778038,mainnet,245,105840000,105903071,63072,58991,4081,0.06470383054287164,2021-11-08 20:05:55 UTC
778040,mainnet,245,105840000,105903250,63251,59160,4091,0.06467881930720464,2021-11-08 20:07:22 UTC
778041,mainnet,245,105840000,105903408,63409,59301,4108,0.06478575596524153,2021-11-08 20:08:50 UTC
778043,mainnet,245,105840000,105903579,63580,59466,4114,0.06470588235294118,2021-11-08 20:10:29 UTC
778044,mainnet,245,105840000,105903735,63736,59608,4128,0.06476716455378435,2021-11-08 20:12:04 UTC
778046,mainnet,245,105840000,105903923,63924,59757,4167,0.06518678430636381,2021-11-08 20:13:31 UTC
778047,mainnet,245,105840000,105904103,64104,59928,4176,0.06514414077124672,2021-11-08 20:14:59 UTC
778049,mainnet,245,105840000,105904264,64265,60074,4191,0.06521434684509453,2021-11-08 20:16:25 UTC
778050,mainnet,245,105840000,105904438,64439,60240,4199,0.06516240165117398,2021-11-08 20:17:55 UTC
778052,mainnet,245,105840000,105904591,64592,60390,4202,0.06505449591280654,2021-11-08 20:19:20 UTC
778053,mainnet,245,105840000,105904784,64785,60563,4222,0.06516940649841785,2021-11-08 20:20:49 UTC
778055,mainnet,245,105840000,105904942,64943,60708,4235,0.06521103121198589,2021-11-08 20:22:14 UTC
778056,mainnet,245,105840000,105905111,65112,60872,4240,0.06511856493426711,2021-11-08 20:23:43 UTC
778057,mainnet,245,105840000,105905274,65275,61030,4245,0.0650325545767905,2021-11-08 20:25:11 UTC
778059,mainnet,245,105840000,105905448,65449,61193,4256,0.06502773151614234,2021-11-08 20:26:36 UTC
778060,mainnet,245,105840000,105905610,65611,61346,4265,0.06500434378381674,2021-11-08 20:28:00 UTC
778062,mainnet,245,105840000,105905770,65771,61492,4279,0.06505906858645907,2021-11-08 20:29:37 UTC
778063,mainnet,245,105840000,105905962,65963,61664,4299,0.06517289995906796,2021-11-08 20:31:16 UTC
778065,mainnet,245,105840000,105906140,66141,61833,4308,0.0651335782646165,2021-11-08 20:32:48 UTC
778067,mainnet,245,105840000,105906371,66372,62051,4321,0.06510275417344663,2021-11-08 20:34:39 UTC
778068,mainnet,245,105840000,105906598,66599,62252,4347,0.06527125031907385,2021-11-08 20:36:29 UTC
778070,mainnet,245,105840000,105906764,66765,62407,4358,0.06527372126113982,2021-11-08 20:38:01 UTC
778071,mainnet,245,105840000,105906942,66943,62572,4371,0.06529435489894388,2021-11-08 20:39:27 UTC
778073,mainnet,245,105840000,105907071,67072,62693,4379,0.06528804866412213,2021-11-08 20:40:49 UTC
778074,mainnet,245,105840000,105907243,67244,62843,4401,0.06544821842840996,2021-11-08 20:42:10 UTC
778076,mainnet,245,105840000,105907409,67410,62993,4417,0.06552440290758048,2021-11-08 20:43:40 UTC
778077,mainnet,245,105840000,105907591,67592,63168,4424,0.06545153272576636,2021-11-08 20:45:05 UTC
778079,mainnet,245,105840000,105907743,67744,63316,4428,0.0653637222484648,2021-11-08 20:46:28 UTC
778080,mainnet,245,105840000,105907912,67913,63474,4439,0.06536303800450577,2021-11-08 20:47:53 UTC
778082,mainnet,245,105840000,105908075,68076,63628,4448,0.0653387390563488,2021-11-08 20:49:16 UTC
778083,mainnet,245,105840000,105908207,68208,63751,4457,0.06534424114473375,2021-11-08 20:51:09 UTC
778085,mainnet,245,105840000,105908456,68457,63979,4478,0.06541332515301576,2021-11-08 20:53:02 UTC
778087,mainnet,245,105840000,105908613,68614,64124,4490,0.06543854023960124,2021-11-08 20:54:28 UTC
778088,mainnet,245,105840000,105908775,68776,64275,4501,0.06544434104920321,2021-11-08 20:55:47 UTC
778089,mainnet,245,105840000,105908927,68928,64412,4516,0.06551764159702879,2021-11-08 20:57:09 UTC
778091,mainnet,245,105840000,105909097,69098,64570,4528,0.06553011664592318,2021-11-08 20:58:33 UTC
778092,mainnet,245,105840000,105909236,69237,64708,4529,0.06541300171873421,2021-11-08 20:59:54 UTC
778094,mainnet,245,105840000,105909388,69389,64852,4537,0.06538500338670394,2021-11-08 21:01:24 UTC
778095,mainnet,245,105840000,105909544,69545,64998,4547,0.06538212668056655,2021-11-08 21:03:00 UTC
778097,mainnet,245,105840000,105909720,69721,65164,4557,0.06536050831169948,2021-11-08 21:04:23 UTC
778098,mainnet,245,105840000,105909889,69890,65321,4569,0.06537415939333238,2021-11-08 21:05:55 UTC
778100,mainnet,245,105840000,105910084,70085,65482,4603,0.06567739173860312,2021-11-08 21:07:26 UTC
778101,mainnet,245,105840000,105910252,70253,65649,4604,0.06553456791880774,2021-11-08 21:08:51 UTC
778103,mainnet,245,105840000,105910422,70423,65816,4607,0.06541896823480965,2021-11-08 21:10:19 UTC
778104,mainnet,245,105840000,105910588,70589,65974,4615,0.065378458400034,2021-11-08 21:11:53 UTC
778106,mainnet,245,105840000,105910760,70761,66142,4619,0.0652760701516372,2021-11-08 21:13:17 UTC
778107,mainnet,245,105840000,105910928,70929,66302,4627,0.06523424833283988,2021-11-08 21:14:39 UTC
778109,mainnet,245,105840000,105911079,71080,66447,4633,0.0651800787844682,2021-11-08 21:16:01 UTC
778110,mainnet,245,105840000,105911240,71241,66599,4642,0.06515910781712778,2021-11-08 21:17:24 UTC
778112,mainnet,245,105840000,105911424,71425,66774,4651,0.06511725586279314,2021-11-08 21:18:57 UTC
778113,mainnet,245,105840000,105911599,71600,66924,4676,0.06530726256983241,2021-11-08 21:20:21 UTC
778115,mainnet,245,105840000,105911731,71732,67052,4680,0.06524284838008142,2021-11-08 21:21:45 UTC
778116,mainnet,245,105840000,105911893,71894,67190,4704,0.06542966033326843,2021-11-08 21:23:08 UTC
778118,mainnet,245,105840000,105912052,72053,67335,4718,0.06547957753320473,2021-11-08 21:24:42 UTC
778119,mainnet,245,105840000,105912230,72231,67487,4744,0.06567817142224253,2021-11-08 21:26:21 UTC
778121,mainnet,245,105840000,105912371,72372,67615,4757,0.06572984026971757,2021-11-08 21:27:46 UTC
778122,mainnet,245,105840000,105912546,72547,67778,4769,0.0657366948323156,2021-11-08 21:29:28 UTC
778124,mainnet,245,105840000,105912691,72692,67913,4779,0.06574313542067903,2021-11-08 21:30:50 UTC
778125,mainnet,245,105840000,105912875,72876,68086,4790,0.06572808606399912,2021-11-08 21:32:26 UTC
778127,mainnet,245,105840000,105913012,73013,68214,4799,0.06572802103734951,2021-11-08 21:33:51 UTC
778128,mainnet,245,105840000,105913192,73193,68373,4820,0.06585329198147363,2021-11-08 21:35:25 UTC
778130,mainnet,245,105840000,105913304,73305,68480,4825,0.06582088534206398,2021-11-08 21:37:00 UTC
778131,mainnet,245,105840000,105913540,73541,68690,4851,0.06596320419901823,2021-11-08 21:38:25 UTC
778133,mainnet,245,105840000,105913699,73700,68828,4872,0.06610583446404342,2021-11-08 21:39:46 UTC
778134,mainnet,245,105840000,105913883,73884,69011,4873,0.06595473986248714,2021-11-08 21:41:19 UTC
778136,mainnet,245,105840000,105914042,74043,69162,4881,0.06592115392407115,2021-11-08 21:42:41 UTC
778137,mainnet,245,105840000,105914188,74189,69299,4890,0.0659127363894917,2021-11-08 21:44:02 UTC
778139,mainnet,245,105840000,105914360,74361,69455,4906,0.06597544411721198,2021-11-08 21:45:22 UTC
778140,mainnet,245,105840000,105914524,74525,69615,4910,0.0658839315665884,2021-11-08 21:46:43 UTC
778142,mainnet,245,105840000,105914700,74701,69789,4912,0.0657554785076505,2021-11-08 21:48:11 UTC
778143,mainnet,245,105840000,105914851,74852,69938,4914,0.0656495484422594,2021-11-08 21:49:33 UTC
778145,mainnet,245,105840000,105915009,75010,70091,4919,0.06557792294360752,2021-11-08 21:50:55 UTC
778146,mainnet,245,105840000,105915192,75193,70260,4933,0.0656045110582102,2021-11-08 21:52:26 UTC
778148,mainnet,245,105840000,105915352,75353,70411,4942,0.0655846482555439,2021-11-08 21:53:46 UTC
778149,mainnet,245,105840000,105915514,75515,70567,4948,0.06552340594583858,2021-11-08 21:55:06 UTC
778151,mainnet,245,105840000,105915672,75673,70720,4953,0.06545267136230888,2021-11-08 21:56:26 UTC
778152,mainnet,245,105840000,105915830,75831,70878,4953,0.0653162954464533,2021-11-08 21:57:48 UTC
778154,mainnet,245,105840000,105915950,75951,70981,4970,0.06543692643941489,2021-11-08 21:59:19 UTC
778155,mainnet,245,105840000,105916204,76205,71210,4995,0.06554688012597598,2021-11-08 22:01:09 UTC
778157,mainnet,245,105840000,105916388,76389,71382,5007,0.06554608647841967,2021-11-08 22:02:43 UTC
778158,mainnet,245,105840000,105916554,76555,71544,5011,0.06545620795506499,2021-11-08 22:04:04 UTC
778160,mainnet,245,105840000,105916731,76732,71720,5012,0.06531825053432727,2021-11-08 22:05:32 UTC
778161,mainnet,245,105840000,105916898,76899,71886,5013,0.06518940428354075,2021-11-08 22:06:56 UTC
778163,mainnet,245,105840000,105917057,77058,72034,5024,0.06519764333359288,2021-11-08 22:08:16 UTC
778164,mainnet,245,105840000,105917222,77223,72198,5025,0.0650712870517851,2021-11-08 22:09:38 UTC
778166,mainnet,245,105840000,105917392,77393,72355,5038,0.06509632654116006,2021-11-08 22:11:01 UTC
778167,mainnet,245,105840000,105917520,77521,72483,5038,0.06498884173320778,2021-11-08 22:12:27 UTC
778169,mainnet,245,105840000,105917737,77738,72692,5046,0.06491033985952815,2021-11-08 22:13:52 UTC
778170,mainnet,245,105840000,105917852,77853,72796,5057,0.06495574993898758,2021-11-08 22:15:14 UTC
778172,mainnet,245,105840000,105918020,78021,72949,5072,0.06500813883441638,2021-11-08 22:16:39 UTC
778173,mainnet,245,105840000,105918157,78158,73070,5088,0.06509890222370071,2021-11-08 22:18:01 UTC
778175,mainnet,245,105840000,105918296,78297,73192,5105,0.06520045467897877,2021-11-08 22:19:23 UTC
778176,mainnet,245,105840000,105918464,78465,73341,5124,0.06530300133817625,2021-11-08 22:20:50 UTC
778178,mainnet,245,105840000,105918631,78632,73503,5129,0.06522789703937329,2021-11-08 22:22:16 UTC
778179,mainnet,245,105840000,105918769,78770,73635,5135,0.06518979306842707,2021-11-08 22:23:50 UTC
778181,mainnet,245,105840000,105918959,78960,73811,5149,0.06521023302938196,2021-11-08 22:25:13 UTC
778182,mainnet,245,105840000,105919127,79128,73970,5158,0.06518552219189162,2021-11-08 22:26:37 UTC
778184,mainnet,245,105840000,105919320,79321,74159,5162,0.06507734395683362,2021-11-08 22:28:12 UTC
778185,mainnet,245,105840000,105919492,79493,74325,5168,0.06501201363642081,2021-11-08 22:29:36 UTC
778187,mainnet,245,105840000,105919701,79702,74525,5177,0.06495445534616447,2021-11-08 22:31:13 UTC
778188,mainnet,245,105840000,105919871,79872,74690,5182,0.06487880608974358,2021-11-08 22:32:37 UTC
778190,mainnet,245,105840000,105920036,80037,74854,5183,0.0647575496332946,2021-11-08 22:33:59 UTC
778191,mainnet,245,105840000,105920236,80237,75041,5196,0.06475815396886724,2021-11-08 22:35:36 UTC
778193,mainnet,245,105840000,105920422,80423,75219,5204,0.06470785720502842,2021-11-08 22:37:12 UTC
778194,mainnet,245,105840000,105920576,80577,75372,5205,0.06459659704382144,2021-11-08 22:38:33 UTC
778196,mainnet,245,105840000,105920744,80745,75535,5210,0.06452411914050406,2021-11-08 22:39:55 UTC
778197,mainnet,245,105840000,105920904,80905,75686,5219,0.06450775601013535,2021-11-08 22:41:17 UTC
778199,mainnet,245,105840000,105921066,81067,75841,5226,0.06446519545561079,2021-11-08 22:42:37 UTC
778200,mainnet,245,105840000,105921225,81226,75999,5227,0.06435131608105779,2021-11-08 22:43:59 UTC
778202,mainnet,245,105840000,105921391,81392,76163,5229,0.0642446432081777,2021-11-08 22:45:21 UTC
778203,mainnet,245,105840000,105921524,81525,76290,5235,0.06421343146274149,2021-11-08 22:46:41 UTC
778205,mainnet,245,105840000,105921724,81725,76476,5249,0.06422759253594372,2021-11-08 22:48:22 UTC
778206,mainnet,245,105840000,105921905,81906,76631,5275,0.06440309623226625,2021-11-08 22:49:46 UTC
778208,mainnet,245,105840000,105922076,82077,76801,5276,0.06428110189212569,2021-11-08 22:51:16 UTC
778209,mainnet,245,105840000,105922265,82266,76978,5288,0.06427928913524421,2021-11-08 22:52:49 UTC
778211,mainnet,245,105840000,105922434,82435,77143,5292,0.06419603323830897,2021-11-08 22:54:09 UTC
778212,mainnet,245,105840000,105922603,82604,77305,5299,0.06414943586267009,2021-11-08 22:55:38 UTC
778214,mainnet,245,105840000,105922776,82777,77472,5305,0.06408785048987037,2021-11-08 22:57:02 UTC
778215,mainnet,245,105840000,105922927,82928,77621,5307,0.06399527300791048,2021-11-08 22:58:30 UTC
778217,mainnet,245,105840000,105923110,83111,77802,5309,0.06387842764495674,2021-11-08 22:59:55 UTC
778218,mainnet,245,105840000,105923292,83293,77979,5314,0.06379887865727012,2021-11-08 23:01:37 UTC
778220,mainnet,245,105840000,105923472,83473,78159,5314,0.0636613036550741,2021-11-08 23:03:00 UTC
778221,mainnet,245,105840000,105923629,83630,78296,5334,0.06378093985411934,2021-11-08 23:04:20 UTC
778223,mainnet,245,105840000,105923794,83795,78455,5340,0.06372695268214094,2021-11-08 23:05:41 UTC
778224,mainnet,245,105840000,105923936,83937,78590,5347,0.06370253880886856,2021-11-08 23:07:00 UTC
778226,mainnet,245,105840000,105924076,84077,78723,5354,0.06367972215944907,2021-11-08 23:08:33 UTC
778227,mainnet,245,105840000,105924245,84246,78883,5363,0.06365880872682382,2021-11-08 23:09:53 UTC
778229,mainnet,245,105840000,105924407,84408,79035,5373,0.06365510378163207,2021-11-08 23:11:25 UTC
778230,mainnet,245,105840000,105924575,84576,79188,5388,0.06370601589103292,2021-11-08 23:12:55 UTC
778232,mainnet,245,105840000,105924700,84701,79291,5410,0.06387173705151061,2021-11-08 23:14:14 UTC
778233,mainnet,245,105840000,105924869,84870,79449,5421,0.06387416048073524,2021-11-08 23:15:59 UTC
778235,mainnet,245,105840000,105925020,85021,79582,5439,0.06397243034073935,2021-11-08 23:17:20 UTC
778236,mainnet,245,105840000,105925182,85183,79739,5444,0.06390946550368032,2021-11-08 23:18:52 UTC
778238,mainnet,245,105840000,105925421,85422,79971,5451,0.06381260096930533,2021-11-08 23:21:03 UTC
778240,mainnet,245,105840000,105925634,85635,80171,5464,0.06380568692707421,2021-11-08 23:22:33 UTC
778241,mainnet,245,105840000,105925806,85807,80340,5467,0.0637127507079842,2021-11-08 23:24:07 UTC
778243,mainnet,245,105840000,105925960,85961,80487,5474,0.06368004094880236,2021-11-08 23:25:29 UTC
778244,mainnet,245,105840000,105926108,86109,80622,5487,0.06372156220604118,2021-11-08 23:26:46 UTC
778246,mainnet,245,105840000,105926271,86272,80768,5504,0.06379821958456973,2021-11-08 23:28:07 UTC
778247,mainnet,245,105840000,105926428,86429,80923,5506,0.0637054692290782,2021-11-08 23:29:29 UTC
778249,mainnet,245,105840000,105926665,86666,81155,5511,0.06358895068423603,2021-11-08 23:31:31 UTC
778250,mainnet,245,105840000,105926835,86836,81320,5516,0.06352204154958772,2021-11-08 23:33:01 UTC
778252,mainnet,245,105840000,105927028,87029,81503,5526,0.0634960760206368,2021-11-08 23:34:33 UTC
778253,mainnet,245,105840000,105927208,87209,81682,5527,0.06337648637181942,2021-11-08 23:36:06 UTC
778255,mainnet,245,105840000,105927361,87362,81821,5541,0.06342574574757903,2021-11-08 23:37:42 UTC
778256,mainnet,245,105840000,105927515,87516,81949,5567,0.06361122537593125,2021-11-08 23:39:06 UTC
778258,mainnet,245,105840000,105927663,87664,82079,5585,0.0637091622558861,2021-11-08 23:40:39 UTC
778259,mainnet,245,105840000,105927811,87812,82217,5595,0.06371566528492689,2021-11-08 23:42:03 UTC
778261,mainnet,245,105840000,105927982,87983,82373,5610,0.06376231772046873,2021-11-08 23:43:28 UTC
778262,mainnet,245,105840000,105928155,88156,82541,5615,0.0636939062570897,2021-11-08 23:44:51 UTC
778264,mainnet,245,105840000,105928295,88296,82676,5620,0.06364954244812902,2021-11-08 23:46:18 UTC
778265,mainnet,245,105840000,105928435,88436,82792,5644,0.06382016373422589,2021-11-08 23:47:44 UTC
778267,mainnet,245,105840000,105928588,88589,82932,5657,0.0638566864960661,2021-11-08 23:49:06 UTC
778268,mainnet,245,105840000,105928756,88757,83087,5670,0.06388228534087452,2021-11-08 23:50:31 UTC
778270,mainnet,245,105840000,105928878,88879,83199,5680,0.06390710966595034,2021-11-08 23:51:53 UTC
778271,mainnet,245,105840000,105929029,89030,83333,5697,0.06398966640458273,2021-11-08 23:53:17 UTC
778273,mainnet,245,105840000,105929155,89156,83441,5715,0.06410112611602135,2021-11-08 23:54:40 UTC
778274,mainnet,245,105840000,105929342,89343,83596,5747,0.06432512899723537,2021-11-08 23:56:06 UTC
778276,mainnet,245,105840000,105929487,89488,83720,5768,0.06445556946182729,2021-11-08 23:57:29 UTC
778277,mainnet,245,105840000,105929640,89641,83862,5779,0.06446826786849767,2021-11-08 23:58:52 UTC
778278,mainnet,245,105840000,105929803,89804,84023,5781,0.06437352456460736,2021-11-09 00:00:17 UTC
778280,mainnet,245,105840000,105929971,89972,84181,5791,0.06436446894589427,2021-11-09 00:01:45 UTC
778281,mainnet,245,105840000,105930149,90150,84350,5800,0.06433721575152523,2021-11-09 00:03:21 UTC
778283,mainnet,245,105840000,105930306,90307,84474,5833,0.06459078476751526,2021-11-09 00:04:56 UTC
778285,mainnet,245,105840000,105930467,90468,84617,5851,0.0646748021399832,2021-11-09 00:06:18 UTC
778286,mainnet,245,105840000,105930598,90599,84716,5883,0.06493449155067937,2021-11-09 00:07:42 UTC
778287,mainnet,245,105840000,105930764,90765,84868,5897,0.0649699774142015,2021-11-09 00:09:08 UTC
778289,mainnet,245,105840000,105930932,90933,85036,5897,0.0648499444646058,2021-11-09 00:10:33 UTC
778290,mainnet,245,105840000,105931092,91093,85181,5912,0.0649007058720209,2021-11-09 00:12:11 UTC
778292,mainnet,245,105840000,105931211,91212,85285,5927,0.06498048502390036,2021-11-09 00:13:33 UTC
778293,mainnet,245,105840000,105931388,91389,85433,5956,0.06517195723774195,2021-11-09 00:14:51 UTC
778295,mainnet,245,105840000,105931532,91533,85575,5958,0.06509127855527515,2021-11-09 00:16:11 UTC
778296,mainnet,245,105840000,105931700,91701,85726,5975,0.06515741376866119,2021-11-09 00:17:41 UTC
778298,mainnet,245,105840000,105931875,91876,85893,5983,0.06512037964212634,2021-11-09 00:19:12 UTC
778299,mainnet,245,105840000,105932058,92059,86068,5991,0.06507783052173063,2021-11-09 00:20:36 UTC
778301,mainnet,245,105840000,105932216,92217,86221,5996,0.06502054935640934,2021-11-09 00:22:07 UTC
778303,mainnet,245,105840000,105932389,92390,86376,6014,0.06509362485117437,2021-11-09 00:23:36 UTC
778304,mainnet,245,105840000,105932540,92541,86511,6030,0.0651603073232405,2021-11-09 00:24:56 UTC
778305,mainnet,245,105840000,105932711,92712,86674,6038,0.0651264129778238,2021-11-09 00:26:18 UTC
778307,mainnet,245,105840000,105932894,92895,86857,6038,0.06499811615264546,2021-11-09 00:27:53 UTC
778308,mainnet,245,105840000,105933038,93039,86995,6044,0.06496200518062319,2021-11-09 00:29:12 UTC
778310,mainnet,245,105840000,105933191,93192,87133,6059,0.06501631041291098,2021-11-09 00:30:34 UTC
778312,mainnet,245,105840000,105933372,93373,87304,6069,0.06499737611515106,2021-11-09 00:32:15 UTC
778313,mainnet,245,105840000,105933580,93581,87493,6088,0.06505594084269242,2021-11-09 00:34:04 UTC
778315,mainnet,245,105840000,105933763,93764,87669,6095,0.0650036261251653,2021-11-09 00:35:28 UTC
778316,mainnet,245,105840000,105933961,93962,87859,6103,0.06495178902109364,2021-11-09 00:37:11 UTC
778318,mainnet,245,105840000,105934134,94135,88015,6120,0.06501301322568652,2021-11-09 00:38:39 UTC
778319,mainnet,245,105840000,105934335,94336,88216,6120,0.06487449118046133,2021-11-09 00:40:32 UTC
778321,mainnet,245,105840000,105934518,94519,88389,6130,0.06485468530136798,2021-11-09 00:41:52 UTC
778322,mainnet,245,105840000,105934684,94685,88532,6153,0.06498389396419707,2021-11-09 00:43:13 UTC
778324,mainnet,245,105840000,105934773,94774,88616,6158,0.06497562622660223,2021-11-09 00:44:42 UTC
778325,mainnet,245,105840000,105935007,95008,88821,6187,0.06512083192994274,2021-11-09 00:46:05 UTC
778327,mainnet,245,105840000,105935147,95148,88941,6207,0.06523521251103544,2021-11-09 00:47:27 UTC
778328,mainnet,245,105840000,105935314,95315,89101,6214,0.06519435555788701,2021-11-09 00:48:53 UTC
778330,mainnet,245,105840000,105935487,95488,89269,6219,0.0651286025469169,2021-11-09 00:50:18 UTC
778331,mainnet,245,105840000,105935657,95658,89438,6220,0.06502331221643773,2021-11-09 00:51:39 UTC
778333,mainnet,245,105840000,105935911,95912,89679,6233,0.06498665443323046,2021-11-09 00:53:44 UTC
778335,mainnet,245,105840000,105936050,96051,89814,6237,0.0649342536777337,2021-11-09 00:55:03 UTC
778336,mainnet,245,105840000,105936233,96234,89992,6242,0.0648627304279153,2021-11-09 00:56:27 UTC
778337,mainnet,245,105840000,105936402,96403,90151,6252,0.06485275354501416,2021-11-09 00:57:47 UTC
778339,mainnet,245,105840000,105936568,96569,90316,6253,0.06475162836935248,2021-11-09 00:59:12 UTC
778340,mainnet,245,105840000,105936743,96744,90481,6263,0.06473786488050938,2021-11-09 01:00:39 UTC
778342,mainnet,245,105840000,105936944,96945,90672,6273,0.0647067925112177,2021-11-09 01:02:19 UTC
778343,mainnet,245,105840000,105937095,97096,90812,6284,0.06471945291258137,2021-11-09 01:03:51 UTC
778345,mainnet,245,105840000,105937280,97281,90988,6293,0.0646888909447888,2021-11-09 01:05:14 UTC
778346,mainnet,245,105840000,105937465,97466,91171,6295,0.0645866250795149,2021-11-09 01:06:47 UTC
778348,mainnet,245,105840000,105937630,97631,91331,6300,0.0645286845366738,2021-11-09 01:08:17 UTC
778349,mainnet,245,105840000,105937810,97811,91501,6310,0.06451217143266094,2021-11-09 01:09:44 UTC
778351,mainnet,245,105840000,105937976,97977,91657,6320,0.06450493483164416,2021-11-09 01:11:08 UTC
778352,mainnet,245,105840000,105938174,98175,91845,6330,0.06447669977081742,2021-11-09 01:12:46 UTC
778354,mainnet,245,105840000,105938364,98365,92035,6330,0.06435215777969806,2021-11-09 01:14:19 UTC
778355,mainnet,245,105840000,105938518,98519,92180,6339,0.0643429186248338,2021-11-09 01:15:43 UTC
778357,mainnet,245,105840000,105938708,98709,92344,6365,0.06448246867053663,2021-11-09 01:17:07 UTC
778358,mainnet,245,105840000,105938880,98881,92511,6370,0.06442086953004116,2021-11-09 01:18:33 UTC
778360,mainnet,245,105840000,105939053,99054,92671,6383,0.06443959860278232,2021-11-09 01:19:58 UTC
778361,mainnet,245,105840000,105939224,99225,92838,6387,0.06436885865457294,2021-11-09 01:21:23 UTC
778363,mainnet,245,105840000,105939398,99399,93007,6392,0.06430648195655891,2021-11-09 01:22:51 UTC
778364,mainnet,245,105840000,105939581,99582,93189,6393,0.0641983490992348,2021-11-09 01:24:21 UTC
778366,mainnet,245,105840000,105939771,99772,93371,6401,0.06415627630998677,2021-11-09 01:25:53 UTC
778367,mainnet,245,105840000,105939941,99942,93533,6409,0.06412719377238799,2021-11-09 01:27:17 UTC
778369,mainnet,245,105840000,105940100,100101,93691,6410,0.06403532432243435,2021-11-09 01:28:34 UTC
778370,mainnet,245,105840000,105940267,100268,93852,6416,0.06398851079107991,2021-11-09 01:30:06 UTC
778372,mainnet,245,105840000,105940468,100469,94045,6424,0.06394012083329186,2021-11-09 01:31:38 UTC
778373,mainnet,245,105840000,105940648,100649,94222,6427,0.06385557730330157,2021-11-09 01:33:13 UTC
778375,mainnet,245,105840000,105940808,100809,94370,6439,0.06387326528385362,2021-11-09 01:34:33 UTC
778376,mainnet,245,105840000,105940963,100964,94523,6441,0.06379501604532309,2021-11-09 01:35:52 UTC
778378,mainnet,245,105840000,105941168,101169,94720,6449,0.06374482301890895,2021-11-09 01:37:24 UTC
778379,mainnet,245,105840000,105941329,101330,94874,6456,0.06371262212572781,2021-11-09 01:38:45 UTC
778381,mainnet,245,105840000,105941498,101499,95035,6464,0.06368535650597543,2021-11-09 01:40:07 UTC
778382,mainnet,245,105840000,105941682,101683,95200,6483,0.06375697019167413,2021-11-09 01:41:39 UTC
778384,mainnet,245,105840000,105941867,101868,95380,6488,0.06369026583421683,2021-11-09 01:43:10 UTC
778385,mainnet,245,105840000,105942032,102033,95541,6492,0.06362647378789216,2021-11-09 01:44:29 UTC
778387,mainnet,245,105840000,105942199,102200,95703,6497,0.06357142857142857,2021-11-09 01:45:50 UTC
778388,mainnet,245,105840000,105942378,102379,95876,6503,0.06351888570898329,2021-11-09 01:47:14 UTC
778390,mainnet,245,105840000,105942518,102519,96012,6507,0.06347116144324466,2021-11-09 01:48:32 UTC
778391,mainnet,245,105840000,105942664,102665,96136,6529,0.06359518823357523,2021-11-09 01:49:52 UTC
778393,mainnet,245,105840000,105942803,102804,96274,6530,0.06351892922454379,2021-11-09 01:51:16 UTC
778394,mainnet,245,105840000,105942947,102948,96415,6533,0.06345922213156156,2021-11-09 01:53:04 UTC
778396,mainnet,245,105840000,105943163,103164,96617,6547,0.0634620604086697,2021-11-09 01:54:23 UTC
778397,mainnet,245,105840000,105943358,103359,96798,6561,0.06347778132528371,2021-11-09 01:56:05 UTC
778399,mainnet,245,105840000,105943540,103541,96965,6576,0.06351107290831651,2021-11-09 01:57:38 UTC
778400,mainnet,245,105840000,105943698,103699,97115,6584,0.06349145121939459,2021-11-09 01:59:05 UTC
778402,mainnet,245,105840000,105943960,103961,97373,6588,0.06336991756524081,2021-11-09 02:01:12 UTC
778404,mainnet,245,105840000,105944142,104143,97546,6597,0.06334559211852933,2021-11-09 02:02:32 UTC
778405,mainnet,245,105840000,105944300,104301,97695,6606,0.06333592199499526,2021-11-09 02:03:51 UTC
778407,mainnet,245,105840000,105944456,104457,97843,6614,0.06331792029256057,2021-11-09 02:05:11 UTC
778408,mainnet,245,105840000,105944643,104644,98024,6620,0.0632621077175949,2021-11-09 02:06:51 UTC
778410,mainnet,245,105840000,105944822,104823,98195,6628,0.06323039790885589,2021-11-09 02:08:20 UTC
778411,mainnet,245,105840000,105944990,104991,98358,6633,0.06317684372946253,2021-11-09 02:09:45 UTC
778413,mainnet,245,105840000,105945137,105138,98500,6638,0.0631360687857863,2021-11-09 02:11:02 UTC
778414,mainnet,245,105840000,105945307,105308,98662,6646,0.06311011509097125,2021-11-09 02:12:23 UTC
778416,mainnet,245,105840000,105945492,105493,98821,6672,0.06324590257173461,2021-11-09 02:13:55 UTC
778417,mainnet,245,105840000,105945672,105673,98994,6679,0.0632044136155877,2021-11-09 02:15:27 UTC
778419,mainnet,245,105840000,105945844,105845,99146,6699,0.06329066087202985,2021-11-09 02:16:52 UTC
778420,mainnet,245,105840000,105946032,106033,99333,6700,0.06318787547273019,2021-11-09 02:18:24 UTC
778422,mainnet,245,105840000,105946196,106197,99486,6711,0.06319387553320716,2021-11-09 02:19:54 UTC
778423,mainnet,245,105840000,105946410,106411,99692,6719,0.06314196840552198,2021-11-09 02:21:27 UTC
778425,mainnet,245,105840000,105946570,106571,99851,6720,0.06305655384673128,2021-11-09 02:22:48 UTC
778426,mainnet,245,105840000,105946731,106732,100008,6724,0.06299891316568602,2021-11-09 02:24:09 UTC
778428,mainnet,245,105840000,105946897,106898,100167,6731,0.06296656625942487,2021-11-09 02:25:32 UTC
778429,mainnet,245,105840000,105947055,107056,100319,6737,0.06292968166193394,2021-11-09 02:26:53 UTC
778431,mainnet,245,105840000,105947227,107228,100487,6741,0.06286604245159846,2021-11-09 02:28:17 UTC
778432,mainnet,245,105840000,105947404,107405,100655,6750,0.0628462362087426,2021-11-09 02:29:37 UTC
778434,mainnet,245,105840000,105947559,107560,100801,6759,0.06283934548159167,2021-11-09 02:30:57 UTC
778435,mainnet,245,105840000,105947738,107739,100968,6771,0.06284632305850249,2021-11-09 02:32:21 UTC
778437,mainnet,245,105840000,105947893,107894,101120,6774,0.06278384340185737,2021-11-09 02:33:41 UTC
778438,mainnet,245,105840000,105948056,108057,101270,6787,0.06280944316425591,2021-11-09 02:35:05 UTC
778440,mainnet,245,105840000,105948220,108221,101421,6800,0.06283438519326194,2021-11-09 02:36:26 UTC
778441,mainnet,245,105840000,105948396,108397,101591,6806,0.06278771552718249,2021-11-09 02:37:59 UTC
778443,mainnet,245,105840000,105948557,108558,101746,6812,0.06274986643084803,2021-11-09 02:39:29 UTC
778444,mainnet,245,105840000,105948742,108743,101913,6830,0.06280864055617373,2021-11-09 02:40:59 UTC
778446,mainnet,245,105840000,105948916,108917,102074,6843,0.06282765775774213,2021-11-09 02:42:23 UTC
778447,mainnet,245,105840000,105949086,109087,102239,6848,0.0627755827917167,2021-11-09 02:43:44 UTC
778448,mainnet,245,105840000,105949248,109249,102401,6848,0.06268249594961968,2021-11-09 02:45:02 UTC
778450,mainnet,245,105840000,105949430,109431,102574,6857,0.0626604892580713,2021-11-09 02:46:38 UTC
778452,mainnet,245,105840000,105949596,109597,102737,6860,0.06259295418670219,2021-11-09 02:48:01 UTC
778453,mainnet,245,105840000,105949768,109769,102905,6864,0.06253131576310252,2021-11-09 02:49:21 UTC
778454,mainnet,245,105840000,105949924,109925,103055,6870,0.062497157152604045,2021-11-09 02:50:41 UTC
778456,mainnet,245,105840000,105950092,110093,103221,6872,0.062419954038858055,2021-11-09 02:52:04 UTC
778457,mainnet,245,105840000,105950243,110244,103369,6875,0.06236167047639781,2021-11-09 02:53:24 UTC
778459,mainnet,245,105840000,105950404,110405,103525,6880,0.06231601829627281,2021-11-09 02:54:46 UTC
778460,mainnet,245,105840000,105950572,110573,103687,6886,0.062275600734356486,2021-11-09 02:56:12 UTC
778462,mainnet,245,105840000,105950757,110758,103862,6896,0.06226186821719425,2021-11-09 02:57:39 UTC
778463,mainnet,245,105840000,105950926,110927,104022,6905,0.06224814517655756,2021-11-09 02:59:01 UTC
778465,mainnet,245,105840000,105951100,111101,104195,6906,0.06215965652874412,2021-11-09 03:00:27 UTC
778466,mainnet,245,105840000,105951132,111133,104226,6907,0.0621507563010087,2021-11-09 03:01:47 UTC
778468,mainnet,245,105840000,105951446,111447,104512,6935,0.062226888117221636,2021-11-09 03:03:29 UTC
778469,mainnet,245,105840000,105951624,111625,104682,6943,0.062199328107502797,2021-11-09 03:05:01 UTC
778471,mainnet,245,105840000,105951789,111790,104840,6950,0.062170140441899994,2021-11-09 03:06:23 UTC
778472,mainnet,245,105840000,105951950,111951,104995,6956,0.062134326625041314,2021-11-09 03:07:43 UTC
778474,mainnet,245,105840000,105952005,112006,105050,6956,0.062103815867007126,2021-11-09 03:09:07 UTC
778475,mainnet,245,105840000,105952236,112237,105265,6972,0.06211855270543582,2021-11-09 03:10:08 UTC
778477,mainnet,245,105840000,105952479,112480,105485,6995,0.062188833570412515,2021-11-09 03:12:03 UTC
778478,mainnet,245,105840000,105952661,112662,105655,7007,0.062194883811755516,2021-11-09 03:13:33 UTC
778480,mainnet,245,105840000,105952886,112887,105877,7010,0.06209749572581431,2021-11-09 03:15:22 UTC
778482,mainnet,245,105840000,105953090,113091,106061,7030,0.062162329451503656,2021-11-09 03:17:04 UTC
778483,mainnet,245,105840000,105953312,113313,106273,7040,0.06212879369533946,2021-11-09 03:18:50 UTC
778485,mainnet,245,105840000,105953472,113473,106424,7049,0.06212050443717889,2021-11-09 03:20:14 UTC
778486,mainnet,245,105840000,105953662,113663,106605,7058,0.06209584473399435,2021-11-09 03:21:48 UTC
778488,mainnet,245,105840000,105953828,113829,106760,7069,0.06210192481705014,2021-11-09 03:23:10 UTC
778489,mainnet,245,105840000,105953980,113981,106909,7072,0.06204542862406892,2021-11-09 03:24:29 UTC
778491,mainnet,245,105840000,105954202,114203,107116,7087,0.06205616314807842,2021-11-09 03:26:14 UTC
778492,mainnet,245,105840000,105954370,114371,107275,7096,0.062043699888957866,2021-11-09 03:27:36 UTC
778494,mainnet,245,105840000,105954534,114535,107434,7101,0.06199851573754747,2021-11-09 03:28:59 UTC
778495,mainnet,245,105840000,105954704,114705,107604,7101,0.061906630051000396,2021-11-09 03:30:24 UTC
778497,mainnet,245,105840000,105954863,114864,107761,7103,0.06183834795932581,2021-11-09 03:31:41 UTC
778498,mainnet,245,105840000,105955019,115020,107911,7109,0.06180664232307425,2021-11-09 03:33:05 UTC
778500,mainnet,245,105840000,105955196,115197,108079,7118,0.061789803553912,2021-11-09 03:34:26 UTC
778501,mainnet,245,105840000,105955368,115369,108246,7123,0.061741022285015906,2021-11-09 03:35:48 UTC
778503,mainnet,245,105840000,105955529,115530,108398,7132,0.061732883233792085,2021-11-09 03:37:09 UTC
778504,mainnet,245,105840000,105955712,115713,108579,7134,0.06165253688003941,2021-11-09 03:38:38 UTC
778506,mainnet,245,105840000,105955870,115871,108735,7136,0.06158572895720241,2021-11-09 03:40:01 UTC
778507,mainnet,245,105840000,105956036,116037,108893,7144,0.061566569283935293,2021-11-09 03:41:27 UTC
778509,mainnet,245,105840000,105956194,116195,109047,7148,0.061517276991264684,2021-11-09 03:42:46 UTC
778510,mainnet,245,105840000,105956344,116345,109196,7149,0.06144655980059306,2021-11-09 03:44:20 UTC
778512,mainnet,245,105840000,105956515,116516,109353,7163,0.06147653541144564,2021-11-09 03:45:40 UTC
778513,mainnet,245,105840000,105956665,116666,109477,7189,0.06162035211629781,2021-11-09 03:47:11 UTC
778515,mainnet,245,105840000,105956825,116826,109624,7202,0.061647236060465994,2021-11-09 03:48:35 UTC
778516,mainnet,245,105840000,105956988,116989,109783,7206,0.06159553462291326,2021-11-09 03:49:57 UTC
778518,mainnet,245,105840000,105957158,117159,109945,7214,0.061574441570856696,2021-11-09 03:51:18 UTC
778519,mainnet,245,105840000,105957320,117321,110100,7221,0.0615490832843225,2021-11-09 03:52:39 UTC
778521,mainnet,245,105840000,105957481,117482,110261,7221,0.061464735023237606,2021-11-09 03:54:01 UTC
778522,mainnet,245,105840000,105957639,117640,110411,7229,0.061450187011220674,2021-11-09 03:55:24 UTC
778523,mainnet,245,105840000,105957821,117822,110584,7238,0.06143165113476261,2021-11-09 03:56:50 UTC
778525,mainnet,245,105840000,105957981,117982,110740,7242,0.06138224474919903,2021-11-09 03:58:16 UTC
778526,mainnet,245,105840000,105958144,118145,110895,7250,0.06136527148842524,2021-11-09 03:59:40 UTC
778528,mainnet,245,105840000,105958309,118310,111047,7263,0.061389569774321695,2021-11-09 04:01:12 UTC
778529,mainnet,245,105840000,105958483,118484,111217,7267,0.061333175787448097,2021-11-09 04:02:39 UTC
778531,mainnet,245,105840000,105958649,118650,111378,7272,0.061289506953223764,2021-11-09 04:04:03 UTC
778532,mainnet,245,105840000,105958837,118838,111550,7288,0.06132718490718457,2021-11-09 04:05:36 UTC
778534,mainnet,245,105840000,105958990,118991,111696,7295,0.061307157684194605,2021-11-09 04:06:56 UTC
778535,mainnet,245,105840000,105959158,119159,111860,7299,0.06125429048582146,2021-11-09 04:08:19 UTC
778537,mainnet,245,105840000,105959318,119319,112015,7304,0.061214056436946336,2021-11-09 04:09:39 UTC
778538,mainnet,245,105840000,105959500,119501,112185,7316,0.061221245010502,2021-11-09 04:11:11 UTC
778540,mainnet,245,105840000,105959675,119676,112348,7328,0.061231993047895984,2021-11-09 04:12:33 UTC
778541,mainnet,245,105840000,105959849,119850,112522,7328,0.061143095536086774,2021-11-09 04:14:08 UTC
778543,mainnet,245,105840000,105960068,120069,112726,7343,0.0611565016782017,2021-11-09 04:15:49 UTC
778544,mainnet,245,105840000,105960230,120231,112887,7344,0.06108241634852908,2021-11-09 04:17:16 UTC
778546,mainnet,245,105840000,105960432,120433,113079,7354,0.06106299768335921,2021-11-09 04:18:53 UTC
778548,mainnet,245,105840000,105960624,120625,113256,7369,0.06109015544041451,2021-11-09 04:20:29 UTC
778549,mainnet,245,105840000,105960785,120786,113414,7372,0.06103356349245773,2021-11-09 04:21:53 UTC
778551,mainnet,245,105840000,105960979,120980,113604,7376,0.06096875516614316,2021-11-09 04:23:28 UTC
778552,mainnet,245,105840000,105961124,121125,113749,7376,0.060895768833849326,2021-11-09 04:24:52 UTC
778554,mainnet,245,105840000,105961315,121316,113923,7393,0.06094002439908998,2021-11-09 04:26:19 UTC
778555,mainnet,245,105840000,105961488,121489,114087,7402,0.06092732675386249,2021-11-09 04:27:45 UTC
778557,mainnet,245,105840000,105961651,121652,114245,7407,0.06088679183244008,2021-11-09 04:29:07 UTC
778558,mainnet,245,105840000,105961832,121833,114418,7415,0.060861999622433986,2021-11-09 04:30:40 UTC
778560,mainnet,245,105840000,105961993,121994,114573,7421,0.06083086053412463,2021-11-09 04:32:01 UTC
778561,mainnet,245,105840000,105962188,122189,114768,7421,0.06073378127327337,2021-11-09 04:33:32 UTC
778563,mainnet,245,105840000,105962362,122363,114933,7430,0.060720969574135975,2021-11-09 04:34:58 UTC
778564,mainnet,245,105840000,105962528,122529,115082,7447,0.06077744860400395,2021-11-09 04:36:23 UTC
778565,mainnet,245,105840000,105962692,122693,115241,7452,0.06073696135883873,2021-11-09 04:37:42 UTC
778567,mainnet,245,105840000,105962893,122894,115429,7465,0.06074340488551109,2021-11-09 04:39:21 UTC
778569,mainnet,245,105840000,105963055,123056,115591,7465,0.06066343778442335,2021-11-09 04:40:41 UTC
778570,mainnet,245,105840000,105963248,123249,115778,7471,0.0606171246825532,2021-11-09 04:42:16 UTC
778572,mainnet,245,105840000,105963405,123406,115934,7472,0.06054810949224511,2021-11-09 04:43:36 UTC
778573,mainnet,245,105840000,105963565,123566,116094,7472,0.060469708495864555,2021-11-09 04:45:02 UTC
778574,mainnet,245,105840000,105963757,123758,116274,7484,0.060472858320270204,2021-11-09 04:46:27 UTC
778576,mainnet,245,105840000,105963926,123927,116438,7489,0.06043073745027314,2021-11-09 04:47:50 UTC
778578,mainnet,245,105840000,105964124,124125,116631,7494,0.06037462235649547,2021-11-09 04:49:35 UTC
778579,mainnet,245,105840000,105964328,124329,116830,7499,0.060315775080632836,2021-11-09 04:51:19 UTC
778581,mainnet,245,105840000,105964486,124487,116977,7510,0.06032758440640388,2021-11-09 04:52:41 UTC
778582,mainnet,245,105840000,105964668,124669,117154,7515,0.06027962043491165,2021-11-09 04:54:14 UTC
778584,mainnet,245,105840000,105964870,124871,117337,7534,0.060334264961440204,2021-11-09 04:55:44 UTC
778585,mainnet,245,105840000,105965051,125052,117517,7535,0.06025493394747785,2021-11-09 04:57:26 UTC
778587,mainnet,245,105840000,105965262,125263,117723,7540,0.06019335318489897,2021-11-09 04:59:00 UTC
778588,mainnet,245,105840000,105965436,125437,117896,7541,0.060117828073056594,2021-11-09 05:00:28 UTC
778590,mainnet,245,105840000,105965613,125614,118066,7548,0.06008884360023564,2021-11-09 05:02:01 UTC
778591,mainnet,245,105840000,105965787,125788,118236,7552,0.0600375234521576,2021-11-09 05:03:24 UTC
778593,mainnet,245,105840000,105965932,125933,118372,7561,0.06003986246654967,2021-11-09 05:04:47 UTC
778594,mainnet,245,105840000,105966083,126084,118500,7584,0.06015037593984962,2021-11-09 05:06:08 UTC
778596,mainnet,245,105840000,105966295,126296,118696,7600,0.06017609425476658,2021-11-09 05:07:41 UTC
778597,mainnet,245,105840000,105966488,126489,118884,7605,0.060123805232075514,2021-11-09 05:09:15 UTC
778599,mainnet,245,105840000,105966649,126650,119036,7614,0.06011843663639953,2021-11-09 05:10:36 UTC
778600,mainnet,245,105840000,105966809,126810,119193,7617,0.060066240832741896,2021-11-09 05:12:01 UTC
778602,mainnet,245,105840000,105966985,126986,119365,7621,0.06001448978627565,2021-11-09 05:13:24 UTC
778603,mainnet,245,105840000,105967133,127134,119507,7627,0.05999181965485236,2021-11-09 05:14:46 UTC
778605,mainnet,245,105840000,105967329,127330,119689,7641,0.06000942433047986,2021-11-09 05:16:19 UTC
778606,mainnet,245,105840000,105967523,127524,119873,7651,0.0599965496690819,2021-11-09 05:17:53 UTC
778608,mainnet,245,105840000,105967702,127703,120043,7660,0.059982929140270785,2021-11-09 05:19:23 UTC
778609,mainnet,245,105840000,105967870,127871,120208,7663,0.05992758326751179,2021-11-09 05:20:48 UTC
778611,mainnet,245,105840000,105968044,128045,120375,7670,0.059900816119333046,2021-11-09 05:22:12 UTC
778612,mainnet,245,105840000,105968229,128230,120544,7686,0.05993917180067067,2021-11-09 05:23:41 UTC
778614,mainnet,245,105840000,105968391,128392,120702,7690,0.05989469748894012,2021-11-09 05:25:06 UTC
778615,mainnet,245,105840000,105968591,128592,120884,7708,0.059941520467836254,2021-11-09 05:26:44 UTC
778617,mainnet,245,105840000,105968742,128743,121035,7708,0.059871216299138594,2021-11-09 05:28:10 UTC
778618,mainnet,245,105840000,105968903,128904,121188,7716,0.05985849934835226,2021-11-09 05:29:36 UTC
778620,mainnet,245,105840000,105969059,129060,121334,7726,0.059863629319696264,2021-11-09 05:31:08 UTC
778621,mainnet,245,105840000,105969228,129229,121489,7740,0.05989367711581766,2021-11-09 05:32:42 UTC
778623,mainnet,245,105840000,105969416,129417,121675,7742,0.059822125377655175,2021-11-09 05:34:15 UTC
778624,mainnet,245,105840000,105969571,129572,121828,7744,0.05976599882690705,2021-11-09 05:35:39 UTC
778626,mainnet,245,105840000,105969709,129710,121954,7756,0.05979492714516999,2021-11-09 05:36:59 UTC
778627,mainnet,245,105840000,105969857,129858,122082,7776,0.05988079286605369,2021-11-09 05:38:23 UTC
778629,mainnet,245,105840000,105970018,130019,122233,7786,0.059883555480352874,2021-11-09 05:39:45 UTC
778630,mainnet,245,105840000,105970092,130093,122305,7788,0.05986486590362279,2021-11-09 05:41:08 UTC
778632,mainnet,245,105840000,105970345,130346,122540,7806,0.059886762923296456,2021-11-09 05:42:42 UTC
778633,mainnet,245,105840000,105970493,130494,122671,7823,0.05994911643447208,2021-11-09 05:44:14 UTC
778635,mainnet,245,105840000,105970675,130676,122824,7852,0.0600875447672105,2021-11-09 05:45:36 UTC
778636,mainnet,245,105840000,105970809,130810,122953,7857,0.06006421527406162,2021-11-09 05:47:09 UTC
778638,mainnet,245,105840000,105970984,130985,123112,7873,0.06010611902126198,2021-11-09 05:48:31 UTC
778639,mainnet,245,105840000,105971163,131164,123274,7890,0.06015370071056082,2021-11-09 05:49:55 UTC
778641,mainnet,245,105840000,105971330,131331,123435,7896,0.06012289558443932,2021-11-09 05:51:21 UTC
778642,mainnet,245,105840000,105971486,131487,123582,7905,0.060120011864290765,2021-11-09 05:52:41 UTC
778644,mainnet,245,105840000,105971710,131711,123797,7914,0.060086097592456214,2021-11-09 05:54:24 UTC
778645,mainnet,245,105840000,105971877,131878,123955,7923,0.06007825414398156,2021-11-09 05:55:46 UTC
778647,mainnet,245,105840000,105972040,132041,124098,7943,0.06015555774342818,2021-11-09 05:57:11 UTC
778648,mainnet,245,105840000,105972204,132205,124248,7957,0.06018683105782686,2021-11-09 05:58:38 UTC
778650,mainnet,245,105840000,105972399,132400,124415,7985,0.06030966767371601,2021-11-09 06:00:07 UTC
778651,mainnet,245,105840000,105972598,132599,124597,8002,0.06034736310228584,2021-11-09 06:01:43 UTC
778653,mainnet,245,105840000,105972836,132837,124830,8007,0.06027688068836243,2021-11-09 06:03:35 UTC
778654,mainnet,245,105840000,105972981,132982,124971,8011,0.060241235655953435,2021-11-09 06:05:02 UTC
778656,mainnet,245,105840000,105973173,133174,125133,8041,0.06037965368615496,2021-11-09 06:06:27 UTC
778657,mainnet,245,105840000,105973330,133331,125289,8042,0.060316055530971795,2021-11-09 06:07:49 UTC
778659,mainnet,245,105840000,105973494,133495,125453,8042,0.06024195662758905,2021-11-09 06:09:23 UTC
778660,mainnet,245,105840000,105973712,133713,125666,8047,0.06018113422030767,2021-11-09 06:10:54 UTC
778662,mainnet,245,105840000,105973902,133903,125850,8053,0.06014054950225163,2021-11-09 06:12:41 UTC
778663,mainnet,245,105840000,105974080,134081,126027,8054,0.06006816774934554,2021-11-09 06:14:02 UTC
778665,mainnet,245,105840000,105974241,134242,126165,8077,0.06016745876849272,2021-11-09 06:15:25 UTC
778666,mainnet,245,105840000,105974416,134417,126329,8088,0.06017096051838681,2021-11-09 06:16:47 UTC
778668,mainnet,245,105840000,105974572,134573,126484,8089,0.060108639920340635,2021-11-09 06:18:11 UTC
778669,mainnet,245,105840000,105974737,134738,126635,8103,0.06013893630601612,2021-11-09 06:19:35 UTC
778671,mainnet,245,105840000,105974930,134931,126822,8109,0.060097383106921316,2021-11-09 06:21:07 UTC
778672,mainnet,245,105840000,105975071,135072,126959,8113,0.06006426202321725,2021-11-09 06:22:27 UTC
778674,mainnet,245,105840000,105975244,135245,127116,8129,0.06010573403822692,2021-11-09 06:23:50 UTC
778675,mainnet,245,105840000,105975406,135407,127258,8149,0.06018152680437496,2021-11-09 06:25:11 UTC
778677,mainnet,245,105840000,105975568,135569,127416,8153,0.06013911734983662,2021-11-09 06:26:34 UTC
778678,mainnet,245,105840000,105975730,135731,127571,8160,0.060118911670878426,2021-11-09 06:27:56 UTC
778680,mainnet,245,105840000,105975884,135885,127724,8161,0.06005813739559186,2021-11-09 06:29:15 UTC
778681,mainnet,245,105840000,105976058,136059,127890,8169,0.06004012964963729,2021-11-09 06:30:37 UTC
778683,mainnet,245,105840000,105976224,136225,128052,8173,0.059996329601761794,2021-11-09 06:32:07 UTC
778684,mainnet,245,105840000,105976405,136406,128227,8179,0.05996070554081199,2021-11-09 06:33:33 UTC
778686,mainnet,245,105840000,105976584,136585,128392,8193,0.05998462495881685,2021-11-09 06:34:55 UTC
778687,mainnet,245,105840000,105976756,136757,128560,8197,0.05993843093954971,2021-11-09 06:36:15 UTC
778689,mainnet,245,105840000,105976909,136910,128712,8198,0.05987875246512307,2021-11-09 06:37:38 UTC
778690,mainnet,245,105840000,105977088,137089,128881,8208,0.05987351282743327,2021-11-09 06:39:01 UTC
778692,mainnet,245,105840000,105977269,137270,129057,8213,0.05983099001966927,2021-11-09 06:40:32 UTC
778693,mainnet,245,105840000,105977433,137434,129216,8218,0.059795974795174414,2021-11-09 06:41:56 UTC
778695,mainnet,245,105840000,105977611,137612,129390,8222,0.059747696421823676,2021-11-09 06:43:29 UTC
778696,mainnet,245,105840000,105977808,137809,129577,8232,0.059734850408899275,2021-11-09 06:45:03 UTC
778698,mainnet,245,105840000,105977974,137975,129739,8236,0.05969197318354774,2021-11-09 06:46:26 UTC
778699,mainnet,245,105840000,105978134,138135,129886,8249,0.05971694356969631,2021-11-09 06:47:49 UTC
778701,mainnet,245,105840000,105978339,138340,130082,8258,0.05969350874656643,2021-11-09 06:49:22 UTC
778702,mainnet,245,105840000,105978489,138490,130232,8258,0.05962885406888584,2021-11-09 06:50:46 UTC
778704,mainnet,245,105840000,105978694,138695,130418,8277,0.059677710083276256,2021-11-09 06:52:18 UTC
778705,mainnet,245,105840000,105978889,138890,130606,8284,0.059644322845417236,2021-11-09 06:53:53 UTC
778707,mainnet,245,105840000,105979074,139075,130790,8285,0.05957217328779436,2021-11-09 06:55:21 UTC
778708,mainnet,245,105840000,105979246,139247,130961,8286,0.059505770321802265,2021-11-09 06:56:41 UTC
778710,mainnet,245,105840000,105979407,139408,131114,8294,0.05949443360495811,2021-11-09 06:58:01 UTC
778711,mainnet,245,105840000,105979586,139587,131273,8314,0.059561420476118836,2021-11-09 06:59:34 UTC
778713,mainnet,245,105840000,105979792,139793,131479,8314,0.05947365032583892,2021-11-09 07:01:03 UTC
778714,mainnet,245,105840000,105979954,139955,131637,8318,0.05943338930370476,2021-11-09 07:02:26 UTC
778716,mainnet,245,105840000,105980140,140141,131815,8326,0.05941159261029963,2021-11-09 07:03:51 UTC
778717,mainnet,245,105840000,105980310,140311,131984,8327,0.05934673689161933,2021-11-09 07:05:23 UTC
778719,mainnet,245,105840000,105980494,140495,132147,8348,0.05941848464358162,2021-11-09 07:07:02 UTC
778720,mainnet,245,105840000,105980700,140701,132348,8353,0.05936702653143901,2021-11-09 07:08:34 UTC
778722,mainnet,245,105840000,105980861,140862,132505,8357,0.05932756882622709,2021-11-09 07:09:56 UTC
778723,mainnet,245,105840000,105981028,141029,132663,8366,0.05932113253302512,2021-11-09 07:11:22 UTC
778725,mainnet,245,105840000,105981210,141211,132828,8383,0.05936506362818761,2021-11-09 07:12:44 UTC
778726,mainnet,245,105840000,105981398,141399,133011,8388,0.05932149449430336,2021-11-09 07:14:17 UTC
778728,mainnet,245,105840000,105981567,141568,133171,8397,0.059314251808318265,2021-11-09 07:15:37 UTC
778729,mainnet,245,105840000,105981733,141734,133335,8399,0.05925889342006858,2021-11-09 07:17:00 UTC
778731,mainnet,245,105840000,105981928,141929,133530,8399,0.05917747606197465,2021-11-09 07:18:33 UTC
778732,mainnet,245,105840000,105982107,142108,133705,8403,0.05913108340135671,2021-11-09 07:20:06 UTC
778734,mainnet,245,105840000,105982276,142277,133866,8411,0.05911707443929799,2021-11-09 07:21:44 UTC
778735,mainnet,245,105840000,105982522,142523,134096,8427,0.05912729875178042,2021-11-09 07:23:28 UTC
778737,mainnet,245,105840000,105982686,142687,134251,8436,0.05912241479602206,2021-11-09 07:24:48 UTC
778738,mainnet,245,105840000,105982828,142829,134391,8438,0.059077638294744064,2021-11-09 07:26:14 UTC
778740,mainnet,245,105840000,105983023,143024,134576,8448,0.059067009732632285,2021-11-09 07:27:39 UTC
778741,mainnet,245,105840000,105983192,143193,134739,8454,0.05903919884351889,2021-11-09 07:29:02 UTC
778743,mainnet,245,105840000,105983361,143362,134900,8462,0.05902540422148129,2021-11-09 07:30:26 UTC
778744,mainnet,245,105840000,105983538,143539,135061,8478,0.059064087112213406,2021-11-09 07:31:49 UTC
778746,mainnet,245,105840000,105983710,143711,135224,8487,0.05905602215557612,2021-11-09 07:33:22 UTC
778747,mainnet,245,105840000,105983870,143871,135377,8494,0.0590390002154708,2021-11-09 07:34:42 UTC
778749,mainnet,245,105840000,105984030,144031,135534,8497,0.058994244294631015,2021-11-09 07:36:06 UTC
778750,mainnet,245,105840000,105984190,144191,135689,8502,0.05896345819087183,2021-11-09 07:37:31 UTC
778752,mainnet,245,105840000,105984370,144371,135859,8512,0.05895920925947732,2021-11-09 07:38:52 UTC
778753,mainnet,245,105840000,105984547,144548,136027,8521,0.058949276364944514,2021-11-09 07:40:19 UTC
778755,mainnet,245,105840000,105984727,144728,136205,8523,0.05888977944834448,2021-11-09 07:41:46 UTC
778756,mainnet,245,105840000,105984915,144916,136369,8547,0.05897899472798035,2021-11-09 07:43:19 UTC
778758,mainnet,245,105840000,105985112,145113,136557,8556,0.05896094767525997,2021-11-09 07:45:03 UTC
778759,mainnet,245,105840000,105985314,145315,136754,8561,0.05891339503836493,2021-11-09 07:46:28 UTC
778760,mainnet,245,105840000,105985486,145487,136921,8566,0.0588781128210768,2021-11-09 07:47:52 UTC
778761,mainnet,245,105840000,105985657,145658,137091,8567,0.05881585632097104,2021-11-09 07:49:19 UTC
778763,mainnet,245,105840000,105985824,145825,137258,8567,0.05874849991428081,2021-11-09 07:50:43 UTC
778764,mainnet,245,105840000,105985981,145982,137408,8574,0.058733268485155705,2021-11-09 07:52:06 UTC
778766,mainnet,245,105840000,105986158,146159,137575,8584,0.05873056055391731,2021-11-09 07:53:38 UTC
778767,mainnet,245,105840000,105986344,146345,137756,8589,0.05869008165635997,2021-11-09 07:55:02 UTC
778769,mainnet,245,105840000,105986516,146517,137920,8597,0.05867578506248421,2021-11-09 07:56:26 UTC
778770,mainnet,245,105840000,105986680,146681,138080,8601,0.05863745133998268,2021-11-09 07:57:48 UTC
778772,mainnet,245,105840000,105986874,146875,138259,8616,0.058662127659574466,2021-11-09 07:59:18 UTC
778773,mainnet,245,105840000,105987027,147028,138392,8636,0.05873711129852817,2021-11-09 08:00:58 UTC
778775,mainnet,245,105840000,105987212,147213,138563,8650,0.05875839769585566,2021-11-09 08:02:27 UTC
778776,mainnet,245,105840000,105987363,147364,138704,8660,0.05876604869574659,2021-11-09 08:03:52 UTC
778778,mainnet,245,105840000,105987538,147539,138861,8678,0.058818346335545175,2021-11-09 08:05:12 UTC
778779,mainnet,245,105840000,105987698,147699,139009,8690,0.05883587566605055,2021-11-09 08:06:34 UTC
778781,mainnet,245,105840000,105987882,147883,139178,8705,0.05886410202660211,2021-11-09 08:08:08 UTC
778782,mainnet,245,105840000,105988075,148076,139350,8726,0.05892919851967909,2021-11-09 08:09:51 UTC
778784,mainnet,245,105840000,105988273,148274,139535,8739,0.05893818201437879,2021-11-09 08:11:15 UTC
778785,mainnet,245,105840000,105988452,148453,139702,8751,0.058947949856183436,2021-11-09 08:12:41 UTC
778787,mainnet,245,105840000,105988636,148637,139886,8751,0.0588749772936752,2021-11-09 08:14:13 UTC
778788,mainnet,245,105840000,105988791,148792,140039,8753,0.05882708747782139,2021-11-09 08:15:35 UTC
778790,mainnet,245,105840000,105988966,148967,140196,8771,0.05887881208589822,2021-11-09 08:16:58 UTC
778791,mainnet,245,105840000,105989160,149161,140390,8771,0.05880223382787726,2021-11-09 08:18:43 UTC
778793,mainnet,245,105840000,105989344,149345,140565,8780,0.05879004988449563,2021-11-09 08:20:08 UTC
778794,mainnet,245,105840000,105989528,149529,140732,8797,0.05883139725404437,2021-11-09 08:21:35 UTC
778796,mainnet,245,105840000,105989689,149690,140892,8798,0.05877480125592892,2021-11-09 08:22:56 UTC
778797,mainnet,245,105840000,105989859,149860,141044,8816,0.05882823969037768,2021-11-09 08:24:18 UTC
778799,mainnet,245,105840000,105990040,150041,141217,8824,0.05881059177158243,2021-11-09 08:25:51 UTC
778800,mainnet,245,105840000,105990224,150225,141392,8833,0.058798468963221835,2021-11-09 08:27:25 UTC
778802,mainnet,245,105840000,105990389,150390,141547,8843,0.058800452157723254,2021-11-09 08:28:48 UTC
778803,mainnet,245,105840000,105990608,150609,141759,8850,0.058761428599884466,2021-11-09 08:30:41 UTC
778805,mainnet,245,105840000,105990797,150798,141948,8850,0.05868778100505312,2021-11-09 08:32:25 UTC
778806,mainnet,245,105840000,105991069,151070,142211,8859,0.058641689283113786,2021-11-09 08:34:22 UTC
778808,mainnet,245,105840000,105991268,151269,142404,8865,0.058604208396961704,2021-11-09 08:36:08 UTC
778810,mainnet,245,105840000,105991460,151461,142594,8867,0.05854312331227181,2021-11-09 08:37:44 UTC
778811,mainnet,245,105840000,105991661,151662,142792,8870,0.058485316031702074,2021-11-09 08:39:28 UTC
778813,mainnet,245,105840000,105991841,151842,142971,8871,0.05842257083020508,2021-11-09 08:40:54 UTC
778814,mainnet,245,105840000,105992083,152084,143203,8881,0.05839536045869388,2021-11-09 08:43:03 UTC
778816,mainnet,245,105840000,105992320,152321,143436,8885,0.058330762009177986,2021-11-09 08:44:58 UTC
778817,mainnet,245,105840000,105992484,152485,143595,8890,0.058300816473751516,2021-11-09 08:46:19 UTC
778819,mainnet,245,105840000,105992674,152675,143780,8895,0.058261011953495985,2021-11-09 08:47:52 UTC
778821,mainnet,245,105840000,105992863,152864,143959,8905,0.05825439606447561,2021-11-09 08:49:28 UTC
778822,mainnet,245,105840000,105993000,153001,144091,8910,0.058234913497297404,2021-11-09 08:50:51 UTC
778823,mainnet,245,105840000,105993188,153189,144265,8924,0.05825483552996625,2021-11-09 08:52:15 UTC
778825,mainnet,245,105840000,105993358,153359,144430,8929,0.05822286269472284,2021-11-09 08:53:38 UTC
778826,mainnet,245,105840000,105993520,153521,144592,8929,0.05816142416998326,2021-11-09 08:55:01 UTC
778828,mainnet,245,105840000,105993689,153690,144760,8930,0.0581039755351682,2021-11-09 08:56:24 UTC
778829,mainnet,245,105840000,105993856,153857,144908,8949,0.058164399409841604,2021-11-09 08:57:51 UTC
778831,mainnet,245,105840000,105994013,154014,145052,8962,0.05818951523887439,2021-11-09 08:59:13 UTC
778832,mainnet,245,105840000,105994224,154225,145249,8976,0.0582006808234722,2021-11-09 09:01:02 UTC
778834,mainnet,245,105840000,105994457,154458,145474,8984,0.058164679071333304,2021-11-09 09:02:59 UTC
778835,mainnet,245,105840000,105994646,154647,145653,8994,0.05815825719218608,2021-11-09 09:04:24 UTC
778837,mainnet,245,105840000,105994808,154809,145811,8998,0.05812323572918887,2021-11-09 09:05:46 UTC
778838,mainnet,245,105840000,105994984,154985,145985,9000,0.05807013581959544,2021-11-09 09:07:12 UTC
778840,mainnet,245,105840000,105995161,155162,146157,9005,0.05803611709052474,2021-11-09 09:08:36 UTC
778841,mainnet,245,105840000,105995326,155327,146317,9010,0.05800665692378015,2021-11-09 09:09:59 UTC
778843,mainnet,245,105840000,105995502,155503,146488,9015,0.057973158074120755,2021-11-09 09:11:25 UTC
778844,mainnet,245,105840000,105995596,155597,146582,9015,0.05793813505401775,2021-11-09 09:12:55 UTC
778846,mainnet,245,105840000,105995854,155855,146807,9048,0.05805396041192134,2021-11-09 09:14:26 UTC
778847,mainnet,245,105840000,105996070,156071,146998,9073,0.058133798079079396,2021-11-09 09:16:03 UTC
778849,mainnet,245,105840000,105996229,156230,147151,9079,0.05811303846892402,2021-11-09 09:17:26 UTC
778850,mainnet,245,105840000,105996385,156386,147306,9080,0.05806146330234164,2021-11-09 09:18:47 UTC
778852,mainnet,245,105840000,105996561,156562,147460,9102,0.05813671261225585,2021-11-09 09:20:14 UTC
778853,mainnet,245,105840000,105996730,156731,147624,9107,0.05810592671519993,2021-11-09 09:21:40 UTC
778855,mainnet,245,105840000,105996891,156892,147780,9112,0.058078168421589374,2021-11-09 09:23:00 UTC
778856,mainnet,245,105840000,105997076,157077,147953,9124,0.058086161564073674,2021-11-09 09:24:25 UTC
778858,mainnet,245,105840000,105997242,157243,148114,9129,0.05805663845131421,2021-11-09 09:25:50 UTC
778859,mainnet,245,105840000,105997411,157412,148282,9130,0.05800066068660585,2021-11-09 09:27:26 UTC
778861,mainnet,245,105840000,105997607,157608,148469,9139,0.05798563524694178,2021-11-09 09:28:49 UTC
778862,mainnet,245,105840000,105997775,157776,148622,9154,0.05801896359395599,2021-11-09 09:30:14 UTC
778864,mainnet,245,105840000,105997947,157948,148791,9157,0.05797477650872439,2021-11-09 09:31:50 UTC
778865,mainnet,245,105840000,105998138,158139,148967,9172,0.05799960793985039,2021-11-09 09:33:14 UTC
778867,mainnet,245,105840000,105998305,158306,149126,9180,0.0579889580938183,2021-11-09 09:34:39 UTC
778868,mainnet,245,105840000,105998484,158485,149292,9193,0.058005489478499546,2021-11-09 09:36:06 UTC
778870,mainnet,245,105840000,105998659,158660,149463,9197,0.05796672129081054,2021-11-09 09:37:27 UTC
778871,mainnet,245,105840000,105998832,158833,149630,9203,0.05794135979299012,2021-11-09 09:38:52 UTC
778873,mainnet,245,105840000,105999012,159013,149800,9213,0.057938659103343754,2021-11-09 09:40:28 UTC
778874,mainnet,245,105840000,105999204,159205,149983,9222,0.05792531641594171,2021-11-09 09:42:02 UTC
778876,mainnet,245,105840000,105999303,159304,150073,9231,0.057945814292170945,2021-11-09 09:43:50 UTC
778877,mainnet,245,105840000,105999614,159615,150355,9260,0.05801459762553645,2021-11-09 09:45:21 UTC
778879,mainnet,245,105840000,105999772,159773,150499,9274,0.058044851132544296,2021-11-09 09:46:42 UTC
778880,mainnet,245,105840000,105999995,159996,150717,9279,0.057995199879997,2021-11-09 09:48:35 UTC
778882,mainnet,245,105840000,106000168,160169,150882,9287,0.05798250597806067,2021-11-09 09:49:58 UTC
778884,mainnet,245,105840000,106000339,160340,151044,9296,0.05797679930148435,2021-11-09 09:51:35 UTC
778885,mainnet,245,105840000,106000524,160525,151222,9303,0.057953589783522816,2021-11-09 09:53:03 UTC
778887,mainnet,245,105840000,106000731,160732,151419,9313,0.057941169151133565,2021-11-09 09:54:55 UTC
778888,mainnet,245,105840000,106000893,160894,151578,9316,0.05790147550561239,2021-11-09 09:56:19 UTC
778890,mainnet,245,105840000,106001051,161052,151726,9326,0.05790676303305765,2021-11-09 09:57:45 UTC
778891,mainnet,245,105840000,106001232,161233,151895,9338,0.05791618341158448,2021-11-09 09:59:12 UTC
778893,mainnet,245,105840000,106001395,161396,152046,9350,0.05793204292547523,2021-11-09 10:00:36 UTC
778894,mainnet,245,105840000,106001529,161530,152178,9352,0.057896366000123815,2021-11-09 10:02:02 UTC
778896,mainnet,245,105840000,106001722,161723,152360,9363,0.05789529009479171,2021-11-09 10:03:36 UTC
778897,mainnet,245,105840000,106001864,161865,152489,9376,0.05792481388811664,2021-11-09 10:04:58 UTC
778898,mainnet,245,105840000,106002041,162042,152651,9391,0.0579541106626677,2021-11-09 10:06:26 UTC
778900,mainnet,245,105840000,106002221,162222,152813,9409,0.058000764384608744,2021-11-09 10:08:00 UTC
778901,mainnet,245,105840000,106002388,162389,152971,9418,0.057996539174451474,2021-11-09 10:09:26 UTC
778903,mainnet,245,105840000,106002582,162583,153159,9424,0.057964239803669514,2021-11-09 10:11:04 UTC
778904,mainnet,245,105840000,106002711,162712,153283,9429,0.057949014209154825,2021-11-09 10:12:29 UTC
778906,mainnet,245,105840000,106002912,162913,153458,9455,0.05803711183269598,2021-11-09 10:13:57 UTC
778907,mainnet,245,105840000,106003085,163086,153630,9456,0.057981678378278945,2021-11-09 10:15:22 UTC
778909,mainnet,245,105840000,106003253,163254,153797,9457,0.05792813652345425,2021-11-09 10:16:49 UTC
778910,mainnet,245,105840000,106003413,163414,153952,9462,0.057902015739165556,2021-11-09 10:18:15 UTC
778912,mainnet,245,105840000,106003589,163590,154109,9481,0.057955865272938445,2021-11-09 10:19:40 UTC
778913,mainnet,245,105840000,106003782,163783,154297,9486,0.057918098947998264,2021-11-09 10:21:16 UTC
778915,mainnet,245,105840000,106003964,163965,154467,9498,0.05792699661513128,2021-11-09 10:22:53 UTC
778916,mainnet,245,105840000,106004172,164173,154670,9503,0.057884061325552925,2021-11-09 10:24:27 UTC
778918,mainnet,245,105840000,106004343,164344,154835,9509,0.05786034172224115,2021-11-09 10:25:54 UTC
778919,mainnet,245,105840000,106004504,164505,154988,9517,0.05785234491352846,2021-11-09 10:27:17 UTC
778921,mainnet,245,105840000,106004694,164695,155167,9528,0.05785239381887732,2021-11-09 10:28:44 UTC
778922,mainnet,245,105840000,106004857,164858,155324,9534,0.05783158839728736,2021-11-09 10:30:19 UTC
778924,mainnet,245,105840000,106005061,165062,155519,9543,0.05781463934763907,2021-11-09 10:31:55 UTC
778925,mainnet,245,105840000,106005196,165197,155646,9551,0.057815819899877115,2021-11-09 10:33:20 UTC
778927,mainnet,245,105840000,106005355,165356,155794,9562,0.05782674955852827,2021-11-09 10:34:46 UTC
778928,mainnet,245,105840000,106005513,165514,155938,9576,0.05785613301593823,2021-11-09 10:36:11 UTC
778930,mainnet,245,105840000,106005679,165680,156100,9580,0.057822308063737324,2021-11-09 10:37:45 UTC
778931,mainnet,245,105840000,106005872,165873,156279,9594,0.05783943137219439,2021-11-09 10:39:09 UTC
778933,mainnet,245,105840000,106006064,166065,156463,9602,0.057820732845572514,2021-11-09 10:40:45 UTC
778934,mainnet,245,105840000,106006215,166216,156602,9614,0.05784040044279733,2021-11-09 10:42:08 UTC
778936,mainnet,245,105840000,106006419,166420,156779,9641,0.05793173897368105,2021-11-09 10:43:43 UTC
778937,mainnet,245,105840000,106006608,166609,156942,9667,0.05802207563817081,2021-11-09 10:45:11 UTC
778939,mainnet,245,105840000,106006772,166773,157104,9669,0.05797701066719433,2021-11-09 10:46:35 UTC
778940,mainnet,245,105840000,106006960,166961,157285,9676,0.05795365384730566,2021-11-09 10:48:12 UTC
778942,mainnet,245,105840000,106007147,167148,157468,9680,0.05791274798382272,2021-11-09 10:49:41 UTC
778943,mainnet,245,105840000,106007335,167336,157644,9692,0.05791939570684133,2021-11-09 10:51:11 UTC
778945,mainnet,245,105840000,106007520,167521,157828,9693,0.05786140245103599,2021-11-09 10:52:40 UTC
778946,mainnet,245,105840000,106007682,167683,157985,9698,0.057835320217314815,2021-11-09 10:54:02 UTC
778948,mainnet,245,105840000,106007858,167859,158160,9699,0.05778063732060837,2021-11-09 10:55:27 UTC
778949,mainnet,245,105840000,106008026,168027,158327,9700,0.05772881739244288,2021-11-09 10:56:51 UTC
778951,mainnet,245,105840000,106008221,168222,158508,9714,0.057745122516674394,2021-11-09 10:58:26 UTC
778952,mainnet,245,105840000,106008409,168410,158687,9723,0.05773410130039784,2021-11-09 11:00:02 UTC
778954,mainnet,245,105840000,106008608,168609,158877,9732,0.05771933882532961,2021-11-09 11:02:12 UTC
778956,mainnet,245,105840000,106008926,168927,159168,9759,0.05777051625850219,2021-11-09 11:04:16 UTC
778957,mainnet,245,105840000,106009091,169092,159328,9764,0.0577437134814184,2021-11-09 11:05:41 UTC
778959,mainnet,245,105840000,106009267,169268,159490,9778,0.057766382304983814,2021-11-09 11:07:07 UTC
778960,mainnet,245,105840000,106009434,169435,159654,9781,0.05772715200519373,2021-11-09 11:08:32 UTC
778962,mainnet,245,105840000,106009613,169614,159825,9789,0.05771339629983374,2021-11-09 11:09:55 UTC
778963,mainnet,245,105840000,106009800,169801,160011,9790,0.05765572640914953,2021-11-09 11:11:45 UTC
778965,mainnet,245,105840000,106010008,170009,160209,9800,0.05764400708197801,2021-11-09 11:13:19 UTC
778966,mainnet,245,105840000,106010189,170190,160373,9817,0.05768259004641871,2021-11-09 11:14:46 UTC
778968,mainnet,245,105840000,106010382,170383,160549,9834,0.05771702575961217,2021-11-09 11:16:19 UTC
778969,mainnet,245,105840000,106010541,170542,160707,9835,0.05766907858474745,2021-11-09 11:17:42 UTC
778971,mainnet,245,105840000,106010701,170702,160864,9838,0.05763259950088458,2021-11-09 11:19:04 UTC
778972,mainnet,245,105840000,106010865,170866,161011,9855,0.05767677595308605,2021-11-09 11:20:30 UTC
778973,mainnet,245,105840000,106011051,171052,161187,9865,0.05767252063699928,2021-11-09 11:21:57 UTC
778975,mainnet,245,105840000,106011242,171243,161377,9866,0.05761403385831829,2021-11-09 11:23:33 UTC
778977,mainnet,245,105840000,106011428,171429,161558,9871,0.05758068938160988,2021-11-09 11:24:58 UTC
778978,mainnet,245,105840000,106011580,171581,161698,9883,0.0575996176732855,2021-11-09 11:26:24 UTC
778979,mainnet,245,105840000,106011752,171753,161862,9891,0.057588513737751305,2021-11-09 11:27:47 UTC
778981,mainnet,245,105840000,106011928,171929,162032,9897,0.0575644597479192,2021-11-09 11:29:26 UTC
778982,mainnet,245,105840000,106012119,172120,162210,9910,0.05757610969091331,2021-11-09 11:30:52 UTC
778984,mainnet,245,105840000,106012295,172296,162370,9926,0.05761015926080698,2021-11-09 11:32:19 UTC
778985,mainnet,245,105840000,106012493,172494,162557,9937,0.0576078008510441,2021-11-09 11:33:54 UTC
778987,mainnet,245,105840000,106012636,172637,162691,9946,0.057612215226168204,2021-11-09 11:35:23 UTC
778988,mainnet,245,105840000,106012818,172819,162854,9965,0.057661483980349384,2021-11-09 11:36:46 UTC
778990,mainnet,245,105840000,106012981,172982,163005,9977,0.057676521256546924,2021-11-09 11:38:21 UTC
778991,mainnet,245,105840000,106013123,173124,163139,9985,0.05767542339594741,2021-11-09 11:39:45 UTC
778993,mainnet,245,105840000,106013339,173340,163336,10004,0.05771316487827391,2021-11-09 11:41:50 UTC
778995,mainnet,245,105840000,106013515,173516,163504,10012,0.05770073076834413,2021-11-09 11:43:13 UTC
778996,mainnet,245,105840000,106013697,173698,163670,10028,0.05773238609540697,2021-11-09 11:44:44 UTC
778998,mainnet,245,105840000,106013867,173868,163835,10033,0.05770469551613868,2021-11-09 11:46:12 UTC
778999,mainnet,245,105840000,106014040,174041,163995,10046,0.057722031015680214,2021-11-09 11:47:50 UTC
779001,mainnet,245,105840000,106014246,174247,164190,10057,0.05771691908612487,2021-11-09 11:49:19 UTC
779002,mainnet,245,105840000,106014431,174432,164370,10062,0.05768436984039626,2021-11-09 11:51:05 UTC
779004,mainnet,245,105840000,106014635,174636,164569,10067,0.05764561716942669,2021-11-09 11:52:33 UTC
779005,mainnet,245,105840000,106014839,174840,164767,10073,0.05761267444520705,2021-11-09 11:54:16 UTC
779007,mainnet,245,105840000,106015000,175001,164921,10080,0.05759967085902366,2021-11-09 11:55:41 UTC
779008,mainnet,245,105840000,106015175,175176,165088,10088,0.057587797415171026,2021-11-09 11:57:05 UTC
779010,mainnet,245,105840000,106015355,175356,165268,10088,0.0575286845046648,2021-11-09 11:58:32 UTC
779011,mainnet,245,105840000,106015510,175511,165412,10099,0.057540553013771215,2021-11-09 11:59:57 UTC
779013,mainnet,245,105840000,106015706,175707,165604,10103,0.05749913207783412,2021-11-09 12:01:36 UTC
779014,mainnet,245,105840000,106015916,175917,165812,10105,0.05744186178709278,2021-11-09 12:03:22 UTC
779016,mainnet,245,105840000,106016070,176071,165961,10110,0.05742001806089589,2021-11-09 12:04:39 UTC
779017,mainnet,245,105840000,106016219,176220,166109,10111,0.057377142208602884,2021-11-09 12:06:19 UTC
779019,mainnet,245,105840000,106016491,176492,166373,10119,0.05733404346939238,2021-11-09 12:08:16 UTC
779020,mainnet,245,105840000,106016660,176661,166531,10130,0.057341461895947604,2021-11-09 12:09:44 UTC
779022,mainnet,245,105840000,106016832,176833,166701,10132,0.05729699773232372,2021-11-09 12:11:10 UTC
779023,mainnet,245,105840000,106016953,176954,166821,10133,0.057263469602269516,2021-11-09 12:12:31 UTC
779025,mainnet,245,105840000,106017140,177141,166981,10160,0.05735544001670985,2021-11-09 12:13:59 UTC
779026,mainnet,245,105840000,106017275,177276,167115,10161,0.05731740337101469,2021-11-09 12:15:19 UTC
779028,mainnet,245,105840000,106017444,177445,167274,10171,0.05731916932007101,2021-11-09 12:16:42 UTC
779029,mainnet,245,105840000,106017598,177599,167427,10172,0.057275097269691835,2021-11-09 12:18:03 UTC
779031,mainnet,245,105840000,106017762,177763,167574,10189,0.05731788954956881,2021-11-09 12:19:23 UTC
779032,mainnet,245,105840000,106017899,177900,167710,10190,0.05727937043282743,2021-11-09 12:20:45 UTC
779034,mainnet,245,105840000,106018087,178088,167883,10205,0.05730313103634158,2021-11-09 12:22:24 UTC
779036,mainnet,245,105840000,106018310,178311,168100,10211,0.05726511544436406,2021-11-09 12:24:25 UTC
779037,mainnet,245,105840000,106018497,178498,168279,10219,0.057249941175811496,2021-11-09 12:25:51 UTC
779039,mainnet,245,105840000,106018666,178667,168427,10240,0.057313325907974055,2021-11-09 12:27:14 UTC
779040,mainnet,245,105840000,106018848,178849,168607,10242,0.05726618544134997,2021-11-09 12:28:44 UTC
779042,mainnet,245,105840000,106019017,179018,168759,10259,0.05730708643823526,2021-11-09 12:30:07 UTC
779043,mainnet,245,105840000,106019182,179183,168922,10261,0.05726547719370699,2021-11-09 12:31:32 UTC
779044,mainnet,245,105840000,106019330,179331,169056,10275,0.05729628452414808,2021-11-09 12:32:54 UTC
779046,mainnet,245,105840000,106019495,179496,169208,10288,0.05731604046886839,2021-11-09 12:34:16 UTC
779048,mainnet,245,105840000,106019649,179650,169352,10298,0.057322571667130534,2021-11-09 12:35:48 UTC
779049,mainnet,245,105840000,106019828,179829,169519,10310,0.05733224340901635,2021-11-09 12:37:10 UTC
779051,mainnet,245,105840000,106019982,179983,169662,10321,0.0573443047398921,2021-11-09 12:38:42 UTC
779052,mainnet,245,105840000,106020159,180160,169830,10330,0.05733792184724689,2021-11-09 12:40:14 UTC
779054,mainnet,245,105840000,106020305,180306,169973,10333,0.05730813173161182,2021-11-09 12:41:33 UTC
779055,mainnet,245,105840000,106020474,180475,170134,10341,0.057298794846931705,2021-11-09 12:42:57 UTC
779057,mainnet,245,105840000,106020647,180648,170299,10349,0.05728820689960586,2021-11-09 12:44:26 UTC
779058,mainnet,245,105840000,106020801,180802,170436,10366,0.057333436577029016,2021-11-09 12:45:51 UTC
779060,mainnet,245,105840000,106020975,180976,170604,10372,0.057311466713818406,2021-11-09 12:47:22 UTC
779061,mainnet,245,105840000,106021163,181164,170778,10386,0.0573292707160363,2021-11-09 12:48:58 UTC
779063,mainnet,245,105840000,106021314,181315,170920,10395,0.05733116399635993,2021-11-09 12:50:19 UTC
779064,mainnet,245,105840000,106021492,181493,171094,10399,0.05729697564093381,2021-11-09 12:51:44 UTC
779066,mainnet,245,105840000,106021672,181673,171267,10406,0.057278737071551636,2021-11-09 12:53:15 UTC
779067,mainnet,245,105840000,106021816,181817,171407,10410,0.05725537215991904,2021-11-09 12:54:37 UTC
779069,mainnet,245,105840000,106021994,181995,171572,10423,0.05727080414297096,2021-11-09 12:55:59 UTC
779070,mainnet,245,105840000,106022183,182184,171759,10425,0.05722236859438809,2021-11-09 12:57:35 UTC
779072,mainnet,245,105840000,106022336,182337,171906,10431,0.05720725908619754,2021-11-09 12:58:55 UTC
779073,mainnet,245,105840000,106022491,182492,172052,10440,0.05720798719943888,2021-11-09 13:00:18 UTC
779075,mainnet,245,105840000,106022690,182691,172240,10451,0.0572058831579005,2021-11-09 13:02:16 UTC
779076,mainnet,245,105840000,106022852,182853,172394,10459,0.05719895216375996,2021-11-09 13:03:44 UTC
779078,mainnet,245,105840000,106023032,183033,172553,10480,0.057257434451710894,2021-11-09 13:05:09 UTC
779079,mainnet,245,105840000,106023193,183194,172708,10486,0.05723986593447384,2021-11-09 13:06:34 UTC
779081,mainnet,245,105840000,106023360,183361,172873,10488,0.057198640932368386,2021-11-09 13:08:14 UTC
779082,mainnet,245,105840000,106023553,183554,173049,10505,0.05723111454939691,2021-11-09 13:09:39 UTC
779084,mainnet,245,105840000,106023716,183717,173186,10531,0.05732185916382262,2021-11-09 13:11:03 UTC
779085,mainnet,245,105840000,106023886,183887,173333,10554,0.05739394301935428,2021-11-09 13:12:44 UTC
779087,mainnet,245,105840000,106024040,184041,173482,10559,0.05737308534511332,2021-11-09 13:14:19 UTC
779088,mainnet,245,105840000,106024272,184273,173688,10585,0.05744194754521824,2021-11-09 13:15:50 UTC
779090,mainnet,245,105840000,106024400,184401,173807,10594,0.05745088150281181,2021-11-09 13:17:18 UTC
779091,mainnet,245,105840000,106024590,184591,173984,10607,0.05746217312870075,2021-11-09 13:19:00 UTC
779093,mainnet,245,105840000,106024744,184745,174138,10607,0.05741427372865301,2021-11-09 13:20:28 UTC
779094,mainnet,245,105840000,106024924,184925,174290,10635,0.057509801270785456,2021-11-09 13:21:56 UTC
779096,mainnet,245,105840000,106025111,185112,174456,10656,0.057565149747180085,2021-11-09 13:23:35 UTC
779097,mainnet,245,105840000,106025301,185302,174642,10660,0.057527711519573456,2021-11-09 13:25:00 UTC
779099,mainnet,245,105840000,106025482,185483,174818,10665,0.05749853086266666,2021-11-09 13:26:35 UTC
779100,mainnet,245,105840000,106025648,185649,174981,10668,0.057463277475235525,2021-11-09 13:28:10 UTC
779102,mainnet,245,105840000,106025796,185797,175121,10676,0.05746056179593858,2021-11-09 13:30:03 UTC
779103,mainnet,245,105840000,106026055,186056,175364,10692,0.05746656920497055,2021-11-09 13:31:39 UTC
779105,mainnet,245,105840000,106026273,186274,175576,10698,0.05743152560207007,2021-11-09 13:33:31 UTC
779107,mainnet,245,105840000,106026437,186438,175719,10719,0.05749364399961381,2021-11-09 13:35:05 UTC
779108,mainnet,245,105840000,106026607,186608,175869,10739,0.057548443796621794,2021-11-09 13:36:29 UTC
779110,mainnet,245,105840000,106026753,186754,176013,10741,0.05751416301658867,2021-11-09 13:38:02 UTC
779111,mainnet,245,105840000,106026984,186985,176236,10749,0.05748589459047517,2021-11-09 13:39:54 UTC
779113,mainnet,245,105840000,106027130,187131,176382,10749,0.057441043974541896,2021-11-09 13:41:18 UTC
779114,mainnet,245,105840000,106027324,187325,176566,10759,0.057434939276658215,2021-11-09 13:42:48 UTC
779115,mainnet,245,105840000,106027479,187480,176713,10767,0.05743012588009388,2021-11-09 13:44:25 UTC
779116,mainnet,245,105840000,106027683,187684,176896,10788,0.05747959335905032,2021-11-09 13:46:07 UTC
779118,mainnet,245,105840000,106027869,187870,177066,10804,0.05750785117368393,2021-11-09 13:47:29 UTC
779119,mainnet,245,105840000,106028007,188008,177195,10813,0.05751351006340156,2021-11-09 13:48:53 UTC
779121,mainnet,245,105840000,106028196,188197,177367,10830,0.05754608203106319,2021-11-09 13:50:21 UTC
779122,mainnet,245,105840000,106028342,188343,177504,10839,0.05754925853363279,2021-11-09 13:51:47 UTC
779124,mainnet,245,105840000,106028541,188542,177684,10858,0.05758929044987324,2021-11-09 13:53:23 UTC
779125,mainnet,245,105840000,106028689,188690,177826,10864,0.05757591817266416,2021-11-09 13:54:44 UTC
779127,mainnet,245,105840000,106028850,188851,177981,10870,0.057558604402412485,2021-11-09 13:56:07 UTC
779128,mainnet,245,105840000,106028994,188995,178102,10893,0.05763644540860869,2021-11-09 13:57:25 UTC
779130,mainnet,245,105840000,106029180,189181,178277,10904,0.05763792347011592,2021-11-09 13:58:50 UTC
779131,mainnet,245,105840000,106029360,189361,178448,10913,0.05763066312493069,2021-11-09 14:00:19 UTC
779133,mainnet,245,105840000,106029510,189511,178592,10919,0.057616708264955595,2021-11-09 14:01:46 UTC
779134,mainnet,245,105840000,106029707,189708,178772,10936,0.05764648828726253,2021-11-09 14:03:32 UTC
779136,mainnet,245,105840000,106029911,189912,178976,10936,0.05758456548296053,2021-11-09 14:05:05 UTC
779137,mainnet,245,105840000,106030069,190070,179131,10939,0.05755248066501815,2021-11-09 14:06:38 UTC
779139,mainnet,245,105840000,106030249,190250,179304,10946,0.05753482260183968,2021-11-09 14:08:12 UTC
779140,mainnet,245,105840000,106030421,190422,179460,10962,0.057566877776727476,2021-11-09 14:09:36 UTC
779142,mainnet,245,105840000,106030581,190582,179619,10963,0.057523795531582204,2021-11-09 14:11:01 UTC
779143,mainnet,245,105840000,106030738,190739,179769,10970,0.05751314623648022,2021-11-09 14:12:33 UTC
779145,mainnet,245,105840000,106030921,190922,179948,10974,0.057478970469615864,2021-11-09 14:14:02 UTC
779146,mainnet,245,105840000,106031081,191082,180088,10994,0.05753550831580159,2021-11-09 14:15:36 UTC
779148,mainnet,245,105840000,106031268,191269,180269,11000,0.05751062639528622,2021-11-09 14:17:01 UTC
779149,mainnet,245,105840000,106031413,191414,180401,11013,0.057534976542990585,2021-11-09 14:18:22 UTC
779151,mainnet,245,105840000,106031587,191588,180569,11019,0.05751404054533687,2021-11-09 14:19:49 UTC
779152,mainnet,245,105840000,106031746,191747,180721,11026,0.05750285532498553,2021-11-09 14:21:13 UTC
779154,mainnet,245,105840000,106031922,191923,180886,11037,0.057507437878732616,2021-11-09 14:22:40 UTC
779155,mainnet,245,105840000,106032091,192092,181045,11047,0.057508901984465774,2021-11-09 14:24:15 UTC
779157,mainnet,245,105840000,106032270,192271,181220,11051,0.057476166452559145,2021-11-09 14:25:43 UTC
779158,mainnet,245,105840000,106032458,192459,181394,11065,0.05749276469273975,2021-11-09 14:27:17 UTC
779160,mainnet,245,105840000,106032635,192636,181554,11082,0.05752818787765527,2021-11-09 14:28:43 UTC
779161,mainnet,245,105840000,106032801,192802,181715,11087,0.05750459020134646,2021-11-09 14:30:10 UTC
779163,mainnet,245,105840000,106032993,192994,181896,11098,0.05750437837445724,2021-11-09 14:31:48 UTC
779164,mainnet,245,105840000,106033184,193185,182074,11111,0.05751481740300748,2021-11-09 14:33:23 UTC
779166,mainnet,245,105840000,106033394,193395,182284,11111,0.0574523643320665,2021-11-09 14:35:00 UTC
779167,mainnet,245,105840000,106033552,193553,182437,11116,0.05743129788740035,2021-11-09 14:36:21 UTC
779169,mainnet,245,105840000,106033714,193715,182594,11121,0.05740908034999871,2021-11-09 14:37:47 UTC
779170,mainnet,245,105840000,106033886,193887,182764,11123,0.057368467199966994,2021-11-09 14:39:10 UTC
779172,mainnet,245,105840000,106034025,194026,182893,11133,0.057378907981404555,2021-11-09 14:40:35 UTC
779173,mainnet,245,105840000,106034199,194200,183054,11146,0.05739443872296601,2021-11-09 14:41:59 UTC
779175,mainnet,245,105840000,106034365,194366,183212,11154,0.05738657995739996,2021-11-09 14:43:26 UTC
779176,mainnet,245,105840000,106034532,194533,183372,11161,0.05737329913176685,2021-11-09 14:44:53 UTC
779178,mainnet,245,105840000,106034686,194687,183516,11171,0.057379280588842604,2021-11-09 14:46:19 UTC
779179,mainnet,245,105840000,106034839,194840,183659,11181,0.05738554711558202,2021-11-09 14:47:39 UTC
779181,mainnet,245,105840000,106035008,195009,183819,11190,0.0573819669861391,2021-11-09 14:49:05 UTC
779182,mainnet,245,105840000,106035157,195158,183962,11196,0.057368901095522604,2021-11-09 14:50:28 UTC
779184,mainnet,245,105840000,106035324,195325,184121,11204,0.05736080890822987,2021-11-09 14:51:56 UTC
779185,mainnet,245,105840000,106035501,195502,184293,11209,0.057334451821464745,2021-11-09 14:53:33 UTC
779187,mainnet,245,105840000,106035720,195721,184498,11223,0.05734182841902504,2021-11-09 14:55:23 UTC
779188,mainnet,245,105840000,106035889,195890,184658,11232,0.0573383021083261,2021-11-09 14:56:55 UTC
779190,mainnet,245,105840000,106036032,196033,184794,11239,0.057332183867001986,2021-11-09 14:58:19 UTC
779191,mainnet,245,105840000,106036229,196230,184963,11267,0.05741731641441166,2021-11-09 15:00:04 UTC
779193,mainnet,245,105840000,106036377,196378,185095,11283,0.057455519457373025,2021-11-09 15:01:39 UTC
779194,mainnet,245,105840000,106036504,196505,185196,11309,0.05755069845551004,2021-11-09 15:03:00 UTC
779196,mainnet,245,105840000,106036661,196662,185330,11332,0.05762170627777608,2021-11-09 15:04:37 UTC
779197,mainnet,245,105840000,106036829,196830,185462,11368,0.05775542346187065,2021-11-09 15:06:11 UTC
779199,mainnet,245,105840000,106036963,196964,185593,11371,0.057731362076318515,2021-11-09 15:07:39 UTC
779200,mainnet,245,105840000,106037102,197103,185713,11390,0.0577870453519226,2021-11-09 15:09:03 UTC
779202,mainnet,245,105840000,106037280,197281,185866,11415,0.05786162884413603,2021-11-09 15:10:35 UTC
779203,mainnet,245,105840000,106037427,197428,185998,11430,0.05789452357315072,2021-11-09 15:12:02 UTC
779205,mainnet,245,105840000,106037578,197579,186135,11444,0.05792113534333102,2021-11-09 15:13:37 UTC
779206,mainnet,245,105840000,106037726,197727,186272,11455,0.057933413241489526,2021-11-09 15:14:59 UTC
779208,mainnet,245,105840000,106037858,197859,186384,11475,0.05799584552635968,2021-11-09 15:16:26 UTC
779209,mainnet,245,105840000,106038000,198001,186514,11487,0.0580148585108156,2021-11-09 15:17:58 UTC
779211,mainnet,245,105840000,106038123,198124,186624,11500,0.05804445700672306,2021-11-09 15:19:24 UTC
779212,mainnet,245,105840000,106038279,198280,186761,11519,0.058094613677627596,2021-11-09 15:20:51 UTC
779214,mainnet,245,105840000,106038447,198448,186912,11536,0.058131097315165685,2021-11-09 15:22:16 UTC
779215,mainnet,245,105840000,106038608,198609,187052,11557,0.058189709429079244,2021-11-09 15:23:37 UTC
779217,mainnet,245,105840000,106038757,198758,187175,11583,0.05827689954618179,2021-11-09 15:25:16 UTC
779218,mainnet,245,105840000,106038928,198929,187332,11597,0.05829718140643144,2021-11-09 15:26:39 UTC
779220,mainnet,245,105840000,106039110,199111,187500,11611,0.058314206648552816,2021-11-09 15:28:15 UTC
779221,mainnet,245,105840000,106039274,199275,187649,11626,0.058341487893614354,2021-11-09 15:29:48 UTC
779223,mainnet,245,105840000,106039457,199458,187825,11633,0.05832305548035175,2021-11-09 15:31:12 UTC
779224,mainnet,245,105840000,106039613,199614,187966,11648,0.058352620557676316,2021-11-09 15:32:37 UTC
779226,mainnet,245,105840000,106039788,199789,188131,11658,0.05835156089674607,2021-11-09 15:34:11 UTC
779227,mainnet,245,105840000,106039958,199959,188291,11668,0.058351962152241206,2021-11-09 15:35:43 UTC
779229,mainnet,245,105840000,106040149,200150,188468,11682,0.05836622533100175,2021-11-09 15:37:21 UTC
779230,mainnet,245,105840000,106040313,200314,188615,11699,0.058403306808310955,2021-11-09 15:38:46 UTC
779232,mainnet,245,105840000,106040484,200485,188777,11708,0.05839838391899643,2021-11-09 15:40:11 UTC
779233,mainnet,245,105840000,106040639,200640,188910,11730,0.058462918660287085,2021-11-09 15:41:37 UTC
779235,mainnet,245,105840000,106040824,200825,189075,11750,0.05850865181127848,2021-11-09 15:43:12 UTC
779236,mainnet,245,105840000,106040960,200961,189207,11754,0.05848896054458328,2021-11-09 15:44:37 UTC
779238,mainnet,245,105840000,106041123,201124,189356,11768,0.05851116724011058,2021-11-09 15:46:02 UTC
779239,mainnet,245,105840000,106041296,201297,189519,11778,0.05851055902472466,2021-11-09 15:47:37 UTC
779241,mainnet,245,105840000,106041457,201458,189669,11789,0.058518400857747024,2021-11-09 15:49:07 UTC
779242,mainnet,245,105840000,106041629,201630,189826,11804,0.05854287556415216,2021-11-09 15:50:38 UTC
779244,mainnet,245,105840000,106041803,201804,189985,11819,0.05856672811242592,2021-11-09 15:52:16 UTC
779245,mainnet,245,105840000,106041946,201947,190119,11828,0.05856982277528262,2021-11-09 15:53:40 UTC
779247,mainnet,245,105840000,106042135,202136,190293,11843,0.05858926663236633,2021-11-09 15:55:05 UTC
779248,mainnet,245,105840000,106042298,202299,190450,11849,0.058571718100435495,2021-11-09 15:56:40 UTC
779250,mainnet,245,105840000,106042457,202458,190590,11868,0.05861956553951931,2021-11-09 15:58:11 UTC
779251,mainnet,245,105840000,106042608,202609,190737,11872,0.058595620135334564,2021-11-09 15:59:32 UTC
779253,mainnet,245,105840000,106042774,202775,190886,11889,0.05863148810257675,2021-11-09 16:01:11 UTC
779254,mainnet,245,105840000,106042910,202911,190995,11916,0.0587252539290625,2021-11-09 16:02:33 UTC
779256,mainnet,245,105840000,106043064,203065,191134,11931,0.058754585970009605,2021-11-09 16:03:58 UTC
779257,mainnet,245,105840000,106043220,203221,191280,11941,0.05875869127698417,2021-11-09 16:05:24 UTC
779259,mainnet,245,105840000,106043387,203388,191432,11956,0.05878419572442819,2021-11-09 16:06:50 UTC
779260,mainnet,245,105840000,106043512,203513,191543,11970,0.05881688147685897,2021-11-09 16:08:13 UTC
779262,mainnet,245,105840000,106043667,203668,191686,11982,0.05883103874933716,2021-11-09 16:09:38 UTC
779263,mainnet,245,105840000,106043859,203860,191867,11993,0.05882958893358187,2021-11-09 16:11:24 UTC
779265,mainnet,245,105840000,106044012,204013,192007,12006,0.05884919098292756,2021-11-09 16:12:51 UTC
779266,mainnet,245,105840000,106044174,204175,192162,12013,0.05883678217215624,2021-11-09 16:14:23 UTC
779268,mainnet,245,105840000,106044314,204315,192284,12031,0.05888456549935149,2021-11-09 16:15:50 UTC
779269,mainnet,245,105840000,106044458,204459,192421,12038,0.05887732992922787,2021-11-09 16:17:16 UTC
779271,mainnet,245,105840000,106044636,204637,192572,12065,0.058958057438293174,2021-11-09 16:18:50 UTC
779272,mainnet,245,105840000,106044773,204774,192703,12071,0.05894791330930685,2021-11-09 16:20:17 UTC
779273,mainnet,245,105840000,106044925,204926,192842,12084,0.058967627338649076,2021-11-09 16:21:48 UTC
779275,mainnet,245,105840000,106045095,205096,192995,12101,0.05900163825720638,2021-11-09 16:23:11 UTC
779276,mainnet,245,105840000,106045253,205254,193143,12111,0.059004940220409835,2021-11-09 16:24:39 UTC
779278,mainnet,245,105840000,106045419,205420,193300,12120,0.059001070976535876,2021-11-09 16:26:04 UTC
779279,mainnet,245,105840000,106045572,205573,193444,12129,0.059000938839244454,2021-11-09 16:27:42 UTC
779281,mainnet,245,105840000,106045735,205736,193589,12147,0.05904168448885951,2021-11-09 16:29:18 UTC
779282,mainnet,245,105840000,106045926,205927,193765,12162,0.059059763896914926,2021-11-09 16:30:55 UTC
779284,mainnet,245,105840000,106046094,206095,193911,12184,0.05911836774303113,2021-11-09 16:32:27 UTC
779285,mainnet,245,105840000,106046247,206248,194042,12206,0.05918117993871456,2021-11-09 16:33:54 UTC
779287,mainnet,245,105840000,106046404,206405,194196,12209,0.05915069886872896,2021-11-09 16:35:17 UTC
779288,mainnet,245,105840000,106046570,206571,194349,12222,0.0591660978549748,2021-11-09 16:36:56 UTC
779290,mainnet,245,105840000,106046746,206747,194512,12235,0.05917860960497613,2021-11-09 16:38:22 UTC
779291,mainnet,245,105840000,106046915,206916,194664,12252,0.059212434031201064,2021-11-09 16:39:51 UTC
779293,mainnet,245,105840000,106047100,207101,194842,12259,0.05919334044741455,2021-11-09 16:41:26 UTC
779294,mainnet,245,105840000,106047263,207264,194998,12266,0.05918056198857496,2021-11-09 16:43:06 UTC
779296,mainnet,245,105840000,106047439,207440,195145,12295,0.05927015040493637,2021-11-09 16:44:32 UTC
779297,mainnet,245,105840000,106047597,207598,195302,12296,0.05922985770575825,2021-11-09 16:46:13 UTC
779299,mainnet,245,105840000,106047798,207799,195479,12320,0.05928806202147267,2021-11-09 16:47:45 UTC
779300,mainnet,245,105840000,106047964,207965,195644,12321,0.05924554612554997,2021-11-09 16:49:26 UTC
779302,mainnet,245,105840000,106048130,208131,195798,12333,0.05925594937803595,2021-11-09 16:50:52 UTC
779303,mainnet,245,105840000,106048300,208301,195949,12352,0.059298803174252644,2021-11-09 16:52:18 UTC
779304,mainnet,245,105840000,106048471,208472,196116,12356,0.059269350320426725,2021-11-09 16:53:55 UTC
779306,mainnet,245,105840000,106048630,208631,196265,12366,0.059272112006365306,2021-11-09 16:55:23 UTC
779307,mainnet,245,105840000,106048800,208801,196427,12374,0.05926216828463465,2021-11-09 16:56:48 UTC
779309,mainnet,245,105840000,106048973,208974,196588,12386,0.05927053126226229,2021-11-09 16:58:30 UTC
779310,mainnet,245,105840000,106049156,209157,196759,12398,0.059276046223650174,2021-11-09 16:59:55 UTC
779312,mainnet,245,105840000,106049320,209321,196916,12405,0.05926304575269562,2021-11-09 17:01:30 UTC
779313,mainnet,245,105840000,106049502,209503,197088,12415,0.05925929461630621,2021-11-09 17:03:12 UTC
779315,mainnet,245,105840000,106049660,209661,197222,12439,0.059329107463953715,2021-11-09 17:04:41 UTC
779316,mainnet,245,105840000,106049852,209853,197401,12452,0.05933677383692394,2021-11-09 17:06:18 UTC
779318,mainnet,245,105840000,106050031,210032,197571,12461,0.059329054620248345,2021-11-09 17:07:51 UTC
779319,mainnet,245,105840000,106050183,210184,197717,12467,0.0593146956952004,2021-11-09 17:09:20 UTC
779321,mainnet,245,105840000,106050346,210347,197871,12476,0.05931151858595559,2021-11-09 17:10:47 UTC
779322,mainnet,245,105840000,106050526,210527,198032,12495,0.059351057109064395,2021-11-09 17:12:26 UTC
779324,mainnet,245,105840000,106050686,210687,198170,12517,0.059410405008377354,2021-11-09 17:13:56 UTC
779325,mainnet,245,105840000,106050832,210833,198306,12527,0.05941669472995214,2021-11-09 17:15:21 UTC
779326,mainnet,245,105840000,106051006,211007,198468,12539,0.05942456885316601,2021-11-09 17:16:47 UTC
779328,mainnet,245,105840000,106051173,211174,198628,12546,0.05941072291096442,2021-11-09 17:18:22 UTC
779330,mainnet,245,105840000,106051347,211348,198791,12557,0.059413857713344814,2021-11-09 17:20:00 UTC
779331,mainnet,245,105840000,106051505,211506,198946,12560,0.0593836581468138,2021-11-09 17:21:30 UTC
779333,mainnet,245,105840000,106051671,211672,199108,12564,0.05935598473109339,2021-11-09 17:23:06 UTC
779334,mainnet,245,105840000,106051838,211839,199273,12566,0.05931863349052818,2021-11-09 17:24:35 UTC
779336,mainnet,245,105840000,106051994,211995,199421,12574,0.05931271963961414,2021-11-09 17:26:04 UTC
779337,mainnet,245,105840000,106052194,212195,199592,12603,0.05939348241004736,2021-11-09 17:27:42 UTC
779339,mainnet,245,105840000,106052365,212366,199763,12603,0.05934565796784796,2021-11-09 17:29:08 UTC
779340,mainnet,245,105840000,106052542,212543,199932,12611,0.05933387596862753,2021-11-09 17:30:48 UTC
779342,mainnet,245,105840000,106052808,212809,200178,12631,0.05935369274795709,2021-11-09 17:33:07 UTC
779343,mainnet,245,105840000,106052982,212983,200346,12637,0.05933337402515694,2021-11-09 17:34:42 UTC
779345,mainnet,245,105840000,106053141,213142,200502,12640,0.05930318754633061,2021-11-09 17:36:09 UTC
779346,mainnet,245,105840000,106053322,213323,200675,12648,0.05929037187738781,2021-11-09 17:37:37 UTC
779348,mainnet,245,105840000,106053488,213489,200828,12661,0.05930516326368103,2021-11-09 17:39:04 UTC
779349,mainnet,245,105840000,106053647,213648,200982,12666,0.05928443046506403,2021-11-09 17:40:34 UTC
779351,mainnet,245,105840000,106053816,213817,201131,12686,0.05933111024848352,2021-11-09 17:42:10 UTC
779352,mainnet,245,105840000,106053991,213992,201295,12697,0.05933399379416053,2021-11-09 17:43:37 UTC
779354,mainnet,245,105840000,106054149,214150,201443,12707,0.059336913378473036,2021-11-09 17:45:07 UTC
779355,mainnet,245,105840000,106054322,214323,201603,12720,0.0593496731568707,2021-11-09 17:46:37 UTC
779357,mainnet,245,105840000,106054517,214518,201784,12734,0.059360986024482795,2021-11-09 17:48:16 UTC
779358,mainnet,245,105840000,106054692,214693,201949,12744,0.059359177989035505,2021-11-09 17:49:45 UTC
779360,mainnet,245,105840000,106054860,214861,202108,12753,0.059354652542806745,2021-11-09 17:51:14 UTC
779361,mainnet,245,105840000,106055044,215045,202287,12758,0.05932711758004139,2021-11-09 17:52:48 UTC
779363,mainnet,245,105840000,106055233,215234,202455,12779,0.059372589832461416,2021-11-09 17:54:20 UTC
779364,mainnet,245,105840000,106055386,215387,202605,12782,0.059344342973345655,2021-11-09 17:55:53 UTC
779366,mainnet,245,105840000,106055561,215562,202771,12791,0.059337916701459444,2021-11-09 17:57:24 UTC
779367,mainnet,245,105840000,106055736,215737,202929,12808,0.05936858304324247,2021-11-09 17:59:06 UTC
779369,mainnet,245,105840000,106055932,215933,203119,12814,0.059342481232604556,2021-11-09 18:00:44 UTC
779370,mainnet,245,105840000,106056075,216076,203249,12827,0.05936337214683722,2021-11-09 18:02:13 UTC
779371,mainnet,245,105840000,106056272,216273,203438,12835,0.05934628918080389,2021-11-09 18:03:47 UTC
779373,mainnet,245,105840000,106056441,216442,203607,12835,0.059299951026140954,2021-11-09 18:05:17 UTC
779374,mainnet,245,105840000,106056606,216607,203767,12840,0.05927786267295147,2021-11-09 18:06:47 UTC
779376,mainnet,245,105840000,106056760,216761,203911,12850,0.05928188188834707,2021-11-09 18:08:19 UTC
779377,mainnet,245,105840000,106056948,216949,204093,12856,0.059258166665898435,2021-11-09 18:10:00 UTC
779379,mainnet,245,105840000,106057142,217143,204263,12880,0.05931575045016418,2021-11-09 18:11:44 UTC
779380,mainnet,245,105840000,106057294,217295,204398,12897,0.05935249315446743,2021-11-09 18:13:13 UTC
779382,mainnet,245,105840000,106057466,217467,204555,12912,0.059374525790119884,2021-11-09 18:14:53 UTC
779383,mainnet,245,105840000,106057622,217623,204691,12932,0.059423866043570764,2021-11-09 18:16:24 UTC
779385,mainnet,245,105840000,106057812,217813,204840,12973,0.05956026499795696,2021-11-09 18:18:09 UTC
779386,mainnet,245,105840000,106057938,217939,204948,12991,0.05960842254025209,2021-11-09 18:19:21 UTC
779388,mainnet,245,105840000,106058047,218048,205036,13012,0.059674933959495156,2021-11-09 18:20:54 UTC
779389,mainnet,245,105840000,106058233,218234,205191,13043,0.05976612260234427,2021-11-09 18:22:31 UTC
779391,mainnet,245,105840000,106058432,218433,205375,13058,0.059780344545009224,2021-11-09 18:24:11 UTC
779392,mainnet,245,105840000,106058597,218598,205531,13067,0.059776393196644066,2021-11-09 18:25:40 UTC
779394,mainnet,245,105840000,106058762,218763,205687,13076,0.05977244780881593,2021-11-09 18:27:13 UTC
779395,mainnet,245,105840000,106058927,218928,205842,13086,0.05977307607980706,2021-11-09 18:28:39 UTC
779397,mainnet,245,105840000,106059124,219125,206020,13105,0.059806046776953795,2021-11-09 18:30:31 UTC
779398,mainnet,245,105840000,106059298,219299,206181,13118,0.05981787422651266,2021-11-09 18:32:08 UTC
779400,mainnet,245,105840000,106059500,219501,206364,13137,0.05984938565200158,2021-11-09 18:33:41 UTC
779401,mainnet,245,105840000,106059658,219659,206511,13148,0.05985641380503417,2021-11-09 18:35:07 UTC
779403,mainnet,245,105840000,106059816,219817,206665,13152,0.059831587183884774,2021-11-09 18:36:33 UTC
779404,mainnet,245,105840000,106059978,219979,206809,13170,0.05986935116533851,2021-11-09 18:38:01 UTC
779406,mainnet,245,105840000,106060166,220167,206981,13186,0.05989090099787888,2021-11-09 18:40:00 UTC
779407,mainnet,245,105840000,106060374,220375,207169,13206,0.059925127623369254,2021-11-09 18:41:31 UTC
779409,mainnet,245,105840000,106060519,220520,207294,13226,0.05997641937239253,2021-11-09 18:42:57 UTC
779410,mainnet,245,105840000,106060694,220695,207447,13248,0.060028546183647113,2021-11-09 18:44:22 UTC
779412,mainnet,245,105840000,106060900,220901,207651,13250,0.05998162072602659,2021-11-09 18:46:10 UTC
779413,mainnet,245,105840000,106061102,221103,207844,13259,0.05996752644695007,2021-11-09 18:47:55 UTC
779415,mainnet,245,105840000,106061268,221269,207993,13276,0.05999936728597318,2021-11-09 18:49:32 UTC
779416,mainnet,245,105840000,106061460,221461,208167,13294,0.060028628065438155,2021-11-09 18:51:10 UTC
779418,mainnet,245,105840000,106061625,221626,208318,13308,0.060047106386434804,2021-11-09 18:52:34 UTC
779419,mainnet,245,105840000,106061825,221826,208501,13325,0.060069604104117644,2021-11-09 18:54:13 UTC
779421,mainnet,245,105840000,106062010,222011,208678,13333,0.060055582831481324,2021-11-09 18:55:42 UTC
779422,mainnet,245,105840000,106062211,222212,208873,13339,0.0600282613000198,2021-11-09 18:57:29 UTC
779423,mainnet,245,105840000,106062364,222365,209020,13345,0.06001394104287995,2021-11-09 18:58:57 UTC
779425,mainnet,245,105840000,106062531,222532,209182,13350,0.05999137202739381,2021-11-09 19:00:30 UTC
779427,mainnet,245,105840000,106062708,222709,209345,13364,0.06000655563987086,2021-11-09 19:02:20 UTC
779428,mainnet,245,105840000,106062918,222919,209540,13379,0.06001731570660195,2021-11-09 19:03:59 UTC
779430,mainnet,245,105840000,106063079,223080,209686,13394,0.06004124081047158,2021-11-09 19:05:27 UTC
779431,mainnet,245,105840000,106063244,223245,209844,13401,0.06002822011691191,2021-11-09 19:07:04 UTC
779433,mainnet,245,105840000,106063412,223413,210006,13407,0.0600099367539042,2021-11-09 19:08:32 UTC
779434,mainnet,245,105840000,106063596,223597,210170,13427,0.060050000670849785,2021-11-09 19:10:09 UTC
779436,mainnet,245,105840000,106063762,223763,210319,13444,0.0600814254367344,2021-11-09 19:11:44 UTC
779437,mainnet,245,105840000,106063933,223934,210470,13464,0.06012485821715327,2021-11-09 19:13:12 UTC
779439,mainnet,245,105840000,106064084,224085,210612,13473,0.060124506325724615,2021-11-09 19:14:40 UTC
779440,mainnet,245,105840000,106064284,224285,210794,13491,0.06015114697817509,2021-11-09 19:16:28 UTC
779442,mainnet,245,105840000,106064456,224457,210950,13507,0.060176336670275374,2021-11-09 19:17:57 UTC
779443,mainnet,245,105840000,106064619,224620,211108,13512,0.060154928323390616,2021-11-09 19:19:35 UTC
779445,mainnet,245,105840000,106064800,224801,211276,13525,0.06016432311244167,2021-11-09 19:21:15 UTC
779446,mainnet,245,105840000,106064977,224978,211437,13541,0.060188107281600865,2021-11-09 19:22:40 UTC
779448,mainnet,245,105840000,106065163,225164,211614,13550,0.06017835888507932,2021-11-09 19:24:18 UTC
779449,mainnet,245,105840000,106065345,225346,211783,13563,0.06018744508444791,2021-11-09 19:25:56 UTC
779451,mainnet,245,105840000,106065516,225517,211943,13574,0.06019058430184864,2021-11-09 19:27:25 UTC
779452,mainnet,245,105840000,106065686,225687,212109,13578,0.060162969067779716,2021-11-09 19:28:51 UTC
779454,mainnet,245,105840000,106065867,225868,212268,13600,0.06021215931428976,2021-11-09 19:30:31 UTC
779455,mainnet,245,105840000,106066069,226070,212459,13611,0.06020701552616446,2021-11-09 19:32:09 UTC
779457,mainnet,245,105840000,106066232,226233,212613,13620,0.06020341859940857,2021-11-09 19:33:39 UTC
779458,mainnet,245,105840000,106066430,226431,212797,13634,0.060212603397944625,2021-11-09 19:35:16 UTC
779460,mainnet,245,105840000,106066625,226626,212969,13657,0.06026228235065703,2021-11-09 19:36:51 UTC
779461,mainnet,245,105840000,106066789,226790,213127,13663,0.0602451607213722,2021-11-09 19:38:23 UTC
779463,mainnet,245,105840000,106066996,226997,213320,13677,0.06025189760217095,2021-11-09 19:40:01 UTC
779464,mainnet,245,105840000,106067180,227181,213487,13694,0.060277928171810144,2021-11-09 19:41:36 UTC
779466,mainnet,245,105840000,106067365,227366,213655,13711,0.06030365138147304,2021-11-09 19:43:09 UTC
779467,mainnet,245,105840000,106067538,227539,213826,13713,0.06026659166120973,2021-11-09 19:44:45 UTC
779469,mainnet,245,105840000,106067720,227721,214006,13715,0.06022720785522635,2021-11-09 19:46:17 UTC
779470,mainnet,245,105840000,106067899,227900,214172,13728,0.06023694602896007,2021-11-09 19:47:52 UTC
779472,mainnet,245,105840000,106068088,228089,214348,13741,0.06024402755064909,2021-11-09 19:49:26 UTC
779473,mainnet,245,105840000,106068268,228269,214518,13751,0.06024033048727598,2021-11-09 19:51:09 UTC
779475,mainnet,245,105840000,106068478,228479,214707,13772,0.060276874461110214,2021-11-09 19:52:55 UTC
779476,mainnet,245,105840000,106068687,228688,214901,13787,0.06028737843699713,2021-11-09 19:54:36 UTC
779478,mainnet,245,105840000,106068861,228862,215065,13797,0.060285237391965465,2021-11-09 19:56:05 UTC
779479,mainnet,245,105840000,106069071,229072,215269,13803,0.060256164000838164,2021-11-09 19:57:49 UTC
779481,mainnet,245,105840000,106069366,229367,215540,13827,0.06028330143394647,2021-11-09 20:00:06 UTC
779482,mainnet,245,105840000,106069540,229541,215703,13838,0.06028552633298626,2021-11-09 20:01:43 UTC
779484,mainnet,245,105840000,106069815,229816,215952,13864,0.060326522087235004,2021-11-09 20:04:03 UTC
779485,mainnet,245,105840000,106070019,230020,216141,13879,0.06033823145813408,2021-11-09 20:05:44 UTC
779487,mainnet,245,105840000,106070190,230191,216306,13885,0.060319473828255664,2021-11-09 20:07:18 UTC
779488,mainnet,245,105840000,106070379,230380,216485,13895,0.06031339526000521,2021-11-09 20:08:51 UTC
779490,mainnet,245,105840000,106070567,230568,216656,13912,0.06033794802401027,2021-11-09 20:10:25 UTC
779491,mainnet,245,105840000,106070775,230776,216862,13914,0.06029223142787812,2021-11-09 20:12:10 UTC
779493,mainnet,245,105840000,106070970,230971,217043,13928,0.06030194266812717,2021-11-09 20:13:53 UTC
779494,mainnet,245,105840000,106071155,231156,217223,13933,0.060275311910571214,2021-11-09 20:15:24 UTC
779496,mainnet,245,105840000,106071328,231329,217392,13937,0.06024752625049173,2021-11-09 20:16:59 UTC
779497,mainnet,245,105840000,106071521,231522,217554,13968,0.06033119962681732,2021-11-09 20:18:33 UTC
779499,mainnet,245,105840000,106071703,231704,217726,13978,0.06032696889134413,2021-11-09 20:20:10 UTC
779500,mainnet,245,105840000,106071882,231883,217899,13984,0.06030627514738036,2021-11-09 20:21:46 UTC
779502,mainnet,245,105840000,106072064,232065,218072,13993,0.06029776140305518,2021-11-09 20:23:16 UTC
779503,mainnet,245,105840000,106072245,232246,218238,14008,0.060315355269843184,2021-11-09 20:24:52 UTC
779504,mainnet,245,105840000,106072416,232417,218401,14016,0.06030539934686361,2021-11-09 20:26:27 UTC
779506,mainnet,245,105840000,106072612,232613,218572,14041,0.06036206058990684,2021-11-09 20:28:01 UTC
779507,mainnet,245,105840000,106072822,232823,218770,14053,0.06035915695614265,2021-11-09 20:29:47 UTC
779509,mainnet,245,105840000,106072992,232993,218930,14063,0.06035803650753456,2021-11-09 20:31:21 UTC
779511,mainnet,245,105840000,106073268,233269,219178,14091,0.060406654977729575,2021-11-09 20:33:45 UTC
779512,mainnet,245,105840000,106073440,233441,219328,14113,0.06045638940888704,2021-11-09 20:35:17 UTC
779514,mainnet,245,105840000,106073627,233628,219510,14118,0.06042940058554625,2021-11-09 20:36:58 UTC
779515,mainnet,245,105840000,106073805,233806,219680,14126,0.06041761118192005,2021-11-09 20:38:35 UTC
779517,mainnet,245,105840000,106073990,233991,219852,14139,0.060425400976960655,2021-11-09 20:40:06 UTC
779518,mainnet,245,105840000,106074216,234217,220070,14147,0.06040125183056738,2021-11-09 20:41:39 UTC
779519,mainnet,245,105840000,106074351,234352,220196,14156,0.06040486106369905,2021-11-09 20:43:07 UTC
779521,mainnet,245,105840000,106074503,234504,220333,14171,0.060429672841401424,2021-11-09 20:44:46 UTC
779522,mainnet,245,105840000,106074675,234676,220495,14181,0.06042799434113416,2021-11-09 20:46:16 UTC
779524,mainnet,245,105840000,106074853,234854,220664,14190,0.060420516576255884,2021-11-09 20:47:47 UTC
779525,mainnet,245,105840000,106075014,235015,220808,14207,0.06045146054507159,2021-11-09 20:49:17 UTC
779527,mainnet,245,105840000,106075205,235206,220989,14217,0.060444886610035456,2021-11-09 20:50:58 UTC
779528,mainnet,245,105840000,106075367,235368,221140,14228,0.060450018694130046,2021-11-09 20:52:25 UTC
779530,mainnet,245,105840000,106075522,235523,221290,14233,0.060431465292137075,2021-11-09 20:53:52 UTC
779531,mainnet,245,105840000,106075726,235727,221480,14247,0.060438558162620316,2021-11-09 20:55:34 UTC
779533,mainnet,245,105840000,106075898,235899,221644,14255,0.06042840368123646,2021-11-09 20:57:03 UTC
779534,mainnet,245,105840000,106076080,236081,221817,14264,0.06041994061360296,2021-11-09 20:58:33 UTC
779536,mainnet,245,105840000,106076253,236254,221980,14274,0.060418024668365405,2021-11-09 20:59:58 UTC
779537,mainnet,245,105840000,106076458,236459,222170,14289,0.06042908072858297,2021-11-09 21:01:42 UTC
779539,mainnet,245,105840000,106076622,236623,222332,14291,0.06039565046508581,2021-11-09 21:03:07 UTC
779540,mainnet,245,105840000,106076820,236821,222523,14298,0.060374713391126635,2021-11-09 21:04:48 UTC
779542,mainnet,245,105840000,106076978,236979,222675,14304,0.06035977871456964,2021-11-09 21:06:16 UTC
779543,mainnet,245,105840000,106077169,237170,222846,14324,0.06039549690095712,2021-11-09 21:07:43 UTC
779545,mainnet,245,105840000,106077412,237413,223081,14332,0.06036737668114214,2021-11-09 21:10:14 UTC
779547,mainnet,245,105840000,106077669,237670,223319,14351,0.060382042327597085,2021-11-09 21:12:01 UTC
779548,mainnet,245,105840000,106077855,237856,223484,14372,0.06042311314408718,2021-11-09 21:13:49 UTC
779550,mainnet,245,105840000,106078017,238018,223639,14379,0.06041139745733516,2021-11-09 21:15:18 UTC
779551,mainnet,245,105840000,106078173,238174,223772,14402,0.060468397054254455,2021-11-09 21:16:45 UTC
779553,mainnet,245,105840000,106078396,238397,223981,14416,0.060470559612746805,2021-11-09 21:18:53 UTC
779555,mainnet,245,105840000,106078714,238715,224281,14434,0.060465408541566304,2021-11-09 21:21:24 UTC
779556,mainnet,245,105840000,106078923,238924,224479,14445,0.060458555858766805,2021-11-09 21:23:20 UTC
779558,mainnet,245,105840000,106079156,239157,224703,14454,0.060437285966958944,2021-11-09 21:25:05 UTC
779559,mainnet,245,105840000,106079352,239353,224888,14465,0.06043375265820775,2021-11-09 21:26:46 UTC
779561,mainnet,245,105840000,106079549,239550,225079,14471,0.06040910039657692,2021-11-09 21:28:27 UTC
779563,mainnet,245,105840000,106079749,239750,225252,14498,0.06047132429614181,2021-11-09 21:30:17 UTC
779564,mainnet,245,105840000,106079917,239918,225400,14518,0.060512341716753223,2021-11-09 21:31:52 UTC
779566,mainnet,245,105840000,106080102,240103,225560,14543,0.06056983877752464,2021-11-09 21:33:20 UTC
779567,mainnet,245,105840000,106080249,240250,225701,14549,0.06055775234131113,2021-11-09 21:34:47 UTC
779569,mainnet,245,105840000,106080457,240458,225889,14569,0.060588543529431334,2021-11-09 21:36:26 UTC
779570,mainnet,245,105840000,106080636,240637,226063,14574,0.06056425238014104,2021-11-09 21:37:54 UTC
779571,mainnet,245,105840000,106080814,240815,226236,14579,0.060540248738658306,2021-11-09 21:39:25 UTC
779573,mainnet,245,105840000,106080988,240989,226393,14596,0.060567079825220235,2021-11-09 21:40:58 UTC
779574,mainnet,245,105840000,106081168,241169,226564,14605,0.06055919293109811,2021-11-09 21:42:26 UTC
779576,mainnet,245,105840000,106081358,241359,226743,14616,0.06055709544703119,2021-11-09 21:43:59 UTC
779577,mainnet,245,105840000,106081526,241527,226907,14620,0.06053153477665023,2021-11-09 21:45:32 UTC
779579,mainnet,245,105840000,106081716,241717,227089,14628,0.060517050931461175,2021-11-09 21:47:13 UTC
779580,mainnet,245,105840000,106081921,241922,227285,14637,0.060502972032307936,2021-11-09 21:48:54 UTC
779582,mainnet,245,105840000,106082100,242101,227448,14653,0.06052432662401229,2021-11-09 21:50:25 UTC
779583,mainnet,245,105840000,106082284,242285,227627,14658,0.06049899911261531,2021-11-09 21:51:57 UTC
779585,mainnet,245,105840000,106082440,242441,227775,14666,0.0604930684166457,2021-11-09 21:53:26 UTC
779586,mainnet,245,105840000,106082638,242639,227952,14687,0.06053025276233417,2021-11-09 21:54:56 UTC
779588,mainnet,245,105840000,106082797,242798,228104,14694,0.06051944414698639,2021-11-09 21:56:29 UTC
779589,mainnet,245,105840000,106082975,242976,228267,14709,0.060536843145001976,2021-11-09 21:57:58 UTC
779591,mainnet,245,105840000,106083144,243145,228433,14712,0.060507104813999874,2021-11-09 21:59:25 UTC
779592,mainnet,245,105840000,106083329,243330,228597,14733,0.0605474047589693,2021-11-09 22:00:58 UTC
779594,mainnet,245,105840000,106083508,243509,228763,14746,0.06055628334065681,2021-11-09 22:02:26 UTC
779595,mainnet,245,105840000,106083678,243679,228914,14765,0.06059200833883921,2021-11-09 22:04:03 UTC
779597,mainnet,245,105840000,106083864,243865,229077,14788,0.06064010825661739,2021-11-09 22:05:51 UTC
779598,mainnet,245,105840000,106084062,244063,229261,14802,0.060648275240409236,2021-11-09 22:07:22 UTC
779600,mainnet,245,105840000,106084284,244285,229458,14827,0.06069549910964652,2021-11-09 22:09:16 UTC
779601,mainnet,245,105840000,106084470,244471,229634,14837,0.06069022501646412,2021-11-09 22:10:55 UTC
779603,mainnet,245,105840000,106084632,244633,229779,14854,0.060719526801371854,2021-11-09 22:12:22 UTC
779604,mainnet,245,105840000,106084807,244808,229937,14871,0.06074556387046175,2021-11-09 22:14:00 UTC
779606,mainnet,245,105840000,106085020,245021,230137,14884,0.06074581362413834,2021-11-09 22:15:41 UTC
779608,mainnet,245,105840000,106085214,245215,230322,14893,0.060734457516872946,2021-11-09 22:17:18 UTC
779609,mainnet,245,105840000,106085422,245423,230525,14898,0.060703357061074145,2021-11-09 22:19:06 UTC
779611,mainnet,245,105840000,106085604,245605,230697,14908,0.060699090002239366,2021-11-09 22:20:34 UTC
779612,mainnet,245,105840000,106085765,245766,230854,14912,0.06067560199539399,2021-11-09 22:22:03 UTC
779614,mainnet,245,105840000,106085980,245981,231053,14928,0.06068761408401462,2021-11-09 22:23:51 UTC
779615,mainnet,245,105840000,106086182,246183,231248,14935,0.06066625234073839,2021-11-09 22:25:20 UTC
779617,mainnet,245,105840000,106086345,246346,231410,14936,0.06063017057309638,2021-11-09 22:26:47 UTC
779618,mainnet,245,105840000,106086560,246561,231619,14942,0.06060163610627796,2021-11-09 22:28:37 UTC
779620,mainnet,245,105840000,106086757,246758,231803,14955,0.06060593780140867,2021-11-09 22:30:29 UTC
779621,mainnet,245,105840000,106086962,246963,232006,14957,0.06056372816980681,2021-11-09 22:31:56 UTC
779623,mainnet,245,105840000,106087139,247140,232177,14963,0.06054463057376386,2021-11-09 22:33:23 UTC
779624,mainnet,245,105840000,106087365,247366,232379,14987,0.06058633765351746,2021-11-09 22:35:22 UTC
779626,mainnet,245,105840000,106087634,247635,232641,14994,0.060548791568235505,2021-11-09 22:37:40 UTC
779628,mainnet,245,105840000,106087860,247861,232857,15004,0.060533928290453114,2021-11-09 22:39:30 UTC
779629,mainnet,245,105840000,106088036,248037,233024,15013,0.06052726004588025,2021-11-09 22:40:58 UTC
779631,mainnet,245,105840000,106088246,248247,233221,15026,0.06052842531833214,2021-11-09 22:42:47 UTC
779632,mainnet,245,105840000,106088445,248446,233412,15034,0.0605121434838959,2021-11-09 22:44:26 UTC
779634,mainnet,245,105840000,106088631,248632,233576,15056,0.060555358924032306,2021-11-09 22:45:53 UTC
779635,mainnet,245,105840000,106088821,248822,233755,15067,0.06055332727813457,2021-11-09 22:47:34 UTC
779637,mainnet,245,105840000,106088873,248874,233807,15067,0.06054067520110578,2021-11-09 22:49:04 UTC
779638,mainnet,245,105840000,106089171,249172,234075,15097,0.060588669673960156,2021-11-09 22:50:45 UTC
779640,mainnet,245,105840000,106089363,249364,234260,15104,0.060570090309748,2021-11-09 22:52:13 UTC
779641,mainnet,245,105840000,106089539,249540,234425,15115,0.0605714514707061,2021-11-09 22:53:46 UTC
779643,mainnet,245,105840000,106089709,249710,234588,15122,0.060558247567177925,2021-11-09 22:55:19 UTC
779644,mainnet,245,105840000,106089911,249912,234779,15133,0.060553314766797914,2021-11-09 22:57:06 UTC
779646,mainnet,245,105840000,106090088,250089,234947,15142,0.060546445465414316,2021-11-09 22:58:34 UTC
779647,mainnet,245,105840000,106090274,250275,235125,15150,0.060533413245430025,2021-11-09 23:00:03 UTC
779649,mainnet,245,105840000,106090530,250531,235380,15151,0.06047554993194455,2021-11-09 23:02:13 UTC
779651,mainnet,245,105840000,106090714,250715,235556,15159,0.06046307560377321,2021-11-09 23:03:50 UTC
779652,mainnet,245,105840000,106090889,250890,235729,15161,0.06042887321136753,2021-11-09 23:05:15 UTC
779653,mainnet,245,105840000,106091070,251071,235901,15170,0.060421155768686945,2021-11-09 23:06:43 UTC
779655,mainnet,245,105840000,106091206,251207,236026,15181,0.060432233178215576,2021-11-09 23:08:11 UTC
779656,mainnet,245,105840000,106091420,251421,236216,15205,0.06047625297807264,2021-11-09 23:09:43 UTC
779658,mainnet,245,105840000,106091649,251650,236435,15215,0.06046095767931651,2021-11-09 23:11:35 UTC
779659,mainnet,245,105840000,106091838,251839,236614,15225,0.060455290880284625,2021-11-09 23:13:18 UTC
779660,mainnet,245,105840000,106092072,252073,236835,15238,0.060450742443657196,2021-11-09 23:15:02 UTC
779661,mainnet,245,105840000,106092266,252267,237020,15247,0.0604399307083368,2021-11-09 23:16:36 UTC
779662,mainnet,245,105840000,106092441,252442,237191,15251,0.06041387724705081,2021-11-09 23:18:04 UTC
779663,mainnet,245,105840000,106092628,252629,237362,15267,0.06043249191502163,2021-11-09 23:19:31 UTC
779664,mainnet,245,105840000,106092809,252810,237530,15280,0.06044064712630039,2021-11-09 23:21:03 UTC
779666,mainnet,245,105840000,106092988,252989,237709,15280,0.06039788291190526,2021-11-09 23:22:32 UTC
779667,mainnet,245,105840000,106093176,253177,237884,15293,0.06040438112466772,2021-11-09 23:24:00 UTC
779669,mainnet,245,105840000,106093356,253357,238056,15301,0.060393042228949666,2021-11-09 23:25:32 UTC
779671,mainnet,245,105840000,106093560,253561,238252,15309,0.06037600419622891,2021-11-09 23:27:03 UTC
779672,mainnet,245,105840000,106093729,253730,238399,15331,0.060422496354392466,2021-11-09 23:28:33 UTC
779674,mainnet,245,105840000,106093930,253931,238588,15343,0.0604219256412175,2021-11-09 23:30:18 UTC
779675,mainnet,245,105840000,106094164,254165,238810,15355,0.06041351090826825,2021-11-09 23:32:12 UTC
779677,mainnet,245,105840000,106094361,254362,238994,15368,0.0604178297072676,2021-11-09 23:33:44 UTC
779678,mainnet,245,105840000,106094529,254530,239144,15386,0.06044867009782737,2021-11-09 23:35:27 UTC
779680,mainnet,245,105840000,106094665,254666,239274,15392,0.060439948795677476,2021-11-09 23:36:58 UTC
779681,mainnet,245,105840000,106094860,254861,239445,15416,0.060487873782179305,2021-11-09 23:38:27 UTC
779683,mainnet,245,105840000,106095039,255040,239602,15438,0.06053168130489335,2021-11-09 23:39:56 UTC
779685,mainnet,245,105840000,106095226,255227,239783,15444,0.060510839370442784,2021-11-09 23:41:35 UTC
779686,mainnet,245,105840000,106095403,255404,239951,15453,0.060504142456656904,2021-11-09 23:43:01 UTC
779688,mainnet,245,105840000,106095635,255636,240170,15466,0.06050008605986637,2021-11-09 23:45:03 UTC
779689,mainnet,245,105840000,106095824,255825,240350,15475,0.06049056972539822,2021-11-09 23:46:33 UTC
779691,mainnet,245,105840000,106095990,255991,240510,15481,0.06047478231656582,2021-11-09 23:48:00 UTC
779692,mainnet,245,105840000,106096155,256156,240670,15486,0.06045534752260341,2021-11-09 23:49:26 UTC
779694,mainnet,245,105840000,106096358,256359,240868,15491,0.0604269793531727,2021-11-09 23:51:14 UTC
779696,mainnet,245,105840000,106096537,256538,241040,15498,0.060412102690439624,2021-11-09 23:52:46 UTC
779697,mainnet,245,105840000,106096696,256697,241193,15504,0.06039805685302126,2021-11-09 23:54:22 UTC
779699,mainnet,245,105840000,106096919,256920,241411,15509,0.06036509419274482,2021-11-09 23:56:02 UTC
779700,mainnet,245,105840000,106097144,257145,241624,15521,0.06035894145326567,2021-11-09 23:57:47 UTC
779702,mainnet,245,105840000,106097348,257349,241815,15534,0.0603616101092291,2021-11-09 23:59:35 UTC
779704,mainnet,245,105840000,106097542,257543,241994,15549,0.06037438408343461,2021-11-10 00:01:19 UTC
779705,mainnet,245,105840000,106097740,257741,242175,15566,0.0603939613798348,2021-11-10 00:02:48 UTC
779707,mainnet,245,105840000,106097924,257925,242352,15573,0.06037801686536784,2021-11-10 00:04:15 UTC
779708,mainnet,245,105840000,106098132,258133,242552,15581,0.06036035687029555,2021-11-10 00:06:02 UTC
779710,mainnet,245,105840000,106098318,258319,242720,15599,0.06038657628745853,2021-11-10 00:07:40 UTC
779711,mainnet,245,105840000,106098491,258492,242892,15600,0.060350030175015085,2021-11-10 00:09:18 UTC
779713,mainnet,245,105840000,106098736,258737,243118,15619,0.06036631792128687,2021-11-10 00:11:12 UTC
779714,mainnet,245,105840000,106098902,258903,243280,15623,0.06034306284593072,2021-11-10 00:12:38 UTC
779716,mainnet,245,105840000,106099076,259077,243444,15633,0.060341134102988685,2021-11-10 00:14:06 UTC
779717,mainnet,245,105840000,106099223,259224,243587,15637,0.060322346696293556,2021-11-10 00:15:34 UTC
779719,mainnet,245,105840000,106099391,259392,243740,15652,0.06034110535405872,2021-11-10 00:17:12 UTC
779721,mainnet,245,105840000,106099588,259589,243933,15656,0.060310721948926956,2021-11-10 00:18:42 UTC
779722,mainnet,245,105840000,106099766,259767,244105,15662,0.060292492887857194,2021-11-10 00:20:19 UTC
779724,mainnet,245,105840000,106099985,259986,244322,15664,0.060249398044510086,2021-11-10 00:22:01 UTC
779725,mainnet,245,105840000,106100165,260166,244496,15670,0.06023077573549195,2021-11-10 00:23:30 UTC
779727,mainnet,245,105840000,106100386,260387,244713,15674,0.060195017416384076,2021-11-10 00:25:20 UTC
779728,mainnet,245,105840000,106100576,260577,244898,15679,0.060170314340866615,2021-11-10 00:26:56 UTC
779730,mainnet,245,105840000,106100763,260764,245076,15688,0.06016167875933794,2021-11-10 00:28:35 UTC
779731,mainnet,245,105840000,106100951,260952,245248,15704,0.06017964989729912,2021-11-10 00:30:17 UTC
779733,mainnet,245,105840000,106101176,261177,245459,15718,0.06018140954218786,2021-11-10 00:31:58 UTC
779735,mainnet,245,105840000,106101350,261351,245628,15723,0.0601604738455181,2021-11-10 00:33:40 UTC
779736,mainnet,245,105840000,106101565,261566,245843,15723,0.06011102360398523,2021-11-10 00:35:19 UTC
779738,mainnet,245,105840000,106101744,261745,246009,15736,0.06011958203595102,2021-11-10 00:36:48 UTC
779739,mainnet,245,105840000,106101906,261907,246171,15736,0.060082395659528,2021-11-10 00:38:12 UTC
779741,mainnet,245,105840000,106102063,262064,246320,15744,0.06007692777336834,2021-11-10 00:39:38 UTC
779742,mainnet,245,105840000,106102212,262213,246455,15758,0.060096181348750825,2021-11-10 00:41:18 UTC
779744,mainnet,245,105840000,106102363,262364,246581,15783,0.060156881279443825,2021-11-10 00:42:42 UTC
779745,mainnet,245,105840000,106102565,262566,246772,15794,0.06015249499173541,2021-11-10 00:44:23 UTC
779747,mainnet,245,105840000,106102764,262765,246959,15806,0.06015260784351036,2021-11-10 00:46:05 UTC
779748,mainnet,245,105840000,106102903,262904,247092,15812,0.06014362657091562,2021-11-10 00:47:30 UTC
779750,mainnet,245,105840000,106103091,263092,247259,15833,0.060180469189485046,2021-11-10 00:49:08 UTC
779751,mainnet,245,105840000,106103277,263278,247435,15843,0.060175935702945174,2021-11-10 00:50:47 UTC
779753,mainnet,245,105840000,106103450,263451,247599,15852,0.06017058200576198,2021-11-10 00:52:18 UTC
779754,mainnet,245,105840000,106103623,263624,247762,15862,0.06016902861651443,2021-11-10 00:53:43 UTC
779756,mainnet,245,105840000,106103814,263815,247938,15877,0.060182324735136364,2021-11-10 00:55:23 UTC
779758,mainnet,245,105840000,106103981,263982,248105,15877,0.06014425225962376,2021-11-10 00:56:49 UTC
779759,mainnet,245,105840000,106104165,264166,248273,15893,0.060162927855969356,2021-11-10 00:58:16 UTC
779761,mainnet,245,105840000,106104411,264412,248509,15903,0.06014477406471718,2021-11-10 01:00:23 UTC
779762,mainnet,245,105840000,106104682,264683,248775,15908,0.060102084380183086,2021-11-10 01:02:34 UTC
779764,mainnet,245,105840000,106104877,264878,248962,15916,0.060088040531867504,2021-11-10 01:04:09 UTC
779765,mainnet,245,105840000,106105055,265056,249139,15917,0.060051460823373176,2021-11-10 01:05:39 UTC
779767,mainnet,245,105840000,106105276,265277,249351,15926,0.06003535926597481,2021-11-10 01:07:23 UTC
779769,mainnet,245,105840000,106105490,265491,249560,15931,0.06000580057327744,2021-11-10 01:09:21 UTC
779770,mainnet,245,105840000,106105710,265711,249762,15949,0.06002386051010308,2021-11-10 01:11:06 UTC
779772,mainnet,245,105840000,106105855,265856,249896,15960,0.06003249879634088,2021-11-10 01:12:35 UTC
779773,mainnet,245,105840000,106106127,266128,250137,15991,0.060087627006553235,2021-11-10 01:14:46 UTC
779775,mainnet,245,105840000,106106336,266337,250346,15991,0.06004047503726482,2021-11-10 01:16:22 UTC
779776,mainnet,245,105840000,106106565,266566,250566,16000,0.06002265855360399,2021-11-10 01:18:10 UTC
779778,mainnet,245,105840000,106106800,266801,250787,16014,0.0600222637846185,2021-11-10 01:20:09 UTC
779779,mainnet,245,105840000,106106992,266993,250974,16019,0.05999782765840303,2021-11-10 01:21:44 UTC
779781,mainnet,245,105840000,106107184,267185,251156,16029,0.05999214027733593,2021-11-10 01:23:20 UTC
779782,mainnet,245,105840000,106107366,267367,251335,16032,0.059962523422860715,2021-11-10 01:24:54 UTC
779784,mainnet,245,105840000,106107567,267568,251523,16045,0.05996606470130957,2021-11-10 01:26:26 UTC
779785,mainnet,245,105840000,106107724,267725,251668,16057,0.05997572135586889,2021-11-10 01:27:51 UTC
779787,mainnet,245,105840000,106107884,267885,251824,16061,0.05995483136420479,2021-11-10 01:29:17 UTC
779788,mainnet,245,105840000,106108064,268065,251993,16072,0.05995560778169474,2021-11-10 01:30:47 UTC
779790,mainnet,245,105840000,106108248,268249,252176,16073,0.059918210319516566,2021-11-10 01:32:14 UTC
779791,mainnet,245,105840000,106108442,268443,252365,16078,0.05989353419534128,2021-11-10 01:33:43 UTC
779793,mainnet,245,105840000,106108611,268612,252526,16086,0.059885634297797564,2021-11-10 01:35:12 UTC
779794,mainnet,245,105840000,106108814,268815,252719,16096,0.05987761099641017,2021-11-10 01:36:53 UTC
779796,mainnet,245,105840000,106109004,269005,252905,16100,0.05985018865820338,2021-11-10 01:38:24 UTC
779797,mainnet,245,105840000,106109168,269169,253060,16109,0.0598471592196724,2021-11-10 01:39:52 UTC
779799,mainnet,245,105840000,106109338,269339,253222,16117,0.05983908754395019,2021-11-10 01:41:19 UTC
779801,mainnet,245,105840000,106109540,269541,253418,16123,0.05981650286969329,2021-11-10 01:42:58 UTC
779802,mainnet,245,105840000,106109730,269731,253608,16123,0.05977436779606349,2021-11-10 01:44:36 UTC
779804,mainnet,245,105840000,106109908,269909,253782,16127,0.05974976751423628,2021-11-10 01:46:04 UTC
779805,mainnet,245,105840000,106110094,270095,253964,16131,0.05972343064477314,2021-11-10 01:47:34 UTC
779807,mainnet,245,105840000,106110268,270269,254133,16136,0.05970348060635885,2021-11-10 01:49:00 UTC
779808,mainnet,245,105840000,106110436,270437,254292,16145,0.05969967127279181,2021-11-10 01:50:25 UTC
779810,mainnet,245,105840000,106110603,270604,254455,16149,0.059677610087064493,2021-11-10 01:51:52 UTC
779811,mainnet,245,105840000,106110776,270777,254627,16150,0.059643175011171556,2021-11-10 01:53:17 UTC
779812,mainnet,245,105840000,106110956,270957,254801,16156,0.059625697066324174,2021-11-10 01:54:45 UTC
779814,mainnet,245,105840000,106111156,271157,254980,16177,0.059659164248018676,2021-11-10 01:56:27 UTC
779816,mainnet,245,105840000,106111322,271323,255139,16184,0.05964846327071424,2021-11-10 01:57:51 UTC
779817,mainnet,245,105840000,106111515,271516,255327,16189,0.059624478852075016,2021-11-10 01:59:29 UTC
779818,mainnet,245,105840000,106111691,271692,255502,16190,0.059589535208986646,2021-11-10 02:01:00 UTC
779819,mainnet,245,105840000,106111870,271871,255679,16192,0.0595576578597938,2021-11-10 02:02:31 UTC
779820,mainnet,245,105840000,106112050,272051,255844,16207,0.05957338881312695,2021-11-10 02:03:59 UTC
779822,mainnet,245,105840000,106112249,272250,256028,16222,0.059584940312213036,2021-11-10 02:05:47 UTC
779824,mainnet,245,105840000,106112436,272437,256215,16222,0.05954404137470314,2021-11-10 02:07:27 UTC
779825,mainnet,245,105840000,106112649,272650,256414,16236,0.05954887218045113,2021-11-10 02:09:07 UTC
779827,mainnet,245,105840000,106112728,272729,256481,16248,0.05957562268772298,2021-11-10 02:10:40 UTC
779828,mainnet,245,105840000,106113013,273014,256748,16266,0.059579362230508325,2021-11-10 02:12:09 UTC
779830,mainnet,245,105840000,106113170,273171,256876,16295,0.059651280699635024,2021-11-10 02:13:48 UTC
779831,mainnet,245,105840000,106113412,273413,257112,16301,0.05962042770460805,2021-11-10 02:15:36 UTC
779833,mainnet,245,105840000,106113595,273596,257279,16317,0.059639029810377345,2021-11-10 02:17:03 UTC
779834,mainnet,245,105840000,106113800,273801,257483,16318,0.059598029225605455,2021-11-10 02:18:41 UTC
779836,mainnet,245,105840000,106113987,273988,257669,16319,0.059561002671649856,2021-11-10 02:20:12 UTC
779837,mainnet,245,105840000,106114187,274188,257867,16321,0.05952485156170219,2021-11-10 02:21:51 UTC
779839,mainnet,245,105840000,106114260,274261,257939,16322,0.05951265400476189,2021-11-10 02:23:40 UTC
779840,mainnet,245,105840000,106114565,274566,258205,16361,0.05958858707924506,2021-11-10 02:25:19 UTC
779842,mainnet,245,105840000,106114736,274737,258369,16368,0.05957697725461077,2021-11-10 02:26:53 UTC
779843,mainnet,245,105840000,106114915,274916,258543,16373,0.0595563735832036,2021-11-10 02:28:23 UTC
779845,mainnet,245,105840000,106115110,275111,258733,16378,0.059532334221459704,2021-11-10 02:30:03 UTC
779847,mainnet,245,105840000,106115301,275302,258915,16387,0.05952372303869932,2021-11-10 02:31:36 UTC
779848,mainnet,245,105840000,106115504,275505,259116,16389,0.05948712364566886,2021-11-10 02:33:17 UTC
779850,mainnet,245,105840000,106115684,275685,259296,16389,0.05944828336688612,2021-11-10 02:34:46 UTC
779851,mainnet,245,105840000,106115871,275872,259468,16404,0.059462359355063214,2021-11-10 02:36:19 UTC
779853,mainnet,245,105840000,106116084,276085,259670,16415,0.05945632685585961,2021-11-10 02:38:08 UTC
779854,mainnet,245,105840000,106116279,276280,259853,16427,0.059457796438395834,2021-11-10 02:39:45 UTC
779856,mainnet,245,105840000,106116449,276450,260019,16431,0.05943570265870863,2021-11-10 02:41:13 UTC
779857,mainnet,245,105840000,106116617,276618,260183,16435,0.05941406560672118,2021-11-10 02:42:42 UTC
779859,mainnet,245,105840000,106116797,276798,260356,16442,0.05940071821328189,2021-11-10 02:44:10 UTC
779860,mainnet,245,105840000,106116983,276984,260534,16450,0.05938971204112873,2021-11-10 02:45:39 UTC
779862,mainnet,245,105840000,106117163,277164,260705,16459,0.05938361403356857,2021-11-10 02:47:19 UTC
779863,mainnet,245,105840000,106117366,277367,260899,16468,0.0593726002011775,2021-11-10 02:48:50 UTC
779865,mainnet,245,105840000,106117548,277549,261080,16469,0.05933727017571672,2021-11-10 02:50:19 UTC
779866,mainnet,245,105840000,106117717,277718,261247,16471,0.05930836315975198,2021-11-10 02:51:45 UTC
779868,mainnet,245,105840000,106117884,277885,261396,16489,0.059337495726649515,2021-11-10 02:53:13 UTC
779869,mainnet,245,105840000,106118064,278065,261573,16492,0.05930987359070721,2021-11-10 02:54:45 UTC
779871,mainnet,245,105840000,106118257,278258,261757,16501,0.059301080292390514,2021-11-10 02:56:23 UTC
779872,mainnet,245,105840000,106118429,278430,261920,16510,0.05929677118126639,2021-11-10 02:57:53 UTC
779874,mainnet,245,105840000,106118630,278631,262110,16521,0.059293474164755534,2021-11-10 02:59:32 UTC
779875,mainnet,245,105840000,106118817,278818,262289,16529,0.05928239927120917,2021-11-10 03:01:05 UTC
779877,mainnet,245,105840000,106118994,278995,262453,16542,0.05929138515027151,2021-11-10 03:02:37 UTC
779878,mainnet,245,105840000,106119166,279167,262624,16543,0.05925843670634423,2021-11-10 03:04:06 UTC
779880,mainnet,245,105840000,106119368,279369,262818,16551,0.059244225379337004,2021-11-10 03:05:44 UTC
779881,mainnet,245,105840000,106119543,279544,262986,16558,0.05923217811865037,2021-11-10 03:07:13 UTC
779883,mainnet,245,105840000,106119736,279737,263178,16559,0.05919488662565195,2021-11-10 03:08:51 UTC
779884,mainnet,245,105840000,106119914,279915,263355,16560,0.059160816676491076,2021-11-10 03:10:17 UTC
779886,mainnet,245,105840000,106120104,280105,263543,16562,0.05912782706485068,2021-11-10 03:11:50 UTC
779887,mainnet,245,105840000,106120302,280303,263736,16567,0.05910389828150252,2021-11-10 03:13:30 UTC
779889,mainnet,245,105840000,106120475,280476,263898,16578,0.05910666153253755,2021-11-10 03:14:58 UTC
779890,mainnet,245,105840000,106120659,280660,264070,16590,0.059110667711822135,2021-11-10 03:16:37 UTC
779892,mainnet,245,105840000,106120871,280872,264270,16602,0.05910877552764249,2021-11-10 03:18:07 UTC
779893,mainnet,245,105840000,106121070,281071,264458,16613,0.059106062169345115,2021-11-10 03:19:50 UTC
779895,mainnet,245,105840000,106121240,281241,264620,16621,0.05909878004985048,2021-11-10 03:21:23 UTC
779897,mainnet,245,105840000,106121433,281434,264807,16627,0.05907957105395936,2021-11-10 03:23:02 UTC
779898,mainnet,245,105840000,106121608,281609,264967,16642,0.059096122638125914,2021-11-10 03:24:31 UTC
779900,mainnet,245,105840000,106121786,281787,265135,16652,0.05909428043167357,2021-11-10 03:25:59 UTC
779901,mainnet,245,105840000,106121982,281983,265330,16653,0.059056751648149004,2021-11-10 03:27:50 UTC
779903,mainnet,245,105840000,106122159,282160,265496,16664,0.05905869010490502,2021-11-10 03:29:22 UTC
779904,mainnet,245,105840000,106122324,282325,265659,16666,0.05903125830160276,2021-11-10 03:31:01 UTC
779906,mainnet,245,105840000,106122537,282538,265869,16669,0.05899737380458558,2021-11-10 03:32:39 UTC
779907,mainnet,245,105840000,106122734,282735,266061,16674,0.05897395087272534,2021-11-10 03:34:10 UTC
779909,mainnet,245,105840000,106122915,282916,266242,16674,0.05893622135192071,2021-11-10 03:35:42 UTC
779910,mainnet,245,105840000,106123097,283098,266417,16681,0.05892305844619178,2021-11-10 03:37:16 UTC
779912,mainnet,245,105840000,106123294,283295,266612,16683,0.05888914382534108,2021-11-10 03:39:08 UTC
779913,mainnet,245,105840000,106123478,283479,266792,16687,0.058865030566638096,2021-11-10 03:40:35 UTC
779915,mainnet,245,105840000,106123668,283669,266957,16712,0.058913733964585484,2021-11-10 03:42:03 UTC
779916,mainnet,245,105840000,106123830,283831,267102,16729,0.058940003029972064,2021-11-10 03:43:35 UTC
779918,mainnet,245,105840000,106124011,284012,267273,16739,0.05893765052180894,2021-11-10 03:45:04 UTC
779920,mainnet,245,105840000,106124252,284253,267501,16752,0.05893341495076569,2021-11-10 03:47:26 UTC
779921,mainnet,245,105840000,106124461,284462,267705,16757,0.058907692415858706,2021-11-10 03:48:56 UTC
779923,mainnet,245,105840000,106124650,284651,267885,16766,0.05890019708344604,2021-11-10 03:50:24 UTC
779924,mainnet,245,105840000,106124897,284898,268119,16779,0.05889476233599394,2021-11-10 03:52:27 UTC
779926,mainnet,245,105840000,106125073,285074,268294,16780,0.05886190953927752,2021-11-10 03:53:56 UTC
779927,mainnet,245,105840000,106125268,285269,268484,16785,0.058839200894594226,2021-11-10 03:55:35 UTC
779929,mainnet,245,105840000,106125476,285477,268679,16798,0.058841868171516445,2021-11-10 03:57:20 UTC
779930,mainnet,245,105840000,106125650,285651,268850,16801,0.058816527860921196,2021-11-10 03:58:50 UTC
779932,mainnet,245,105840000,106125845,285846,269043,16803,0.05878340085220713,2021-11-10 04:00:23 UTC
779933,mainnet,245,105840000,106126034,286035,269223,16812,0.058776023913157484,2021-11-10 04:02:03 UTC
779935,mainnet,245,105840000,106126197,286198,269380,16818,0.05876351337186144,2021-11-10 04:03:32 UTC
779936,mainnet,245,105840000,106126377,286378,269550,16828,0.058761497042370575,2021-11-10 04:05:01 UTC
779938,mainnet,245,105840000,106126539,286540,269702,16838,0.05876317442590912,2021-11-10 04:06:31 UTC
779939,mainnet,245,105840000,106126728,286729,269878,16851,0.058769779129421856,2021-11-10 04:08:02 UTC
779941,mainnet,245,105840000,106126908,286909,270058,16851,0.05873290834376056,2021-11-10 04:09:32 UTC
779943,mainnet,245,105840000,106127102,287103,270236,16867,0.05874895072500113,2021-11-10 04:11:13 UTC
779944,mainnet,245,105840000,106127302,287303,270435,16868,0.05871153451234411,2021-11-10 04:12:54 UTC
779946,mainnet,245,105840000,106127487,287488,270620,16868,0.058673753339269816,2021-11-10 04:14:26 UTC
779947,mainnet,245,105840000,106127660,287661,270775,16886,0.058701040460820204,2021-11-10 04:16:05 UTC
779949,mainnet,245,105840000,106127888,287889,270990,16899,0.0586997071788085,2021-11-10 04:17:45 UTC
779950,mainnet,245,105840000,106128062,288063,271157,16906,0.0586885507684083,2021-11-10 04:19:23 UTC
779952,mainnet,245,105840000,106128291,288292,271376,16916,0.05867661953852344,2021-11-10 04:21:02 UTC
779953,mainnet,245,105840000,106128477,288478,271558,16920,0.05865265288860849,2021-11-10 04:22:29 UTC
779955,mainnet,245,105840000,106128658,288659,271734,16925,0.058633196955577345,2021-11-10 04:23:58 UTC
779956,mainnet,245,105840000,106128820,288821,271886,16935,0.05863493305542187,2021-11-10 04:25:27 UTC
779958,mainnet,245,105840000,106128996,288997,272054,16943,0.05862690616165566,2021-11-10 04:26:55 UTC
779959,mainnet,245,105840000,106129171,289172,272219,16953,0.05862600805057198,2021-11-10 04:28:28 UTC
779961,mainnet,245,105840000,106129333,289334,272375,16959,0.0586139202444234,2021-11-10 04:29:51 UTC
779962,mainnet,245,105840000,106129519,289520,272550,16970,0.05861425808234319,2021-11-10 04:31:22 UTC
779964,mainnet,245,105840000,106129697,289698,272714,16984,0.0586265697381411,2021-11-10 04:32:46 UTC
779965,mainnet,245,105840000,106129864,289865,272873,16992,0.05862039225156539,2021-11-10 04:34:14 UTC
779967,mainnet,245,105840000,106130045,290046,273049,16997,0.05860104948870179,2021-11-10 04:35:45 UTC
779968,mainnet,245,105840000,106130224,290225,273219,17006,0.05859591696097855,2021-11-10 04:37:15 UTC
779970,mainnet,245,105840000,106130433,290434,273414,17020,0.05860195431664337,2021-11-10 04:38:55 UTC
779971,mainnet,245,105840000,106130613,290614,273589,17025,0.05858286249113945,2021-11-10 04:40:25 UTC
779973,mainnet,245,105840000,106130796,290797,273764,17033,0.058573506604263456,2021-11-10 04:41:54 UTC
779974,mainnet,245,105840000,106130963,290964,273919,17045,0.05858113031165368,2021-11-10 04:43:24 UTC
779976,mainnet,245,105840000,106131149,291150,274091,17059,0.058591791172934914,2021-11-10 04:44:56 UTC
779977,mainnet,245,105840000,106131338,291339,274275,17064,0.05857094312810849,2021-11-10 04:46:30 UTC
779979,mainnet,245,105840000,106131520,291521,274453,17068,0.05854809773566913,2021-11-10 04:47:59 UTC
779980,mainnet,245,105840000,106131707,291708,274635,17073,0.05852770578797976,2021-11-10 04:49:33 UTC
779982,mainnet,245,105840000,106131873,291874,274795,17079,0.0585149756401735,2021-11-10 04:51:00 UTC
779983,mainnet,245,105840000,106132024,292025,274930,17095,0.058539508603715436,2021-11-10 04:52:25 UTC
779985,mainnet,245,105840000,106132221,292222,275119,17103,0.05852742093339995,2021-11-10 04:53:55 UTC
779986,mainnet,245,105840000,106132396,292397,275294,17103,0.05849239219280636,2021-11-10 04:55:21 UTC
779988,mainnet,245,105840000,106132574,292575,275470,17105,0.058463641801247544,2021-11-10 04:56:48 UTC
779989,mainnet,245,105840000,106132772,292773,275666,17107,0.05843093454655996,2021-11-10 04:58:26 UTC
779991,mainnet,245,105840000,106132968,292969,275859,17110,0.058402083496888746,2021-11-10 05:00:07 UTC
779992,mainnet,245,105840000,106133168,293169,276051,17118,0.05838952958873551,2021-11-10 05:01:40 UTC
779994,mainnet,245,105840000,106133343,293344,276225,17119,0.05835810515981237,2021-11-10 05:03:09 UTC
779995,mainnet,245,105840000,106133519,293520,276396,17124,0.05834014717906787,2021-11-10 05:04:42 UTC
779997,mainnet,245,105840000,106133702,293703,276556,17147,0.05838210709458194,2021-11-10 05:06:08 UTC
779998,mainnet,245,105840000,106133850,293851,276690,17161,0.058400345753460085,2021-11-10 05:07:33 UTC
780000,mainnet,245,105840000,106134022,294023,276853,17170,0.05839679208769382,2021-11-10 05:09:01 UTC
780001,mainnet,245,105840000,106134213,294214,277033,17181,0.05839626938215041,2021-11-10 05:10:35 UTC
780003,mainnet,245,105840000,106134430,294431,277239,17192,0.058390590664705824,2021-11-10 05:12:57 UTC
780005,mainnet,245,105840000,106134659,294660,277454,17206,0.05839272381728093,2021-11-10 05:14:34 UTC
780006,mainnet,245,105840000,106134844,294845,277627,17218,0.05839678475131001,2021-11-10 05:16:01 UTC
780008,mainnet,245,105840000,106135034,295035,277815,17220,0.058365956581422546,2021-11-10 05:17:33 UTC
780009,mainnet,245,105840000,106135275,295276,278044,17232,0.05835895907557675,2021-11-10 05:19:36 UTC
780011,mainnet,245,105840000,106135436,295437,278203,17234,0.058333925676201694,2021-11-10 05:21:01 UTC
780012,mainnet,245,105840000,106135619,295620,278377,17243,0.0583282592517421,2021-11-10 05:22:30 UTC
780014,mainnet,245,105840000,106135786,295787,278538,17249,0.05831561224800279,2021-11-10 05:24:05 UTC
780015,mainnet,245,105840000,106135983,295984,278718,17266,0.05833423428293421,2021-11-10 05:25:36 UTC
780017,mainnet,245,105840000,106136161,296162,278895,17267,0.058302550631073535,2021-11-10 05:27:07 UTC
780018,mainnet,245,105840000,106136368,296369,279086,17283,0.058315815756708696,2021-11-10 05:28:47 UTC
780020,mainnet,245,105840000,106136556,296557,279262,17295,0.05831931129597345,2021-11-10 05:30:18 UTC
780021,mainnet,245,105840000,106136721,296722,279415,17307,0.05832732321836601,2021-11-10 05:31:43 UTC
780023,mainnet,245,105840000,106136915,296916,279605,17311,0.05830268493445958,2021-11-10 05:33:13 UTC
780024,mainnet,245,105840000,106137071,297072,279754,17318,0.0582956320353315,2021-11-10 05:34:41 UTC
780026,mainnet,245,105840000,106137266,297267,279933,17334,0.05831121517020053,2021-11-10 05:36:09 UTC
780027,mainnet,245,105840000,106137446,297447,280107,17340,0.058296099809377805,2021-11-10 05:37:50 UTC
780029,mainnet,245,105840000,106137612,297613,280260,17353,0.058307264803620806,2021-11-10 05:39:15 UTC
780030,mainnet,245,105840000,106137785,297786,280427,17359,0.058293539655994576,2021-11-10 05:40:44 UTC
780032,mainnet,245,105840000,106137976,297977,280617,17360,0.05825953009796058,2021-11-10 05:42:25 UTC
780033,mainnet,245,105840000,106138195,298196,280828,17368,0.058243571342338596,2021-11-10 05:44:05 UTC
780035,mainnet,245,105840000,106138383,298384,281007,17377,0.058237036838436375,2021-11-10 05:45:35 UTC
780036,mainnet,245,105840000,106138564,298565,281183,17382,0.058218478388290654,2021-11-10 05:47:03 UTC
780038,mainnet,245,105840000,106138743,298744,281355,17389,0.05820702675200171,2021-11-10 05:48:32 UTC
780039,mainnet,245,105840000,106138913,298914,281524,17390,0.058177268378195736,2021-11-10 05:49:58 UTC
780041,mainnet,245,105840000,106139095,299096,281701,17395,0.05815858453473132,2021-11-10 05:51:30 UTC
780042,mainnet,245,105840000,106139278,299279,281882,17397,0.0581297050578223,2021-11-10 05:52:58 UTC
780044,mainnet,245,105840000,106139459,299460,282061,17399,0.058101248914713154,2021-11-10 05:54:31 UTC
780045,mainnet,245,105840000,106139613,299614,282205,17409,0.05810476145974487,2021-11-10 05:55:58 UTC
780047,mainnet,245,105840000,106139818,299819,282390,17429,0.058131739482821305,2021-11-10 05:57:25 UTC
780048,mainnet,245,105840000,106139998,299999,282561,17438,0.058126860422868076,2021-11-10 05:58:52 UTC
780050,mainnet,245,105840000,106140167,300168,282720,17448,0.05812744862876789,2021-11-10 06:00:26 UTC
780051,mainnet,245,105840000,106140384,300385,282923,17462,0.05813206385139071,2021-11-10 06:02:05 UTC
780053,mainnet,245,105840000,106140555,300556,283089,17467,0.058115625707022986,2021-11-10 06:03:33 UTC
780054,mainnet,245,105840000,106140742,300743,283267,17476,0.05810941568049797,2021-11-10 06:04:58 UTC
780056,mainnet,245,105840000,106140912,300913,283436,17477,0.058079910140140176,2021-11-10 06:06:27 UTC
780057,mainnet,245,105840000,106141112,301113,283629,17484,0.05806458040669118,2021-11-10 06:08:08 UTC
780059,mainnet,245,105840000,106141299,301300,283804,17496,0.058068370394955195,2021-11-10 06:09:38 UTC
780060,mainnet,245,105840000,106141492,301493,283988,17505,0.05806104951027055,2021-11-10 06:11:11 UTC
780062,mainnet,245,105840000,106141676,301677,284170,17507,0.058032266298060506,2021-11-10 06:12:41 UTC
780063,mainnet,245,105840000,106141836,301837,284325,17512,0.05801806935531429,2021-11-10 06:14:08 UTC
780065,mainnet,245,105840000,106142038,302039,284518,17521,0.05800906505451283,2021-11-10 06:15:48 UTC
780066,mainnet,245,105840000,106142218,302219,284679,17540,0.05803738348680924,2021-11-10 06:17:18 UTC
780068,mainnet,245,105840000,106142395,302396,284850,17546,0.05802325427585021,2021-11-10 06:18:48 UTC
780069,mainnet,245,105840000,106142594,302595,285037,17558,0.0580247525570482,2021-11-10 06:20:27 UTC
780071,mainnet,245,105840000,106142763,302764,285201,17563,0.05800887820216406,2021-11-10 06:21:54 UTC
780072,mainnet,245,105840000,106142994,302995,285425,17570,0.05798775557352431,2021-11-10 06:23:46 UTC
780074,mainnet,245,105840000,106143183,303184,285610,17574,0.05796480025331152,2021-11-10 06:25:18 UTC
780075,mainnet,245,105840000,106143352,303353,285770,17583,0.0579621760786938,2021-11-10 06:26:47 UTC
780077,mainnet,245,105840000,106143571,303572,285977,17595,0.05795989089902889,2021-11-10 06:28:31 UTC
780078,mainnet,245,105840000,106143752,303753,286154,17599,0.057938522417885586,2021-11-10 06:29:57 UTC
780080,mainnet,245,105840000,106143934,303935,286332,17603,0.057916988829848484,2021-11-10 06:31:30 UTC
780082,mainnet,245,105840000,106144166,304167,286556,17611,0.05789911463110725,2021-11-10 06:33:19 UTC
780083,mainnet,245,105840000,106144370,304371,286750,17621,0.05789316327771043,2021-11-10 06:35:08 UTC
780085,mainnet,245,105840000,106144552,304553,286930,17623,0.05786513349072247,2021-11-10 06:36:41 UTC
780086,mainnet,245,105840000,106144754,304755,287119,17636,0.05786943610441174,2021-11-10 06:38:14 UTC
780088,mainnet,245,105840000,106144929,304930,287288,17642,0.05785590135440921,2021-11-10 06:39:45 UTC
780089,mainnet,245,105840000,106145112,305113,287466,17647,0.057837588041151966,2021-11-10 06:41:14 UTC
780091,mainnet,245,105840000,106145290,305291,287639,17652,0.05782024363639937,2021-11-10 06:42:41 UTC
780092,mainnet,245,105840000,106145463,305464,287807,17657,0.05780386559463636,2021-11-10 06:44:09 UTC
780094,mainnet,245,105840000,106145642,305643,287978,17665,0.05779618705483194,2021-11-10 06:45:40 UTC
780095,mainnet,245,105840000,106145848,305849,288183,17666,0.05776052888843841,2021-11-10 06:47:29 UTC
780097,mainnet,245,105840000,106146035,306036,288362,17674,0.057751375655151684,2021-11-10 06:48:57 UTC
780098,mainnet,245,105840000,106146227,306228,288541,17687,0.0577576185064723,2021-11-10 06:50:26 UTC
780100,mainnet,245,105840000,106146373,306374,288682,17692,0.05774641451298087,2021-11-10 06:51:55 UTC
780101,mainnet,245,105840000,106146572,306573,288863,17710,0.05776764424786266,2021-11-10 06:53:26 UTC
780103,mainnet,245,105840000,106146748,306749,289036,17713,0.057744279524953625,2021-11-10 06:54:56 UTC
780104,mainnet,245,105840000,106146931,306932,289214,17718,0.05772614129514029,2021-11-10 06:56:24 UTC
780106,mainnet,245,105840000,106147108,307109,289382,17727,0.057722176816700256,2021-11-10 06:58:00 UTC
780107,mainnet,245,105840000,106147312,307313,289570,17743,0.05773592396026201,2021-11-10 06:59:29 UTC
780109,mainnet,245,105840000,106147485,307486,289729,17757,0.057748970684844185,2021-11-10 07:01:05 UTC
780110,mainnet,245,105840000,106147669,307670,289904,17766,0.05774368641726525,2021-11-10 07:02:35 UTC
780112,mainnet,245,105840000,106147846,307847,290075,17772,0.057729976254438084,2021-11-10 07:04:03 UTC
780113,mainnet,245,105840000,106148020,308021,290234,17787,0.057746062768447605,2021-11-10 07:05:34 UTC
780115,mainnet,245,105840000,106148182,308183,290388,17795,0.05774166647738519,2021-11-10 07:07:07 UTC
780116,mainnet,245,105840000,106148382,308383,290574,17809,0.05774961654825331,2021-11-10 07:08:51 UTC
780118,mainnet,245,105840000,106148563,308564,290740,17824,0.05776435358629004,2021-11-10 07:10:25 UTC
780119,mainnet,245,105840000,106148739,308740,290910,17830,0.05775085832739522,2021-11-10 07:11:57 UTC
780121,mainnet,245,105840000,106148917,308918,291088,17830,0.05771758201205498,2021-11-10 07:13:36 UTC
780122,mainnet,245,105840000,106149122,309123,291284,17839,0.05770842027283638,2021-11-10 07:15:09 UTC
780124,mainnet,245,105840000,106149302,309303,291458,17845,0.057694235102795643,2021-11-10 07:16:39 UTC
780125,mainnet,245,105840000,106149436,309437,291575,17862,0.05772418941496977,2021-11-10 07:18:09 UTC
780127,mainnet,245,105840000,106149644,309645,291761,17884,0.057756463046391836,2021-11-10 07:19:41 UTC
780128,mainnet,245,105840000,106149821,309822,291929,17893,0.057752515960777476,2021-11-10 07:21:10 UTC
780130,mainnet,245,105840000,106149998,309999,292101,17898,0.057735670115064884,2021-11-10 07:22:40 UTC
780131,mainnet,245,105840000,106150173,310174,292263,17911,0.057745007640872544,2021-11-10 07:24:09 UTC
780133,mainnet,245,105840000,106150359,310360,292433,17927,0.05776195386003351,2021-11-10 07:25:47 UTC
780134,mainnet,245,105840000,106150515,310516,292586,17930,0.057742596194721045,2021-11-10 07:27:14 UTC
780136,mainnet,245,105840000,106150731,310732,292788,17944,0.05774751232573407,2021-11-10 07:28:54 UTC
780137,mainnet,245,105840000,106150904,310905,292951,17954,0.05774754346182918,2021-11-10 07:30:26 UTC
780139,mainnet,245,105840000,106151085,311086,293119,17967,0.057755733141317836,2021-11-10 07:32:05 UTC
780140,mainnet,245,105840000,106151276,311277,293291,17986,0.05778133302492635,2021-11-10 07:33:32 UTC
780142,mainnet,245,105840000,106151482,311483,293497,17986,0.05774311920714774,2021-11-10 07:35:11 UTC
780143,mainnet,245,105840000,106151696,311697,293697,18000,0.0577483902636214,2021-11-10 07:37:10 UTC
780145,mainnet,245,105840000,106151926,311927,293915,18012,0.057744279911646,2021-11-10 07:39:28 UTC
780147,mainnet,245,105840000,106152160,312161,294139,18022,0.05773302878963099,2021-11-10 07:41:04 UTC
780148,mainnet,245,105840000,106152351,312352,294324,18028,0.057716934740293005,2021-11-10 07:42:34 UTC
780150,mainnet,245,105840000,106152520,312521,294490,18031,0.057695322874302846,2021-11-10 07:44:13 UTC
780151,mainnet,245,105840000,106152770,312771,294713,18058,0.057735531746869115,2021-11-10 07:46:13 UTC
780153,mainnet,245,105840000,106152984,312985,294915,18070,0.057734396217071104,2021-11-10 07:47:57 UTC
780155,mainnet,245,105840000,106153201,313202,295103,18099,0.05778698731170299,2021-11-10 07:49:46 UTC
780156,mainnet,245,105840000,106153412,313413,295305,18108,0.0577767993031559,2021-11-10 07:51:26 UTC
780158,mainnet,245,105840000,106153644,313645,295523,18122,0.057778698847423045,2021-11-10 07:53:18 UTC
780160,mainnet,245,105840000,106153895,313896,295768,18128,0.057751611998878606,2021-11-10 07:55:28 UTC
780161,mainnet,245,105840000,106154048,314049,295916,18133,0.05773939735518979,2021-11-10 07:56:51 UTC
780163,mainnet,245,105840000,106154255,314256,296119,18137,0.05771409296878978,2021-11-10 07:58:40 UTC
780164,mainnet,245,105840000,106154461,314462,296308,18154,0.05773034579694844,2021-11-10 08:00:14 UTC
780166,mainnet,245,105840000,106154636,314637,296470,18167,0.057739553835054365,2021-11-10 08:01:46 UTC
780167,mainnet,245,105840000,106154829,314830,296658,18172,0.057720039386335485,2021-11-10 08:03:21 UTC
780169,mainnet,245,105840000,106155143,315144,296966,18178,0.057681567791231944,2021-11-10 08:05:53 UTC
780170,mainnet,245,105840000,106155330,315331,297146,18185,0.057669559922747846,2021-11-10 08:07:27 UTC
780172,mainnet,245,105840000,106155502,315503,297314,18189,0.05765079888305341,2021-11-10 08:09:05 UTC
780173,mainnet,245,105840000,106155686,315687,297485,18202,0.05765837680994149,2021-11-10 08:10:45 UTC
780175,mainnet,245,105840000,106155895,315896,297677,18219,0.05767404462228075,2021-11-10 08:12:14 UTC
780176,mainnet,245,105840000,106156072,316073,297848,18225,0.05766073027433536,2021-11-10 08:13:43 UTC
780178,mainnet,245,105840000,106156263,316264,298027,18237,0.05766385045405105,2021-11-10 08:15:14 UTC
780179,mainnet,245,105840000,106156442,316443,298192,18251,0.057675473940014474,2021-11-10 08:16:42 UTC
780181,mainnet,245,105840000,106156624,316625,298369,18256,0.05765811290959337,2021-11-10 08:18:12 UTC
780182,mainnet,245,105840000,106156796,316797,298539,18258,0.057633121525772026,2021-11-10 08:19:41 UTC
780184,mainnet,245,105840000,106156964,316965,298690,18275,0.057656208098685977,2021-11-10 08:21:08 UTC
780185,mainnet,245,105840000,106157153,317154,298870,18284,0.05765022670374644,2021-11-10 08:22:45 UTC
780187,mainnet,245,105840000,106157328,317329,299040,18289,0.05763419038285187,2021-11-10 08:24:12 UTC
780188,mainnet,245,105840000,106157488,317489,299186,18303,0.05764924139104032,2021-11-10 08:25:39 UTC
780190,mainnet,245,105840000,106157692,317693,299384,18309,0.05763110927845436,2021-11-10 08:27:18 UTC
780192,mainnet,245,105840000,106157868,317869,299558,18311,0.05760549157042681,2021-11-10 08:28:55 UTC
780193,mainnet,245,105840000,106158080,318081,299767,18314,0.05757652924883913,2021-11-10 08:30:36 UTC
780195,mainnet,245,105840000,106158232,318233,299911,18322,0.057574167355365406,2021-11-10 08:32:02 UTC
780196,mainnet,245,105840000,106158411,318412,300066,18346,0.05761717523208924,2021-11-10 08:33:28 UTC
780198,mainnet,245,105840000,106158579,318580,300230,18350,0.05759934710276853,2021-11-10 08:34:54 UTC
780199,mainnet,245,105840000,106158744,318745,300378,18367,0.05762286467238702,2021-11-10 08:36:20 UTC
780200,mainnet,245,105840000,106158944,318945,300573,18372,0.057602407938672814,2021-11-10 08:37:52 UTC
780202,mainnet,245,105840000,106159142,319143,300770,18373,0.05756980413169018,2021-11-10 08:39:32 UTC
780204,mainnet,245,105840000,106159346,319347,300965,18382,0.05756121084588238,2021-11-10 08:41:13 UTC
780205,mainnet,245,105840000,106159494,319495,301109,18386,0.05754706646426392,2021-11-10 08:42:42 UTC
780207,mainnet,245,105840000,106159683,319684,301281,18403,0.05756622164387332,2021-11-10 08:44:11 UTC
780208,mainnet,245,105840000,106159881,319882,301470,18412,0.05755872477976254,2021-11-10 08:45:43 UTC
780210,mainnet,245,105840000,106160066,320067,301644,18423,0.05755982341197312,2021-11-10 08:47:13 UTC
780211,mainnet,245,105840000,106160271,320272,301845,18427,0.05753546985062697,2021-11-10 08:48:52 UTC
780213,mainnet,245,105840000,106160440,320441,302012,18429,0.057511367147150334,2021-11-10 08:50:20 UTC
780214,mainnet,245,105840000,106160612,320613,302179,18434,0.057496109016165906,2021-11-10 08:51:44 UTC
780216,mainnet,245,105840000,106160797,320798,302357,18441,0.05748477234895479,2021-11-10 08:53:17 UTC
780217,mainnet,245,105840000,106160991,320992,302535,18457,0.05749987538630246,2021-11-10 08:54:53 UTC
780219,mainnet,245,105840000,106161190,321191,302733,18458,0.05746736365589322,2021-11-10 08:56:52 UTC
780220,mainnet,245,105840000,106161462,321463,302966,18497,0.057540059042564776,2021-11-10 08:59:02 UTC
780222,mainnet,245,105840000,106161704,321705,303207,18498,0.05749988343358045,2021-11-10 09:00:58 UTC
780224,mainnet,245,105840000,106161900,321901,303387,18514,0.05751457746325734,2021-11-10 09:02:34 UTC
780225,mainnet,245,105840000,106162072,322073,303542,18531,0.057536645418895714,2021-11-10 09:04:04 UTC
780227,mainnet,245,105840000,106162244,322245,303699,18546,0.057552483358934974,2021-11-10 09:05:32 UTC
780228,mainnet,245,105840000,106162440,322441,303894,18547,0.05752060066802919,2021-11-10 09:07:13 UTC
780230,mainnet,245,105840000,106162623,322624,304067,18557,0.05751896945050585,2021-11-10 09:08:48 UTC
780231,mainnet,245,105840000,106162833,322834,304263,18571,0.057524919927888635,2021-11-10 09:10:30 UTC
780233,mainnet,245,105840000,106163031,323032,304442,18590,0.057548478169345454,2021-11-10 09:12:08 UTC
780234,mainnet,245,105840000,106163216,323217,304617,18600,0.05754647806272566,2021-11-10 09:13:45 UTC
780236,mainnet,245,105840000,106163434,323435,304829,18606,0.057526241748728495,2021-11-10 09:15:28 UTC
780237,mainnet,245,105840000,106163610,323611,305002,18609,0.05750422575252386,2021-11-10 09:16:56 UTC
780239,mainnet,245,105840000,106163796,323797,305180,18617,0.057495900209081616,2021-11-10 09:18:29 UTC
780241,mainnet,245,105840000,106163991,323992,305373,18619,0.05746746833255142,2021-11-10 09:20:06 UTC
780242,mainnet,245,105840000,106164156,324157,305526,18631,0.05747523576538529,2021-11-10 09:21:37 UTC
780244,mainnet,245,105840000,106164330,324331,305688,18643,0.05748140017451307,2021-11-10 09:23:09 UTC
780245,mainnet,245,105840000,106164529,324530,305867,18663,0.057507780482543985,2021-11-10 09:24:47 UTC
780247,mainnet,245,105840000,106164714,324715,306046,18669,0.05749349429499715,2021-11-10 09:26:18 UTC
780248,mainnet,245,105840000,106164896,324897,306218,18679,0.05749206671652862,2021-11-10 09:27:46 UTC
780250,mainnet,245,105840000,106165078,325079,306382,18697,0.057515250139196936,2021-11-10 09:29:19 UTC
780251,mainnet,245,105840000,106165264,325265,306565,18700,0.057491583785528724,2021-11-10 09:30:47 UTC
780253,mainnet,245,105840000,106165462,325463,306759,18704,0.05746889815432169,2021-11-10 09:32:23 UTC
780254,mainnet,245,105840000,106165650,325651,306946,18705,0.057438791835431185,2021-11-10 09:33:53 UTC
780256,mainnet,245,105840000,106165813,325814,307102,18712,0.05743154069499776,2021-11-10 09:35:24 UTC
780257,mainnet,245,105840000,106165978,325979,307259,18720,0.057427012169495584,2021-11-10 09:36:52 UTC
780259,mainnet,245,105840000,106166167,326168,307444,18724,0.05740599936229183,2021-11-10 09:38:27 UTC
780260,mainnet,245,105840000,106166344,326345,307608,18737,0.057414699168058345,2021-11-10 09:39:53 UTC
780262,mainnet,245,105840000,106166523,326524,307771,18753,0.05743222550256643,2021-11-10 09:41:24 UTC
780263,mainnet,245,105840000,106166698,326699,307941,18758,0.05741676589153931,2021-11-10 09:42:53 UTC
780265,mainnet,245,105840000,106166875,326876,308109,18767,0.057413208678520296,2021-11-10 09:44:23 UTC
780266,mainnet,245,105840000,106167054,327055,308278,18777,0.05741236183516534,2021-11-10 09:45:56 UTC
780268,mainnet,245,105840000,106167239,327240,308463,18777,0.05737990465713238,2021-11-10 09:47:29 UTC
780269,mainnet,245,105840000,106167408,327409,308626,18783,0.05736861234724763,2021-11-10 09:48:57 UTC
780271,mainnet,245,105840000,106167584,327585,308797,18788,0.05735305340598623,2021-11-10 09:50:25 UTC
780272,mainnet,245,105840000,106167771,327772,308979,18793,0.05733558693237983,2021-11-10 09:52:04 UTC
780274,mainnet,245,105840000,106167959,327960,309160,18800,0.05732406391023295,2021-11-10 09:53:37 UTC
780275,mainnet,245,105840000,106168133,328134,309332,18802,0.05729976168272718,2021-11-10 09:55:07 UTC
780277,mainnet,245,105840000,106168338,328339,309531,18808,0.05728226010312512,2021-11-10 09:56:41 UTC
780278,mainnet,245,105840000,106168516,328517,309704,18813,0.0572664428324866,2021-11-10 09:58:14 UTC
780280,mainnet,245,105840000,106168691,328692,309875,18817,0.0572481228627408,2021-11-10 09:59:41 UTC
780281,mainnet,245,105840000,106168873,328874,310046,18828,0.05724988901524596,2021-11-10 10:01:20 UTC
780283,mainnet,245,105840000,106169055,329056,310212,18844,0.05726684819605173,2021-11-10 10:02:52 UTC
780284,mainnet,245,105840000,106169253,329254,310401,18853,0.05725974475632794,2021-11-10 10:04:33 UTC
780286,mainnet,245,105840000,106169408,329409,310546,18863,0.05726315917294306,2021-11-10 10:06:03 UTC
780287,mainnet,245,105840000,106169587,329588,310719,18869,0.05725026396592109,2021-11-10 10:07:45 UTC
780289,mainnet,245,105840000,106169796,329797,310919,18878,0.05724127266166763,2021-11-10 10:09:22 UTC
780290,mainnet,245,105840000,106169967,329968,311073,18895,0.05726312854579838,2021-11-10 10:10:53 UTC
780292,mainnet,245,105840000,106170032,330033,311136,18897,0.057257910572579104,2021-11-10 10:12:19 UTC
780293,mainnet,245,105840000,106170303,330304,311371,18933,0.05731992346444487,2021-11-10 10:13:49 UTC
780295,mainnet,245,105840000,106170512,330513,311576,18937,0.05729577959112047,2021-11-10 10:15:42 UTC
780296,mainnet,245,105840000,106170691,330692,311740,18952,0.05731012543393853,2021-11-10 10:17:33 UTC
780298,mainnet,245,105840000,106170861,330862,311894,18968,0.05732903748390568,2021-11-10 10:19:04 UTC
780299,mainnet,245,105840000,106171050,331051,312069,18982,0.05733859737623508,2021-11-10 10:20:37 UTC
780301,mainnet,245,105840000,106171240,331241,312247,18994,0.0573419353280542,2021-11-10 10:22:05 UTC
780302,mainnet,245,105840000,106171392,331393,312376,19017,0.05738503830799081,2021-11-10 10:23:23 UTC
780303,mainnet,245,105840000,106171600,331601,312580,19021,0.057361105666146966,2021-11-10 10:25:08 UTC
780305,mainnet,245,105840000,106171820,331821,312790,19031,0.05735321152066928,2021-11-10 10:27:00 UTC
780306,mainnet,245,105840000,106172002,332003,312953,19050,0.057378999587353124,2021-11-10 10:28:31 UTC
780308,mainnet,245,105840000,106172172,332173,313113,19060,0.057379738871009986,2021-11-10 10:29:57 UTC
780310,mainnet,245,105840000,106172382,332383,313319,19064,0.05735552058919981,2021-11-10 10:31:39 UTC
780311,mainnet,245,105840000,106172563,332564,313491,19073,0.05735136695493198,2021-11-10 10:33:05 UTC
780313,mainnet,245,105840000,106172758,332759,313668,19091,0.057371851700479926,2021-11-10 10:34:41 UTC
780314,mainnet,245,105840000,106172978,332979,313884,19095,0.05734595875415567,2021-11-10 10:36:35 UTC
780316,mainnet,245,105840000,106173160,333161,314058,19103,0.05733864407898884,2021-11-10 10:38:05 UTC
780317,mainnet,245,105840000,106173337,333338,314227,19111,0.05733219734923711,2021-11-10 10:39:29 UTC
780319,mainnet,245,105840000,106173544,333545,314422,19123,0.057332593802935136,2021-11-10 10:41:07 UTC
780320,mainnet,245,105840000,106173746,333747,314609,19138,0.05734283753861458,2021-11-10 10:42:49 UTC
780322,mainnet,245,105840000,106173925,333926,314786,19140,0.05731808843875589,2021-11-10 10:44:20 UTC
780323,mainnet,245,105840000,106174112,334113,314960,19153,0.05732491701909234,2021-11-10 10:45:51 UTC
780325,mainnet,245,105840000,106174290,334291,315138,19153,0.05729439320831252,2021-11-10 10:47:21 UTC
780326,mainnet,245,105840000,106174464,334465,315302,19163,0.057294485222669035,2021-11-10 10:48:50 UTC
780328,mainnet,245,105840000,106174663,334664,315496,19168,0.0572753567757512,2021-11-10 10:50:30 UTC
780329,mainnet,245,105840000,106174840,334841,315664,19177,0.05727195892976069,2021-11-10 10:52:03 UTC
780331,mainnet,245,105840000,106175022,335023,315842,19181,0.05725278562964334,2021-11-10 10:53:37 UTC
780332,mainnet,245,105840000,106175203,335204,316017,19187,0.05723977040846768,2021-11-10 10:55:09 UTC
780334,mainnet,245,105840000,106175364,335365,316174,19191,0.057224218388919536,2021-11-10 10:56:37 UTC
780335,mainnet,245,105840000,106175530,335531,316330,19201,0.05722571088811466,2021-11-10 10:58:06 UTC
780337,mainnet,245,105840000,106175720,335721,316509,19212,0.057226089520762774,2021-11-10 10:59:38 UTC
780338,mainnet,245,105840000,106175908,335909,316689,19220,0.057217877460859934,2021-11-10 11:01:13 UTC
780340,mainnet,245,105840000,106176094,336095,316875,19220,0.05718621223166069,2021-11-10 11:02:42 UTC
780341,mainnet,245,105840000,106176277,336278,317052,19226,0.05717293429840786,2021-11-10 11:04:13 UTC
780343,mainnet,245,105840000,106176464,336465,317229,19236,0.05717087958628683,2021-11-10 11:05:46 UTC
780344,mainnet,245,105840000,106176634,336635,317393,19242,0.057159831865373475,2021-11-10 11:07:15 UTC
780346,mainnet,245,105840000,106176799,336800,317554,19246,0.0571437054631829,2021-11-10 11:08:40 UTC
780347,mainnet,245,105840000,106176985,336986,317734,19252,0.0571299697910299,2021-11-10 11:10:13 UTC
780349,mainnet,245,105840000,106177164,337165,317904,19261,0.05712633280441327,2021-11-10 11:11:41 UTC
780350,mainnet,245,105840000,106177330,337331,318057,19274,0.05713675885109877,2021-11-10 11:13:17 UTC
780352,mainnet,245,105840000,106177502,337503,318199,19304,0.057196528623449275,2021-11-10 11:14:46 UTC
780353,mainnet,245,105840000,106177706,337707,318395,19312,0.0571856668650635,2021-11-10 11:16:28 UTC
780355,mainnet,245,105840000,106177886,337887,318571,19316,0.057167041052186084,2021-11-10 11:17:58 UTC
780356,mainnet,245,105840000,106178077,338078,318753,19325,0.05716136512875727,2021-11-10 11:19:34 UTC
780358,mainnet,245,105840000,106178244,338245,318916,19329,0.0571449688835016,2021-11-10 11:21:13 UTC
780359,mainnet,245,105840000,106178466,338467,319133,19334,0.057122260072621556,2021-11-10 11:22:56 UTC
780361,mainnet,245,105840000,106178644,338645,319298,19347,0.057130623514299636,2021-11-10 11:24:28 UTC
780362,mainnet,245,105840000,106178844,338845,319488,19357,0.05712641473239977,2021-11-10 11:26:04 UTC
780364,mainnet,245,105840000,106179027,339028,319664,19364,0.0571162263883809,2021-11-10 11:27:32 UTC
780365,mainnet,245,105840000,106179175,339176,319808,19368,0.05710309691723471,2021-11-10 11:28:59 UTC
780367,mainnet,245,105840000,106179364,339365,319982,19383,0.057115495115878184,2021-11-10 11:30:30 UTC
780368,mainnet,245,105840000,106179539,339540,320132,19408,0.057159686634858924,2021-11-10 11:32:00 UTC
780370,mainnet,245,105840000,106179711,339712,320296,19416,0.05715429540316504,2021-11-10 11:33:32 UTC
780371,mainnet,245,105840000,106179906,339907,320475,19432,0.0571685784641093,2021-11-10 11:35:15 UTC
780373,mainnet,245,105840000,106180107,340108,320647,19461,0.057220059510508424,2021-11-10 11:36:43 UTC
780374,mainnet,245,105840000,106180312,340313,320844,19469,0.05720909868268329,2021-11-10 11:38:25 UTC
780376,mainnet,245,105840000,106180478,340479,321006,19473,0.05719295463156318,2021-11-10 11:39:55 UTC
780377,mainnet,245,105840000,106180744,340745,321262,19483,0.057177654844531835,2021-11-10 11:42:04 UTC
780379,mainnet,245,105840000,106180921,340922,321432,19490,0.057168501886061915,2021-11-10 11:43:38 UTC
780381,mainnet,245,105840000,106181172,341173,321666,19507,0.05717627127586298,2021-11-10 11:45:35 UTC
780382,mainnet,245,105840000,106181425,341426,321910,19516,0.05716026313168886,2021-11-10 11:47:43 UTC
780384,mainnet,245,105840000,106181638,341639,322117,19522,0.05714218809913388,2021-11-10 11:49:37 UTC
780386,mainnet,245,105840000,106181872,341873,322335,19538,0.05714987729361488,2021-11-10 11:51:58 UTC
780387,mainnet,245,105840000,106182112,342113,322566,19547,0.057136092460678196,2021-11-10 11:53:37 UTC
780389,mainnet,245,105840000,106182282,342283,322730,19553,0.05712524431537646,2021-11-10 11:55:03 UTC
780390,mainnet,245,105840000,106182461,342462,322905,19557,0.057107065893442194,2021-11-10 11:56:33 UTC
780392,mainnet,245,105840000,106182653,342654,323091,19563,0.057092577352081106,2021-11-10 11:58:21 UTC
780393,mainnet,245,105840000,106182830,342831,323262,19569,0.05708060239593269,2021-11-10 11:59:55 UTC
780395,mainnet,245,105840000,106182980,342981,323395,19586,0.057105204078360026,2021-11-10 12:01:30 UTC
780396,mainnet,245,105840000,106183196,343197,323594,19603,0.057118797658487694,2021-11-10 12:03:13 UTC
780398,mainnet,245,105840000,106183386,343387,323779,19608,0.05710175399767609,2021-11-10 12:04:51 UTC
780399,mainnet,245,105840000,106183577,343578,323953,19625,0.0571194896064358,2021-11-10 12:06:36 UTC
780401,mainnet,245,105840000,106183771,343772,324141,19631,0.057104708934991796,2021-11-10 12:08:08 UTC
780402,mainnet,245,105840000,106183948,343949,324302,19647,0.05712184073801639,2021-11-10 12:09:39 UTC
780404,mainnet,245,105840000,106184116,344117,324462,19655,0.05711720141695993,2021-11-10 12:11:09 UTC
780405,mainnet,245,105840000,106184264,344265,324597,19668,0.05713040826107795,2021-11-10 12:12:46 UTC
780407,mainnet,245,105840000,106184479,344480,324795,19685,0.0571441012540641,2021-11-10 12:14:18 UTC
780408,mainnet,245,105840000,106184657,344658,324964,19694,0.05714070179714383,2021-11-10 12:15:46 UTC
780410,mainnet,245,105840000,106184819,344820,325112,19708,0.057154457398062755,2021-11-10 12:17:15 UTC
780412,mainnet,245,105840000,106185011,345012,325295,19717,0.05714873685552966,2021-11-10 12:18:51 UTC
780413,mainnet,245,105840000,106185215,345216,325485,19731,0.05715552002224694,2021-11-10 12:20:36 UTC
780415,mainnet,245,105840000,106185386,345387,325647,19740,0.05715328023347723,2021-11-10 12:22:14 UTC
780416,mainnet,245,105840000,106185614,345615,325867,19748,0.05713872372437539,2021-11-10 12:23:57 UTC
780418,mainnet,245,105840000,106185788,345789,326032,19757,0.057135999120851155,2021-11-10 12:25:26 UTC
780419,mainnet,245,105840000,106185948,345949,326186,19763,0.05712691755143099,2021-11-10 12:26:52 UTC
780421,mainnet,245,105840000,106186131,346132,326362,19770,0.05711693804675673,2021-11-10 12:28:25 UTC
780422,mainnet,245,105840000,106186300,346301,326521,19780,0.0571179407509652,2021-11-10 12:29:52 UTC
780424,mainnet,245,105840000,106186500,346501,326712,19789,0.0571109462887553,2021-11-10 12:31:30 UTC
780425,mainnet,245,105840000,106186661,346662,326862,19800,0.05711615348668155,2021-11-10 12:32:59 UTC
780427,mainnet,245,105840000,106186828,346829,327024,19805,0.05710306808254212,2021-11-10 12:34:25 UTC
780428,mainnet,245,105840000,106187027,347028,327215,19813,0.05709337575065989,2021-11-10 12:36:00 UTC
780430,mainnet,245,105840000,106187211,347212,327391,19821,0.05708616061656855,2021-11-10 12:37:47 UTC
780431,mainnet,245,105840000,106187415,347416,327591,19825,0.05706415363713819,2021-11-10 12:39:21 UTC
780433,mainnet,245,105840000,106187584,347585,327752,19833,0.057059424313477276,2021-11-10 12:40:51 UTC
780434,mainnet,245,105840000,106187754,347755,327921,19834,0.057034406406809394,2021-11-10 12:42:20 UTC
780436,mainnet,245,105840000,106187954,347955,328108,19847,0.05703898492621172,2021-11-10 12:43:58 UTC
780437,mainnet,245,105840000,106188140,348141,328292,19849,0.05701425571822911,2021-11-10 12:45:30 UTC
780439,mainnet,245,105840000,106188320,348321,328467,19854,0.05699914733823112,2021-11-10 12:46:58 UTC
780440,mainnet,245,105840000,106188473,348474,328608,19866,0.05700855730987104,2021-11-10 12:48:28 UTC
780442,mainnet,245,105840000,106188663,348664,328785,19879,0.05701477640364362,2021-11-10 12:50:00 UTC
780443,mainnet,245,105840000,106188848,348849,328959,19890,0.05701607285673744,2021-11-10 12:51:33 UTC
780445,mainnet,245,105840000,106189005,349006,329102,19904,0.05703053815693713,2021-11-10 12:53:02 UTC
780446,mainnet,245,105840000,106189166,349167,329255,19912,0.05702715319603514,2021-11-10 12:54:30 UTC
780448,mainnet,245,105840000,106189329,349330,329400,19930,0.05705207110754874,2021-11-10 12:56:01 UTC
780449,mainnet,245,105840000,106189538,349539,329595,19944,0.057058010694085635,2021-11-10 12:57:44 UTC
780451,mainnet,245,105840000,106189710,349711,329751,19960,0.05707569964913886,2021-11-10 12:59:15 UTC
780452,mainnet,245,105840000,106190048,350049,330059,19990,0.057106290833569016,2021-11-10 13:02:19 UTC
780454,mainnet,245,105840000,106190203,350204,330196,20008,0.05713241424998001,2021-11-10 13:03:43 UTC
780455,mainnet,245,105840000,106190370,350371,330350,20021,0.05714228631935862,2021-11-10 13:05:04 UTC
780457,mainnet,245,105840000,106190582,350583,330542,20041,0.05716477980963139,2021-11-10 13:06:56 UTC
780458,mainnet,245,105840000,106190803,350804,330751,20053,0.057162974196417374,2021-11-10 13:08:52 UTC
780460,mainnet,245,105840000,106190962,350963,330897,20066,0.05717411806942612,2021-11-10 13:10:31 UTC
780461,mainnet,245,105840000,106191160,351161,331076,20085,0.0571959870258941,2021-11-10 13:11:57 UTC
780463,mainnet,245,105840000,106191312,351313,331226,20087,0.0571769333898831,2021-11-10 13:13:23 UTC
780464,mainnet,245,105840000,106191496,351497,331390,20107,0.057203902167017075,2021-11-10 13:15:14 UTC
780466,mainnet,245,105840000,106191691,351692,331580,20112,0.057186401737884286,2021-11-10 13:16:46 UTC
780467,mainnet,245,105840000,106191885,351886,331766,20120,0.057177608657349256,2021-11-10 13:18:23 UTC
780469,mainnet,245,105840000,106192110,352111,331987,20124,0.05715243204557654,2021-11-10 13:20:22 UTC
780471,mainnet,245,105840000,106192302,352303,332168,20135,0.057152507926415616,2021-11-10 13:21:53 UTC
780472,mainnet,245,105840000,106192464,352465,332325,20140,0.05714042529045437,2021-11-10 13:23:20 UTC
780474,mainnet,245,105840000,106192677,352678,332525,20153,0.05714277613006765,2021-11-10 13:25:18 UTC
780475,mainnet,245,105840000,106192877,352878,332712,20166,0.05714722935405438,2021-11-10 13:26:53 UTC
780477,mainnet,245,105840000,106193048,353049,332878,20171,0.05713371231755365,2021-11-10 13:28:17 UTC
780478,mainnet,245,105840000,106193223,353224,333045,20179,0.057128054718818655,2021-11-10 13:29:51 UTC
780480,mainnet,245,105840000,106193378,353379,333190,20189,0.057131295294853404,2021-11-10 13:31:17 UTC
780481,mainnet,245,105840000,106193531,353532,333326,20206,0.05715465643845536,2021-11-10 13:32:42 UTC
780483,mainnet,245,105840000,106193660,353661,333454,20207,0.05713663649653199,2021-11-10 13:34:05 UTC
780484,mainnet,245,105840000,106193819,353820,333597,20223,0.057156181109038494,2021-11-10 13:35:26 UTC
780486,mainnet,245,105840000,106193938,353939,333702,20237,0.05717651911770107,2021-11-10 13:36:53 UTC
780487,mainnet,245,105840000,106194104,354105,333846,20259,0.05721184394459271,2021-11-10 13:38:18 UTC
780489,mainnet,245,105840000,106194244,354245,333977,20268,0.05721463958559754,2021-11-10 13:39:46 UTC
780490,mainnet,245,105840000,106194380,354381,334101,20280,0.05722654431247725,2021-11-10 13:41:09 UTC
780492,mainnet,245,105840000,106194547,354548,334254,20294,0.05723907623227321,2021-11-10 13:42:34 UTC
780493,mainnet,245,105840000,106194697,354698,334386,20312,0.057265617511234906,2021-11-10 13:44:01 UTC
780495,mainnet,245,105840000,106194845,354846,334527,20319,0.05726145990091476,2021-11-10 13:45:26 UTC
780496,mainnet,245,105840000,106194958,354959,334628,20331,0.05727703762969808,2021-11-10 13:46:52 UTC
780498,mainnet,245,105840000,106195099,355100,334740,20360,0.05733596170092931,2021-11-10 13:48:18 UTC
780499,mainnet,245,105840000,106195199,355200,334811,20389,0.057401463963963964,2021-11-10 13:49:40 UTC
780501,mainnet,245,105840000,106195393,355394,334948,20446,0.05753051542794757,2021-11-10 13:51:03 UTC
780502,mainnet,245,105840000,106195531,355532,335051,20481,0.05760662893916722,2021-11-10 13:52:23 UTC
780504,mainnet,245,105840000,106195652,355653,335137,20516,0.05768544058393996,2021-11-10 13:53:45 UTC
780505,mainnet,245,105840000,106195768,355769,335224,20545,0.05774814556636469,2021-11-10 13:55:07 UTC
780507,mainnet,245,105840000,106195876,355877,335312,20565,0.0577868196034023,2021-11-10 13:56:29 UTC
780508,mainnet,245,105840000,106196003,356004,335392,20612,0.057898225862630756,2021-11-10 13:58:02 UTC
780510,mainnet,245,105840000,106196078,356079,335449,20630,0.05793658148893925,2021-11-10 13:59:22 UTC
780511,mainnet,245,105840000,106196200,356201,335527,20674,0.058040263783650244,2021-11-10 14:00:44 UTC
780512,mainnet,245,105840000,106196281,356282,335589,20693,0.05808039698890205,2021-11-10 14:02:19 UTC
780513,mainnet,245,105840000,106196417,356418,335675,20743,0.058198519715614815,2021-11-10 14:03:42 UTC
780515,mainnet,245,105840000,106196554,356555,335776,20779,0.05827712414634488,2021-11-10 14:05:15 UTC
780516,mainnet,245,105840000,106196630,356631,335839,20792,0.05830115721852559,2021-11-10 14:06:35 UTC
780518,mainnet,245,105840000,106196748,356749,335913,20836,0.05840520926477719,2021-11-10 14:07:57 UTC
780519,mainnet,245,105840000,106196889,356890,336023,20867,0.05846899604920284,2021-11-10 14:09:28 UTC
780521,mainnet,245,105840000,106196999,357000,336104,20896,0.05853221288515406,2021-11-10 14:10:53 UTC
780522,mainnet,245,105840000,106196999,357000,336104,20896,0.05853221288515406,2021-11-10 14:12:15 UTC
780524,mainnet,245,105840000,106196999,357000,336104,20896,0.05853221288515406,2021-11-10 14:13:34 UTC
780525,mainnet,245,105840000,106197385,357386,336291,21095,0.059025815224994824,2021-11-10 14:15:06 UTC
780527,mainnet,245,105840000,106197462,357463,336342,21121,0.05908583545709626,2021-11-10 14:16:30 UTC
780528,mainnet,245,105840000,106197626,357627,336434,21193,0.05926006705310281,2021-11-10 14:17:51 UTC
780530,mainnet,245,105840000,106197728,357729,336504,21225,0.05933262329864227,2021-11-10 14:19:25 UTC
780531,mainnet,245,105840000,106197865,357866,336594,21272,0.059441243370423565,2021-11-10 14:20:48 UTC
780533,mainnet,245,105840000,106197925,357926,336646,21280,0.05945363007996066,2021-11-10 14:22:21 UTC
780534,mainnet,245,105840000,106198060,358061,336737,21324,0.05955409832402859,2021-11-10 14:23:54 UTC
780536,mainnet,245,105840000,106198219,358220,336836,21384,0.05969515939925186,2021-11-10 14:25:15 UTC
780537,mainnet,245,105840000,106198289,358290,336897,21393,0.05970861592564682,2021-11-10 14:26:37 UTC
780539,mainnet,245,105840000,106198427,358428,336986,21442,0.05982233530862544,2021-11-10 14:28:04 UTC
780540,mainnet,245,105840000,106198526,358527,337058,21469,0.059881124713062055,2021-11-10 14:29:29 UTC
780542,mainnet,245,105840000,106198663,358664,337146,21518,0.05999486985033346,2021-11-10 14:31:02 UTC
780543,mainnet,245,105840000,106198807,358808,337250,21558,0.060082272413101157,2021-11-10 14:32:26 UTC
780545,mainnet,245,105840000,106198914,358915,337337,21578,0.060120084142484986,2021-11-10 14:33:44 UTC
780546,mainnet,245,105840000,106198989,358990,337397,21593,0.060149307780161004,2021-11-10 14:35:06 UTC
780548,mainnet,245,105840000,106199136,359137,337513,21624,0.060211005827859564,2021-11-10 14:36:28 UTC
780549,mainnet,245,105840000,106199264,359265,337616,21649,0.06025914018899698,2021-11-10 14:37:53 UTC
780551,mainnet,245,105840000,106199434,359435,337763,21672,0.06029462907062473,2021-11-10 14:39:23 UTC
780552,mainnet,245,105840000,106199561,359562,337876,21686,0.06031226881594829,2021-11-10 14:40:47 UTC
780554,mainnet,245,105840000,106199752,359753,338041,21712,0.06035251964542339,2021-11-10 14:42:29 UTC
780555,mainnet,245,105840000,106199893,359894,338165,21729,0.060376110743718986,2021-11-10 14:43:53 UTC
780557,mainnet,245,105840000,106200032,360033,338291,21742,0.06038890879447162,2021-11-10 14:45:16 UTC
780558,mainnet,245,105840000,106200187,360188,338428,21760,0.060412895487911865,2021-11-10 14:46:42 UTC
780560,mainnet,245,105840000,106200364,360365,338598,21767,0.060402647315915804,2021-11-10 14:48:36 UTC
780561,mainnet,245,105840000,106200525,360526,338753,21773,0.06039231567210132,2021-11-10 14:49:57 UTC
780563,mainnet,245,105840000,106200668,360669,338894,21775,0.060373916250079714,2021-11-10 14:51:23 UTC
780565,mainnet,245,105840000,106200856,360857,339067,21790,0.0603840302391252,2021-11-10 14:53:06 UTC
780566,mainnet,245,105840000,106201001,361002,339207,21795,0.06037362673891004,2021-11-10 14:54:34 UTC
780568,mainnet,245,105840000,106201163,361164,339340,21824,0.06042684209943405,2021-11-10 14:56:08 UTC
780569,mainnet,245,105840000,106201338,361339,339490,21849,0.06046676389761415,2021-11-10 14:57:32 UTC
780571,mainnet,245,105840000,106201492,361493,339630,21863,0.06047973266425629,2021-11-10 14:58:55 UTC
780572,mainnet,245,105840000,106201648,361649,339764,21885,0.06051447674402528,2021-11-10 15:00:22 UTC
780574,mainnet,245,105840000,106201799,361800,339904,21896,0.06051962410171365,2021-11-10 15:01:50 UTC
780575,mainnet,245,105840000,106201962,361963,340059,21904,0.06051447247370587,2021-11-10 15:03:29 UTC
780577,mainnet,245,105840000,106202092,362093,340185,21908,0.06050379322439263,2021-11-10 15:04:54 UTC
780578,mainnet,245,105840000,106202232,362233,340314,21919,0.06051077621310041,2021-11-10 15:06:17 UTC
780580,mainnet,245,105840000,106202386,362387,340439,21948,0.060565086495928386,2021-11-10 15:07:41 UTC
780581,mainnet,245,105840000,106202530,362531,340565,21966,0.060590680521114056,2021-11-10 15:09:07 UTC
780583,mainnet,245,105840000,106202690,362691,340716,21975,0.06058876564348164,2021-11-10 15:10:42 UTC
780584,mainnet,245,105840000,106202863,362864,340868,21996,0.060617752105472024,2021-11-10 15:12:20 UTC
780586,mainnet,245,105840000,106203005,363006,341000,22006,0.06062158752196933,2021-11-10 15:13:42 UTC
780587,mainnet,245,105840000,106203168,363169,341144,22025,0.06064669616624767,2021-11-10 15:15:06 UTC
780589,mainnet,245,105840000,106203319,363320,341280,22040,0.06066277661565562,2021-11-10 15:16:32 UTC
780590,mainnet,245,105840000,106203455,363456,341400,22056,0.060684099313259375,2021-11-10 15:17:55 UTC
780592,mainnet,245,105840000,106203640,363641,341568,22073,0.06069997607530504,2021-11-10 15:19:34 UTC
780593,mainnet,245,105840000,106203810,363811,341731,22080,0.06069085321774218,2021-11-10 15:21:09 UTC
780595,mainnet,245,105840000,106203966,363967,341863,22104,0.06073078053779601,2021-11-10 15:22:32 UTC
780596,mainnet,245,105840000,106204123,364124,342006,22118,0.06074304357856115,2021-11-10 15:24:09 UTC
780598,mainnet,245,105840000,106204300,364301,342161,22140,0.060773920466866686,2021-11-10 15:25:35 UTC
780599,mainnet,245,105840000,106204469,364470,342312,22158,0.06079512717096057,2021-11-10 15:27:08 UTC
780601,mainnet,245,105840000,106204629,364630,342458,22172,0.06080684529523078,2021-11-10 15:28:35 UTC
780602,mainnet,245,105840000,106204790,364791,342593,22198,0.06085128196693449,2021-11-10 15:30:01 UTC
780604,mainnet,245,105840000,106204950,364951,342747,22204,0.06084104441418163,2021-11-10 15:31:36 UTC
780605,mainnet,245,105840000,106205105,365106,342897,22209,0.06082890996039506,2021-11-10 15:33:01 UTC
780607,mainnet,245,105840000,106205303,365304,343061,22243,0.06088901298644417,2021-11-10 15:34:45 UTC
780608,mainnet,245,105840000,106205459,365460,343196,22264,0.060920483773874025,2021-11-10 15:36:20 UTC
780610,mainnet,245,105840000,106205642,365643,343352,22291,0.060963836310280795,2021-11-10 15:37:48 UTC
780611,mainnet,245,105840000,106205782,365783,343477,22306,0.06098151089580434,2021-11-10 15:39:13 UTC
780613,mainnet,245,105840000,106205942,365943,343618,22325,0.061006768813722356,2021-11-10 15:40:45 UTC
780614,mainnet,245,105840000,106206097,366098,343760,22338,0.06101644914749602,2021-11-10 15:42:11 UTC
780616,mainnet,245,105840000,106206246,366247,343900,22347,0.06101619945009788,2021-11-10 15:43:46 UTC
780617,mainnet,245,105840000,106206445,366446,344081,22365,0.06103218482395769,2021-11-10 15:45:20 UTC
780619,mainnet,245,105840000,106206616,366617,344239,22378,0.061039177124901464,2021-11-10 15:46:57 UTC
780621,mainnet,245,105840000,106206778,366779,344376,22403,0.06108037810234501,2021-11-10 15:48:32 UTC
780622,mainnet,245,105840000,106206939,366940,344535,22405,0.06105902872404208,2021-11-10 15:49:57 UTC
780624,mainnet,245,105840000,106207106,367107,344701,22406,0.06103397647007548,2021-11-10 15:51:53 UTC
780625,mainnet,245,105840000,106207313,367314,344868,22446,0.0611084793936523,2021-11-10 15:53:27 UTC
780627,mainnet,245,105840000,106207468,367469,345005,22464,0.06113168729879255,2021-11-10 15:55:04 UTC
780628,mainnet,245,105840000,106207633,367634,345156,22478,0.06114233177562467,2021-11-10 15:56:42 UTC
780630,mainnet,245,105840000,106207792,367793,345302,22491,0.06115124540162537,2021-11-10 15:58:03 UTC
780631,mainnet,245,105840000,106207976,367977,345472,22505,0.06115871372395557,2021-11-10 15:59:50 UTC
780633,mainnet,245,105840000,106208166,368167,345633,22534,0.061205920139501914,2021-11-10 16:01:35 UTC
780634,mainnet,245,105840000,106208307,368308,345764,22544,0.06120963975802861,2021-11-10 16:02:59 UTC
780636,mainnet,245,105840000,106208450,368451,345905,22546,0.06119131173480327,2021-11-10 16:04:25 UTC
780637,mainnet,245,105840000,106208617,368618,346063,22555,0.06118800492650928,2021-11-10 16:05:52 UTC
780639,mainnet,245,105840000,106208832,368833,346265,22568,0.061187583540518335,2021-11-10 16:07:50 UTC
780641,mainnet,245,105840000,106209066,369067,346476,22591,0.06121110801019869,2021-11-10 16:09:56 UTC
780642,mainnet,245,105840000,106209242,369243,346640,22603,0.06121443060531953,2021-11-10 16:11:29 UTC
780644,mainnet,245,105840000,106209396,369397,346794,22603,0.061188910575884485,2021-11-10 16:13:02 UTC
780645,mainnet,245,105840000,106209570,369571,346948,22623,0.061214218648108214,2021-11-10 16:14:26 UTC
780647,mainnet,245,105840000,106209743,369744,347105,22639,0.061228850231511533,2021-11-10 16:15:52 UTC
780648,mainnet,245,105840000,106209911,369912,347263,22649,0.06122807586669262,2021-11-10 16:17:19 UTC
780650,mainnet,245,105840000,106210060,370061,347393,22668,0.06125476610612845,2021-11-10 16:18:45 UTC
780652,mainnet,245,105840000,106210252,370253,347573,22680,0.0612554118400121,2021-11-10 16:20:24 UTC
780653,mainnet,245,105840000,106210386,370387,347691,22696,0.06127644868745393,2021-11-10 16:21:48 UTC
780654,mainnet,245,105840000,106210575,370576,347842,22734,0.06134773973489918,2021-11-10 16:23:12 UTC
780656,mainnet,245,105840000,106210748,370749,347994,22755,0.061375755565085816,2021-11-10 16:24:40 UTC
780658,mainnet,245,105840000,106210911,370912,348153,22759,0.06135956776809594,2021-11-10 16:26:19 UTC
780659,mainnet,245,105840000,106211075,371076,348308,22768,0.061356703209046126,2021-11-10 16:27:47 UTC
780661,mainnet,245,105840000,106211269,371270,348482,22788,0.06137851159533493,2021-11-10 16:29:26 UTC
780662,mainnet,245,105840000,106211428,371429,348634,22795,0.061371083033365734,2021-11-10 16:30:52 UTC
780664,mainnet,245,105840000,106211555,371556,348748,22808,0.06138509403696885,2021-11-10 16:32:20 UTC
780665,mainnet,245,105840000,106211690,371691,348871,22820,0.061395083550583686,2021-11-10 16:33:48 UTC
780667,mainnet,245,105840000,106211835,371836,348994,22842,0.0614303079852408,2021-11-10 16:35:17 UTC
780668,mainnet,245,105840000,106211961,371962,349108,22854,0.061441760179803316,2021-11-10 16:36:45 UTC
780670,mainnet,245,105840000,106212147,372148,349266,22882,0.061486290400593314,2021-11-10 16:38:21 UTC
780671,mainnet,245,105840000,106212258,372259,349360,22899,0.06151362357928217,2021-11-10 16:39:48 UTC
780673,mainnet,245,105840000,106212427,372428,349499,22929,0.06156626247220939,2021-11-10 16:41:27 UTC
780674,mainnet,245,105840000,106212565,372566,349629,22937,0.06156493077736562,2021-11-10 16:42:56 UTC
780676,mainnet,245,105840000,106212721,372722,349772,22950,0.061574041779127606,2021-11-10 16:44:25 UTC
780677,mainnet,245,105840000,106212885,372886,349906,22980,0.06162741427674946,2021-11-10 16:45:53 UTC
780679,mainnet,245,105840000,106213060,373061,350065,22996,0.06164139376670303,2021-11-10 16:47:21 UTC
780680,mainnet,245,105840000,106213219,373220,350215,23005,0.06163924762874444,2021-11-10 16:48:51 UTC
780682,mainnet,245,105840000,106213389,373390,350372,23018,0.0616460001606899,2021-11-10 16:50:20 UTC
780683,mainnet,245,105840000,106213569,373570,350539,23031,0.06165109618010012,2021-11-10 16:51:57 UTC
780685,mainnet,245,105840000,106213737,373738,350696,23042,0.061652815608795465,2021-11-10 16:53:35 UTC
780686,mainnet,245,105840000,106213928,373929,350874,23055,0.06165608979244723,2021-11-10 16:55:17 UTC
780688,mainnet,245,105840000,106214092,374093,351034,23059,0.06163975268181976,2021-11-10 16:56:43 UTC
780689,mainnet,245,105840000,106214252,374253,351180,23073,0.061650808410353426,2021-11-10 16:58:11 UTC
780691,mainnet,245,105840000,106214420,374421,351340,23081,0.06164451246057246,2021-11-10 16:59:38 UTC
780692,mainnet,245,105840000,106214607,374608,351512,23096,0.06165378208687481,2021-11-10 17:01:10 UTC
780694,mainnet,245,105840000,106214779,374780,351667,23113,0.06167084689684615,2021-11-10 17:02:39 UTC
780695,mainnet,245,105840000,106214949,374950,351825,23125,0.061674889985331376,2021-11-10 17:04:19 UTC
780697,mainnet,245,105840000,106215141,375142,352006,23136,0.061672646624478196,2021-11-10 17:06:06 UTC
780698,mainnet,245,105840000,106215327,375328,352190,23138,0.06164741239662375,2021-11-10 17:07:35 UTC
780700,mainnet,245,105840000,106215469,375470,352320,23150,0.06165605774096466,2021-11-10 17:09:00 UTC
780701,mainnet,245,105840000,106215644,375645,352477,23168,0.061675251900065224,2021-11-10 17:10:27 UTC
780703,mainnet,245,105840000,106215852,375853,352672,23181,0.06167570832213658,2021-11-10 17:12:16 UTC
780704,mainnet,245,105840000,106215989,375990,352802,23188,0.06167185297481316,2021-11-10 17:13:41 UTC
780706,mainnet,245,105840000,106216162,376163,352961,23202,0.06168070756560321,2021-11-10 17:15:09 UTC
780707,mainnet,245,105840000,106216313,376314,353111,23203,0.0616586148801267,2021-11-10 17:16:39 UTC
780709,mainnet,245,105840000,106216547,376548,353334,23214,0.061649510819337776,2021-11-10 17:18:38 UTC
780711,mainnet,245,105840000,106216712,376713,353475,23238,0.061686217359103616,2021-11-10 17:20:10 UTC
780712,mainnet,245,105840000,106216912,376913,353665,23248,0.06168001634329408,2021-11-10 17:21:49 UTC
780714,mainnet,245,105840000,106217086,377087,353827,23260,0.06168337810637863,2021-11-10 17:23:25 UTC
780715,mainnet,245,105840000,106217301,377302,354032,23270,0.06167473270748631,2021-11-10 17:25:11 UTC
780717,mainnet,245,105840000,106217499,377500,354226,23274,0.06165298013245033,2021-11-10 17:27:30 UTC
780718,mainnet,245,105840000,106217753,377754,354464,23290,0.06165388056777691,2021-11-10 17:29:10 UTC
780720,mainnet,245,105840000,106217917,377918,354616,23302,0.061658878381024455,2021-11-10 17:30:37 UTC
780721,mainnet,245,105840000,106218080,378081,354778,23303,0.061634940660863675,2021-11-10 17:32:03 UTC
780723,mainnet,245,105840000,106218272,378273,354967,23306,0.06161158739851906,2021-11-10 17:33:44 UTC
780724,mainnet,245,105840000,106218422,378423,355116,23307,0.06158980823047225,2021-11-10 17:35:13 UTC
780726,mainnet,245,105840000,106218570,378571,355262,23309,0.061571013099260115,2021-11-10 17:36:38 UTC
780727,mainnet,245,105840000,106218760,378761,355426,23335,0.06160877175844398,2021-11-10 17:38:08 UTC
780729,mainnet,245,105840000,106218915,378916,355576,23340,0.06159676551003389,2021-11-10 17:39:35 UTC
780730,mainnet,245,105840000,106219070,379071,355722,23349,0.06159532119312741,2021-11-10 17:41:00 UTC
780732,mainnet,245,105840000,106219236,379237,355881,23356,0.061586817741939734,2021-11-10 17:42:31 UTC
780733,mainnet,245,105840000,106219394,379395,356030,23365,0.061584891735526295,2021-11-10 17:43:55 UTC
780735,mainnet,245,105840000,106219560,379561,356192,23369,0.061568496236441575,2021-11-10 17:45:23 UTC
780736,mainnet,245,105840000,106219723,379724,356346,23378,0.061565768821565135,2021-11-10 17:46:50 UTC
780738,mainnet,245,105840000,106219900,379901,356508,23393,0.061576568632354216,2021-11-10 17:48:16 UTC
780739,mainnet,245,105840000,106220067,380068,356669,23399,0.06156529884125998,2021-11-10 17:49:42 UTC
780741,mainnet,245,105840000,106220228,380229,356825,23404,0.061552380276096774,2021-11-10 17:51:11 UTC
780742,mainnet,245,105840000,106220392,380393,356972,23421,0.061570533632322365,2021-11-10 17:52:38 UTC
780744,mainnet,245,105840000,106220565,380566,357136,23430,0.06156619351176931,2021-11-10 17:54:05 UTC
780745,mainnet,245,105840000,106220727,380728,357278,23450,0.061592527998991405,2021-11-10 17:55:35 UTC
780747,mainnet,245,105840000,106220899,380900,357436,23464,0.06160147020215279,2021-11-10 17:57:04 UTC
780748,mainnet,245,105840000,106221056,381057,357592,23465,0.061578713945682664,2021-11-10 17:58:33 UTC
780750,mainnet,245,105840000,106221196,381197,357724,23473,0.06157708481441355,2021-11-10 17:59:59 UTC
780751,mainnet,245,105840000,106221383,381384,357885,23499,0.06161506513120634,2021-11-10 18:01:30 UTC
780753,mainnet,245,105840000,106221556,381557,358036,23521,0.061644787017405,2021-11-10 18:02:55 UTC
780754,mainnet,245,105840000,106221744,381745,358222,23523,0.061619667579143146,2021-11-10 18:04:34 UTC
780756,mainnet,245,105840000,106221901,381902,358368,23534,0.06162313892045603,2021-11-10 18:06:01 UTC
780757,mainnet,245,105840000,106222045,382046,358496,23550,0.06164179182611518,2021-11-10 18:07:29 UTC
780759,mainnet,245,105840000,106222188,382189,358622,23567,0.06166320851725193,2021-11-10 18:08:55 UTC
780760,mainnet,245,105840000,106222364,382365,358785,23580,0.06166882429092621,2021-11-10 18:10:27 UTC
780762,mainnet,245,105840000,106222543,382544,358956,23588,0.0616608808398511,2021-11-10 18:11:55 UTC
780763,mainnet,245,105840000,106222687,382688,359099,23589,0.06164029183042061,2021-11-10 18:13:23 UTC
780765,mainnet,245,105840000,106222871,382872,359266,23606,0.06165507010175725,2021-11-10 18:14:50 UTC
780766,mainnet,245,105840000,106223040,383041,359431,23610,0.06163831025921507,2021-11-10 18:16:18 UTC
780768,mainnet,245,105840000,106223196,383197,359577,23620,0.061639313460178445,2021-11-10 18:17:44 UTC
780769,mainnet,245,105840000,106223368,383369,359746,23623,0.06161948410017503,2021-11-10 18:19:19 UTC
780771,mainnet,245,105840000,106223527,383528,359902,23626,0.061601760497277905,2021-11-10 18:20:58 UTC
780772,mainnet,245,105840000,106223704,383705,360061,23644,0.06162025514392567,2021-11-10 18:22:27 UTC
780774,mainnet,245,105840000,106223848,383849,360196,23653,0.06162058517802573,2021-11-10 18:23:54 UTC
780775,mainnet,245,105840000,106224032,384033,360367,23666,0.06162491244242031,2021-11-10 18:25:21 UTC
780777,mainnet,245,105840000,106224215,384216,360544,23672,0.061611177046244824,2021-11-10 18:27:23 UTC
780779,mainnet,245,105840000,106224420,384421,360715,23706,0.06166676638373034,2021-11-10 18:28:54 UTC
780780,mainnet,245,105840000,106224642,384643,360924,23719,0.061664972454977734,2021-11-10 18:30:51 UTC
780782,mainnet,245,105840000,106224811,384812,361077,23735,0.06167946945521449,2021-11-10 18:32:32 UTC
780783,mainnet,245,105840000,106224974,384975,361230,23745,0.06167932982661212,2021-11-10 18:34:03 UTC
780785,mainnet,245,105840000,106225131,385132,361382,23750,0.06166716865905716,2021-11-10 18:35:35 UTC
780786,mainnet,245,105840000,106225313,385314,361545,23769,0.06168735109547019,2021-11-10 18:37:03 UTC
780788,mainnet,245,105840000,106225508,385509,361730,23779,0.06168208783711924,2021-11-10 18:38:51 UTC
780790,mainnet,245,105840000,106225705,385706,361915,23791,0.06168169538456752,2021-11-10 18:40:41 UTC
780791,mainnet,245,105840000,106225880,385881,362072,23809,0.06170036876653683,2021-11-10 18:42:13 UTC
780793,mainnet,245,105840000,106226103,386104,362261,23843,0.061752791993866935,2021-11-10 18:44:14 UTC
780794,mainnet,245,105840000,106226240,386241,362393,23848,0.061743833513272804,2021-11-10 18:45:44 UTC
780796,mainnet,245,105840000,106226424,386425,362566,23859,0.061742899657113284,2021-11-10 18:47:32 UTC
780797,mainnet,245,105840000,106226623,386624,362758,23866,0.061729225293825525,2021-11-10 18:49:09 UTC
780799,mainnet,245,105840000,106226768,386769,362894,23875,0.06172935266270047,2021-11-10 18:50:43 UTC
780800,mainnet,245,105840000,106226926,386927,363034,23893,0.06175066614632734,2021-11-10 18:52:10 UTC
780802,mainnet,245,105840000,106227083,387084,363181,23903,0.061751454464664,2021-11-10 18:53:40 UTC
780803,mainnet,245,105840000,106227261,387262,363342,23920,0.06176696913200882,2021-11-10 18:55:10 UTC
780805,mainnet,245,105840000,106227394,387395,363463,23932,0.06177673950360743,2021-11-10 18:56:38 UTC
780806,mainnet,245,105840000,106227538,387539,363578,23961,0.061828615958651904,2021-11-10 18:58:19 UTC
780808,mainnet,245,105840000,106227721,387722,363725,23997,0.061892283646530245,2021-11-10 18:59:59 UTC
780809,mainnet,245,105840000,106227877,387878,363866,24012,0.06190606324669097,2021-11-10 19:01:33 UTC
780811,mainnet,245,105840000,106228024,388025,363979,24046,0.061970233876683205,2021-11-10 19:03:03 UTC
780812,mainnet,245,105840000,106228190,388191,364133,24058,0.06197464650133568,2021-11-10 19:04:33 UTC
780814,mainnet,245,105840000,106228364,388365,364302,24063,0.0619597543547951,2021-11-10 19:06:04 UTC
780815,mainnet,245,105840000,106228540,388541,364442,24099,0.06202434234739706,2021-11-10 19:07:36 UTC
780817,mainnet,245,105840000,106228725,388726,364615,24111,0.06202569419076676,2021-11-10 19:09:15 UTC
780819,mainnet,245,105840000,106228918,388919,364791,24128,0.062038625009320704,2021-11-10 19:10:51 UTC
780820,mainnet,245,105840000,106229103,389104,364967,24137,0.06203225872774374,2021-11-10 19:12:31 UTC
780822,mainnet,245,105840000,106229284,389285,365139,24146,0.062026535828506105,2021-11-10 19:14:08 UTC
780823,mainnet,245,105840000,106229427,389428,365271,24157,0.06203200591636965,2021-11-10 19:15:37 UTC
780825,mainnet,245,105840000,106229616,389617,365440,24177,0.062053247163239796,2021-11-10 19:17:04 UTC
780826,mainnet,245,105840000,106229804,389805,365618,24187,0.062048973204550995,2021-11-10 19:18:46 UTC
780828,mainnet,245,105840000,106229984,389985,365798,24187,0.062020334115414695,2021-11-10 19:20:21 UTC
780829,mainnet,245,105840000,106230159,390160,365968,24192,0.062005331146196434,2021-11-10 19:21:50 UTC
780831,mainnet,245,105840000,106230325,390326,366133,24193,0.06198152313707004,2021-11-10 19:23:18 UTC
780832,mainnet,245,105840000,106230491,390492,366284,24208,0.061993587576698116,2021-11-10 19:24:48 UTC
780834,mainnet,245,105840000,106230650,390651,366423,24228,0.0620195519786203,2021-11-10 19:26:20 UTC
780835,mainnet,245,105840000,106230834,390835,366590,24245,0.06203385060191641,2021-11-10 19:28:12 UTC
780837,mainnet,245,105840000,106231035,391036,366781,24255,0.062027537106557964,2021-11-10 19:29:41 UTC
780838,mainnet,245,105840000,106231147,391148,366892,24256,0.062012332927689776,2021-11-10 19:31:08 UTC
780840,mainnet,245,105840000,106231147,391148,366892,24256,0.062012332927689776,2021-11-10 19:32:41 UTC
780841,mainnet,245,105840000,106231538,391539,367224,24315,0.06210109337767119,2021-11-10 19:34:21 UTC
780843,mainnet,245,105840000,106231713,391714,367393,24321,0.062088666731339705,2021-11-10 19:35:55 UTC
780844,mainnet,245,105840000,106231888,391889,367555,24334,0.06209411338414704,2021-11-10 19:37:30 UTC
780846,mainnet,245,105840000,106232029,392030,367690,24340,0.06208708517205316,2021-11-10 19:39:02 UTC
780847,mainnet,245,105840000,106232208,392209,367840,24369,0.062132689458936435,2021-11-10 19:40:46 UTC
780849,mainnet,245,105840000,106232370,392371,367984,24387,0.06215291140272854,2021-11-10 19:42:21 UTC
780850,mainnet,245,105840000,106232555,392556,368166,24390,0.062131262800721426,2021-11-10 19:43:57 UTC
780852,mainnet,245,105840000,106232728,392729,368333,24396,0.06211917123512651,2021-11-10 19:45:40 UTC
780854,mainnet,245,105840000,106232940,392941,368530,24411,0.06212383029513337,2021-11-10 19:47:36 UTC
780855,mainnet,245,105840000,106233085,393086,368659,24427,0.06214161786479295,2021-11-10 19:49:11 UTC
780857,mainnet,245,105840000,106233246,393247,368804,24443,0.06215686324371197,2021-11-10 19:50:41 UTC
780858,mainnet,245,105840000,106233433,393434,368959,24475,0.062208655073023686,2021-11-10 19:52:29 UTC
780860,mainnet,245,105840000,106233620,393621,369135,24486,0.06220704688012073,2021-11-10 19:54:25 UTC
780861,mainnet,245,105840000,106233811,393812,369308,24504,0.062222583364651154,2021-11-10 19:56:02 UTC
780863,mainnet,245,105840000,106233967,393968,369455,24513,0.06222078950574666,2021-11-10 19:57:34 UTC
780864,mainnet,245,105840000,106234182,394183,369659,24524,0.06221475811995951,2021-11-10 19:59:28 UTC
780866,mainnet,245,105840000,106234334,394335,369801,24534,0.06221613602647495,2021-11-10 20:01:08 UTC
780868,mainnet,245,105840000,106234480,394481,369921,24560,0.06225901881205939,2021-11-10 20:02:42 UTC
780869,mainnet,245,105840000,106234645,394646,370068,24578,0.062278599048260976,2021-11-10 20:04:13 UTC
780870,mainnet,245,105840000,106234809,394810,370216,24594,0.06229325498340974,2021-11-10 20:05:49 UTC
780872,mainnet,245,105840000,106234973,394974,370354,24620,0.06233321686997119,2021-11-10 20:07:24 UTC
780874,mainnet,245,105840000,106235068,395069,370442,24627,0.06233594637898696,2021-11-10 20:09:17 UTC
780875,mainnet,245,105840000,106235342,395343,370692,24651,0.06235345004211533,2021-11-10 20:10:51 UTC
780877,mainnet,245,105840000,106235511,395512,370836,24676,0.06239001597928761,2021-11-10 20:12:22 UTC
780878,mainnet,245,105840000,106235656,395657,370979,24678,0.06237220622913281,2021-11-10 20:13:54 UTC
780880,mainnet,245,105840000,106235819,395820,371131,24689,0.06237431155575767,2021-11-10 20:15:30 UTC
780881,mainnet,245,105840000,106235971,395972,371276,24696,0.06236804622549069,2021-11-10 20:17:03 UTC
780883,mainnet,245,105840000,106236168,396169,371449,24720,0.06239761313984688,2021-11-10 20:18:36 UTC
780884,mainnet,245,105840000,106236238,396239,371514,24725,0.062399208558471024,2021-11-10 20:20:12 UTC
780886,mainnet,245,105840000,106236433,396434,371687,24747,0.06242401004959212,2021-11-10 20:21:56 UTC
780887,mainnet,245,105840000,106236665,396666,371881,24785,0.062483298291257636,2021-11-10 20:23:29 UTC
780889,mainnet,245,105840000,106236791,396792,371983,24809,0.06252394201495998,2021-11-10 20:25:04 UTC
780890,mainnet,245,105840000,106237003,397004,372184,24820,0.06251826178073773,2021-11-10 20:27:01 UTC
780892,mainnet,245,105840000,106237205,397206,372375,24831,0.06251416141750124,2021-11-10 20:28:41 UTC
780893,mainnet,245,105840000,106237376,397377,372532,24845,0.06252249123628192,2021-11-10 20:30:24 UTC
780895,mainnet,245,105840000,106237560,397561,372697,24864,0.06254134585635915,2021-11-10 20:32:02 UTC
780896,mainnet,245,105840000,106237727,397728,372854,24874,0.06254022849786789,2021-11-10 20:33:37 UTC
780898,mainnet,245,105840000,106237877,397878,372988,24890,0.0625568641643921,2021-11-10 20:35:09 UTC
780899,mainnet,245,105840000,106238046,398047,373146,24901,0.06255793913784051,2021-11-10 20:36:46 UTC
780901,mainnet,245,105840000,106238194,398195,373276,24919,0.06257989176157411,2021-11-10 20:38:20 UTC
780902,mainnet,245,105840000,106238370,398371,373427,24944,0.06261499958581322,2021-11-10 20:39:55 UTC
780904,mainnet,245,105840000,106238560,398561,373598,24963,0.06263282157561828,2021-11-10 20:41:32 UTC
780905,mainnet,245,105840000,106238726,398727,373750,24977,0.06264185771216897,2021-11-10 20:43:05 UTC
780907,mainnet,245,105840000,106238854,398855,373868,24987,0.06264682654097353,2021-11-10 20:44:37 UTC
780909,mainnet,245,105840000,106239047,399048,374038,25010,0.06267416451153746,2021-11-10 20:46:19 UTC
780910,mainnet,245,105840000,106239199,399200,374177,25023,0.06268286573146292,2021-11-10 20:47:52 UTC
780912,mainnet,245,105840000,106239335,399336,374300,25036,0.06269407215978524,2021-11-10 20:49:28 UTC
780913,mainnet,245,105840000,106239476,399477,374418,25059,0.06272951884589101,2021-11-10 20:51:01 UTC
780915,mainnet,245,105840000,106239644,399645,374545,25100,0.06280574009433372,2021-11-10 20:52:37 UTC
780916,mainnet,245,105840000,106239789,399790,374661,25129,0.06285549913704695,2021-11-10 20:54:08 UTC
780918,mainnet,245,105840000,106239932,399933,374778,25155,0.062898035420933,2021-11-10 20:55:39 UTC
780919,mainnet,245,105840000,106240081,400082,374887,25195,0.06297459020900716,2021-11-10 20:57:15 UTC
780921,mainnet,245,105840000,106240238,400239,375003,25236,0.06305232623507455,2021-11-10 20:58:48 UTC
780922,mainnet,245,105840000,106240385,400386,375120,25266,0.06310410453911974,2021-11-10 21:00:24 UTC
780924,mainnet,245,105840000,106240544,400545,375261,25284,0.06312399355877617,2021-11-10 21:01:57 UTC
780925,mainnet,245,105840000,106240698,400699,375376,25323,0.06319706313217652,2021-11-10 21:03:38 UTC
780927,mainnet,245,105840000,106240850,400851,375497,25354,0.06325043470017537,2021-11-10 21:05:08 UTC
780928,mainnet,245,105840000,106240981,400982,375614,25368,0.0632646851978393,2021-11-10 21:06:36 UTC
780930,mainnet,245,105840000,106241139,401140,375760,25380,0.06326968140798724,2021-11-10 21:08:25 UTC
780931,mainnet,245,105840000,106241302,401303,375910,25393,0.06327637720126687,2021-11-10 21:09:54 UTC
780933,mainnet,245,105840000,106241455,401456,376039,25417,0.0633120441592603,2021-11-10 21:11:36 UTC
780934,mainnet,245,105840000,106241653,401654,376224,25430,0.06331319991833767,2021-11-10 21:13:18 UTC
780936,mainnet,245,105840000,106241840,401841,376385,25456,0.06334843881037525,2021-11-10 21:15:07 UTC
780938,mainnet,245,105840000,106241916,401917,376451,25466,0.06336134077433898,2021-11-10 21:16:38 UTC
780939,mainnet,245,105840000,106242169,402170,376688,25482,0.06336126513663376,2021-11-10 21:18:19 UTC
780941,mainnet,245,105840000,106242299,402300,376789,25511,0.06341287596321153,2021-11-10 21:19:53 UTC
780942,mainnet,245,105840000,106242486,402487,376932,25555,0.06349273392681005,2021-11-10 21:21:36 UTC
780944,mainnet,245,105840000,106242653,402654,377070,25584,0.06353842256627278,2021-11-10 21:23:35 UTC
780946,mainnet,245,105840000,106242805,402806,377197,25609,0.06357651077690005,2021-11-10 21:25:16 UTC
780947,mainnet,245,105840000,106242936,402937,377294,25643,0.06364022167237061,2021-11-10 21:26:46 UTC
780949,mainnet,245,105840000,106243088,403089,377411,25678,0.06370305317188016,2021-11-10 21:28:31 UTC
780950,mainnet,245,105840000,106243248,403249,377533,25716,0.06377201183387932,2021-11-10 21:30:39 UTC
780952,mainnet,245,105840000,106243359,403360,377626,25734,0.06379908766362555,2021-11-10 21:32:10 UTC
780953,mainnet,245,105840000,106243507,403508,377733,25775,0.06387729611308822,2021-11-10 21:33:38 UTC
780955,mainnet,245,105840000,106243619,403620,377835,25785,0.06388434666270254,2021-11-10 21:35:08 UTC
780956,mainnet,245,105840000,106243762,403763,377948,25815,0.06393602187421829,2021-11-10 21:36:45 UTC
780958,mainnet,245,105840000,106243882,403883,378051,25832,0.06395911687295579,2021-11-10 21:38:15 UTC
780959,mainnet,245,105840000,106244046,404047,378189,25858,0.06399750524072695,2021-11-10 21:39:43 UTC
780961,mainnet,245,105840000,106244199,404200,378322,25878,0.06402276100940128,2021-11-10 21:41:15 UTC
780962,mainnet,245,105840000,106244328,404329,378440,25889,0.06402954030010215,2021-11-10 21:42:44 UTC
780964,mainnet,245,105840000,106244470,404471,378563,25908,0.06405403601247062,2021-11-10 21:44:18 UTC
780965,mainnet,245,105840000,106244615,404616,378690,25926,0.06407556794590427,2021-11-10 21:45:53 UTC
780967,mainnet,245,105840000,106244757,404758,378804,25954,0.06412226565009216,2021-11-10 21:47:23 UTC
780968,mainnet,245,105840000,106244923,404924,378937,25987,0.06417747527931167,2021-11-10 21:48:53 UTC
780970,mainnet,245,105840000,106245073,405074,379059,26015,0.06422283335884307,2021-11-10 21:50:25 UTC
780971,mainnet,245,105840000,106245209,405210,379183,26027,0.0642308926235779,2021-11-10 21:51:56 UTC
780973,mainnet,245,105840000,106245366,405367,379317,26050,0.06426275449160884,2021-11-10 21:53:27 UTC
780974,mainnet,245,105840000,106245530,405531,379465,26066,0.06427622056020378,2021-11-10 21:54:59 UTC
780976,mainnet,245,105840000,106245671,405672,379593,26079,0.06428592557534166,2021-11-10 21:56:29 UTC
780977,mainnet,245,105840000,106245820,405821,379729,26092,0.06429435637879755,2021-11-10 21:58:02 UTC
780979,mainnet,245,105840000,106246008,406009,379900,26109,0.0643064562608218,2021-11-10 21:59:46 UTC
780981,mainnet,245,105840000,106246197,406198,380071,26127,0.0643208484532174,2021-11-10 22:01:37 UTC
780982,mainnet,245,105840000,106246335,406336,380191,26145,0.06434330209481808,2021-11-10 22:03:12 UTC
780984,mainnet,245,105840000,106246492,406493,380321,26172,0.06438487255623097,2021-11-10 22:04:42 UTC
780985,mainnet,245,105840000,106246687,406688,380498,26190,0.06439826107482886,2021-11-10 22:06:24 UTC
780987,mainnet,245,105840000,106246850,406851,380639,26212,0.06442653452984017,2021-11-10 22:08:06 UTC
780988,mainnet,245,105840000,106246996,406997,380773,26224,0.06443290736786758,2021-11-10 22:09:37 UTC
780990,mainnet,245,105840000,106247146,407147,380901,26246,0.06446320370775174,2021-11-10 22:11:07 UTC
780991,mainnet,245,105840000,106247321,407322,381056,26266,0.06448460922808,2021-11-10 22:12:37 UTC
780993,mainnet,245,105840000,106247484,407485,381202,26283,0.06450053376197896,2021-11-10 22:14:16 UTC
780994,mainnet,245,105840000,106247638,407639,381341,26298,0.06451296367619389,2021-11-10 22:15:48 UTC
780996,mainnet,245,105840000,106247815,407816,381503,26313,0.0645217451007317,2021-11-10 22:17:21 UTC
780997,mainnet,245,105840000,106247999,408000,381676,26324,0.06451960784313726,2021-11-10 22:19:02 UTC
780999,mainnet,245,105840000,106248164,408165,381835,26330,0.06450822584004018,2021-11-10 22:20:34 UTC
781000,mainnet,245,105840000,106248367,408368,382034,26334,0.06448595384555107,2021-11-10 22:22:16 UTC
781002,mainnet,245,105840000,106248536,408537,382194,26343,0.0644813076906131,2021-11-10 22:24:00 UTC
781004,mainnet,245,105840000,106248763,408764,382400,26364,0.06449687350158037,2021-11-10 22:25:44 UTC
781005,mainnet,245,105840000,106248945,408946,382569,26377,0.06449995842971933,2021-11-10 22:27:18 UTC
781007,mainnet,245,105840000,106249166,409167,382769,26398,0.06451644438578868,2021-11-10 22:29:20 UTC
781008,mainnet,245,105840000,106249367,409368,382955,26413,0.0645214086103457,2021-11-10 22:30:52 UTC
781010,mainnet,245,105840000,106249562,409563,383127,26436,0.0645468462727346,2021-11-10 22:32:37 UTC
781011,mainnet,245,105840000,106249776,409777,383328,26449,0.06454486220554106,2021-11-10 22:34:20 UTC
781013,mainnet,245,105840000,106249947,409948,383494,26454,0.06453013552938422,2021-11-10 22:36:00 UTC
781014,mainnet,245,105840000,106250137,410138,383643,26495,0.0646002077349575,2021-11-10 22:37:31 UTC
781016,mainnet,245,105840000,106250305,410306,383793,26513,0.0646176268443552,2021-11-10 22:38:57 UTC
781018,mainnet,245,105840000,106250485,410486,383950,26536,0.0646453228611938,2021-11-10 22:40:42 UTC
781019,mainnet,245,105840000,106250667,410668,384115,26553,0.06465806929198281,2021-11-10 22:42:14 UTC
781021,mainnet,245,105840000,106250833,410834,384269,26565,0.06466115267967111,2021-11-10 22:43:46 UTC
781022,mainnet,245,105840000,106251007,411008,384428,26580,0.06467027405792589,2021-11-10 22:45:19 UTC
781024,mainnet,245,105840000,106251184,411185,384583,26602,0.06469593978379562,2021-11-10 22:46:45 UTC
781025,mainnet,245,105840000,106251437,411438,384823,26615,0.06468775368342253,2021-11-10 22:48:55 UTC
781027,mainnet,245,105840000,106251649,411650,385027,26623,0.06467387343617151,2021-11-10 22:50:35 UTC
781028,mainnet,245,105840000,106251826,411827,385189,26638,0.0646825001760448,2021-11-10 22:52:03 UTC
781030,mainnet,245,105840000,106251964,411965,385313,26652,0.06469481630721056,2021-11-10 22:53:36 UTC
781031,mainnet,245,105840000,106252100,412101,385433,26668,0.06471229140429166,2021-11-10 22:55:05 UTC
781033,mainnet,245,105840000,106252256,412257,385584,26673,0.06469993232376892,2021-11-10 22:56:36 UTC
781034,mainnet,245,105840000,106252456,412457,385775,26682,0.06469037984565663,2021-11-10 22:58:18 UTC
781036,mainnet,245,105840000,106252621,412622,385934,26688,0.06467905249841259,2021-11-10 22:59:49 UTC
781037,mainnet,245,105840000,106252792,412793,386100,26693,0.06466437173110978,2021-11-10 23:01:24 UTC
781039,mainnet,245,105840000,106252944,412945,386237,26708,0.06467689401736308,2021-11-10 23:02:54 UTC
781040,mainnet,245,105840000,106253109,413110,386384,26726,0.06469463339062236,2021-11-10 23:04:27 UTC
781042,mainnet,245,105840000,106253290,413291,386548,26743,0.06470743374523036,2021-11-10 23:05:56 UTC
781043,mainnet,245,105840000,106253455,413456,386710,26746,0.06468886652993305,2021-11-10 23:07:36 UTC
781045,mainnet,245,105840000,106253614,413615,386846,26769,0.06471960639725348,2021-11-10 23:09:06 UTC
781046,mainnet,245,105840000,106253797,413798,387023,26775,0.06470548431843556,2021-11-10 23:10:37 UTC
781048,mainnet,245,105840000,106253964,413965,387181,26784,0.06470112207553778,2021-11-10 23:12:07 UTC
781049,mainnet,245,105840000,106254130,414131,387343,26788,0.06468484609942264,2021-11-10 23:13:35 UTC
781051,mainnet,245,105840000,106254302,414303,387510,26793,0.06467006031817293,2021-11-10 23:15:03 UTC
781052,mainnet,245,105840000,106254466,414467,387671,26796,0.0646517093037564,2021-11-10 23:16:30 UTC
781054,mainnet,245,105840000,106254653,414654,387845,26809,0.06465390421893917,2021-11-10 23:18:11 UTC
781055,mainnet,245,105840000,106254809,414810,387999,26811,0.06463441093512692,2021-11-10 23:19:42 UTC
781057,mainnet,245,105840000,106254985,414986,388165,26821,0.06463109598878035,2021-11-10 23:21:13 UTC
781058,mainnet,245,105840000,106255131,415132,388310,26822,0.06461077440428586,2021-11-10 23:22:50 UTC
781060,mainnet,245,105840000,106255332,415333,388497,26836,0.06461321397529211,2021-11-10 23:24:20 UTC
781061,mainnet,245,105840000,106255512,415513,388669,26844,0.06460447687557308,2021-11-10 23:25:57 UTC
781063,mainnet,245,105840000,106255695,415696,388833,26863,0.06462174281205496,2021-11-10 23:27:30 UTC
781065,mainnet,245,105840000,106255904,415905,389037,26868,0.06460129116024092,2021-11-10 23:29:20 UTC
781066,mainnet,245,105840000,106256071,416072,389190,26882,0.06460900997904209,2021-11-10 23:30:50 UTC
781068,mainnet,245,105840000,106256232,416233,389344,26889,0.06460083655068195,2021-11-10 23:32:27 UTC
781069,mainnet,245,105840000,106256436,416437,389542,26895,0.06458359847948189,2021-11-10 23:34:09 UTC
781071,mainnet,245,105840000,106256610,416611,389714,26897,0.0645614254064343,2021-11-10 23:35:43 UTC
781072,mainnet,245,105840000,106256826,416827,389918,26909,0.06455675855930638,2021-11-10 23:37:37 UTC
781074,mainnet,245,105840000,106257022,417023,390108,26915,0.06454080470381729,2021-11-10 23:39:18 UTC
781075,mainnet,245,105840000,106257211,417212,390284,26928,0.06454272647958352,2021-11-10 23:40:53 UTC
781077,mainnet,245,105840000,106257388,417389,390451,26938,0.06453931464413293,2021-11-10 23:42:27 UTC
781078,mainnet,245,105840000,106257566,417567,390621,26946,0.06453096149839427,2021-11-10 23:43:59 UTC
781080,mainnet,245,105840000,106257755,417756,390801,26955,0.06452331025766236,2021-11-10 23:45:33 UTC
781082,mainnet,245,105840000,106257992,417993,391018,26975,0.06453457354549,2021-11-10 23:47:44 UTC
781083,mainnet,245,105840000,106258184,418185,391209,26976,0.06450733527027512,2021-11-10 23:49:18 UTC
781085,mainnet,245,105840000,106258391,418392,391401,26991,0.06451127172603682,2021-11-10 23:51:21 UTC
781086,mainnet,245,105840000,106258640,418641,391607,27034,0.06457561490632785,2021-11-10 23:53:23 UTC
781088,mainnet,245,105840000,106258816,418817,391773,27044,0.06457235499036572,2021-11-10 23:54:51 UTC
781089,mainnet,245,105840000,106258953,418954,391901,27053,0.06457272158757286,2021-11-10 23:56:21 UTC
781091,mainnet,245,105840000,106259148,419149,392073,27076,0.06459755361458575,2021-11-10 23:57:49 UTC
781092,mainnet,245,105840000,106259334,419335,392248,27087,0.06459513276974257,2021-11-10 23:59:30 UTC
781094,mainnet,245,105840000,106259530,419531,392441,27090,0.06457210551782824,2021-11-11 00:01:19 UTC
781096,mainnet,245,105840000,106259684,419685,392584,27101,0.06457462144227218,2021-11-11 00:02:45 UTC
781097,mainnet,245,105840000,106259855,419856,392742,27114,0.06457928432605464,2021-11-11 00:04:34 UTC
781099,mainnet,245,105840000,106260028,420029,392908,27121,0.06456935116384821,2021-11-11 00:06:05 UTC
781100,mainnet,245,105840000,106260248,420249,393110,27139,0.06457838091226868,2021-11-11 00:08:27 UTC
781102,mainnet,245,105840000,106260480,420481,393333,27148,0.06456415390945132,2021-11-11 00:09:57 UTC
781103,mainnet,245,105840000,106260633,420634,393480,27154,0.06455493374287385,2021-11-11 00:11:37 UTC
781105,mainnet,245,105840000,106260785,420786,393605,27181,0.06459578027786096,2021-11-11 00:13:03 UTC
781107,mainnet,245,105840000,106260964,420965,393757,27208,0.06463245162899528,2021-11-11 00:14:32 UTC
781108,mainnet,245,105840000,106261115,421116,393899,27217,0.06463064808746284,2021-11-11 00:16:04 UTC
781110,mainnet,245,105840000,106261272,421273,394041,27232,0.06464216790537253,2021-11-11 00:17:35 UTC
781111,mainnet,245,105840000,106261444,421445,394206,27239,0.06463239568626986,2021-11-11 00:19:03 UTC
781113,mainnet,245,105840000,106261612,421613,394362,27251,0.06463510375628835,2021-11-11 00:20:34 UTC
781114,mainnet,245,105840000,106261805,421806,394535,27271,0.06465294471866213,2021-11-11 00:22:03 UTC
781116,mainnet,245,105840000,106261966,421967,394693,27274,0.06463538617948797,2021-11-11 00:23:41 UTC
781117,mainnet,245,105840000,106262161,422162,394870,27292,0.064648168238733,2021-11-11 00:25:16 UTC
781119,mainnet,245,105840000,106262362,422363,395057,27306,0.06465054940892076,2021-11-11 00:26:56 UTC
781120,mainnet,245,105840000,106262553,422554,395235,27319,0.06465209180365113,2021-11-11 00:28:38 UTC
781122,mainnet,245,105840000,106262732,422733,395405,27328,0.0646460058713183,2021-11-11 00:30:16 UTC
781123,mainnet,245,105840000,106262904,422905,395560,27345,0.06465991180052258,2021-11-11 00:31:44 UTC
781125,mainnet,245,105840000,106263097,423098,395747,27351,0.06464459770549613,2021-11-11 00:33:14 UTC
781126,mainnet,245,105840000,106263282,423283,395927,27356,0.06462815657609684,2021-11-11 00:34:53 UTC
781128,mainnet,245,105840000,106263467,423468,396104,27364,0.06461881417249946,2021-11-11 00:36:25 UTC
781129,mainnet,245,105840000,106263646,423647,396270,27377,0.06462219725384577,2021-11-11 00:37:53 UTC
781131,mainnet,245,105840000,106263836,423837,396454,27383,0.06460738444260411,2021-11-11 00:39:22 UTC
781132,mainnet,245,105840000,106264010,424011,396624,27387,0.06459030544018905,2021-11-11 00:40:54 UTC
781134,mainnet,245,105840000,106264182,424183,396792,27391,0.06457354490868328,2021-11-11 00:42:25 UTC
781135,mainnet,245,105840000,106264358,424359,396967,27392,0.06454911996682054,2021-11-11 00:43:53 UTC
781137,mainnet,245,105840000,106264571,424572,397170,27402,0.06454028998615076,2021-11-11 00:45:36 UTC
781138,mainnet,245,105840000,106264736,424737,397328,27409,0.06453169843926948,2021-11-11 00:47:06 UTC
781140,mainnet,245,105840000,106264906,424907,397480,27427,0.06454824232126088,2021-11-11 00:48:38 UTC
781141,mainnet,245,105840000,106265072,425073,397644,27429,0.06452773994113953,2021-11-11 00:50:08 UTC
781143,mainnet,245,105840000,106265241,425242,397806,27436,0.06451855649253836,2021-11-11 00:51:39 UTC
781144,mainnet,245,105840000,106265419,425420,397972,27448,0.06451976869916788,2021-11-11 00:53:09 UTC
781146,mainnet,245,105840000,106265596,425597,398128,27469,0.06454227825854035,2021-11-11 00:54:41 UTC
781147,mainnet,245,105840000,106265762,425763,398287,27476,0.0645335550529285,2021-11-11 00:56:12 UTC
781149,mainnet,245,105840000,106265928,425929,398444,27485,0.06452953426510052,2021-11-11 00:57:43 UTC
781150,mainnet,245,105840000,106266122,426123,398633,27490,0.06451188975952953,2021-11-11 00:59:22 UTC
781152,mainnet,245,105840000,106266316,426317,398821,27496,0.06449660698494313,2021-11-11 01:01:09 UTC
781154,mainnet,245,105840000,106266538,426539,399015,27524,0.06452868319192383,2021-11-11 01:03:01 UTC
781155,mainnet,245,105840000,106266711,426712,399176,27536,0.06453064361911547,2021-11-11 01:04:33 UTC
781157,mainnet,245,105840000,106266908,426909,399358,27551,0.0645360018177176,2021-11-11 01:06:18 UTC
781158,mainnet,245,105840000,106267117,427118,399561,27557,0.06451847030562982,2021-11-11 01:08:05 UTC
781160,mainnet,245,105840000,106267303,427304,399742,27562,0.06450208750678674,2021-11-11 01:09:37 UTC
781161,mainnet,245,105840000,106267541,427542,399969,27573,0.0644919095667794,2021-11-11 01:11:41 UTC
781163,mainnet,245,105840000,106267737,427738,400155,27583,0.06448573659576656,2021-11-11 01:13:23 UTC
781164,mainnet,245,105840000,106267936,427937,400350,27587,0.06446509649784898,2021-11-11 01:15:04 UTC
781166,mainnet,245,105840000,106268192,428193,400593,27600,0.06445691545634795,2021-11-11 01:17:19 UTC
781168,mainnet,245,105840000,106268386,428387,400777,27610,0.06445106877659686,2021-11-11 01:18:57 UTC
781169,mainnet,245,105840000,106268583,428584,400960,27624,0.06445410934612585,2021-11-11 01:20:34 UTC
781171,mainnet,245,105840000,106268804,428805,401170,27635,0.06444654330056786,2021-11-11 01:22:27 UTC
781172,mainnet,245,105840000,106268979,428980,401340,27640,0.06443190824747075,2021-11-11 01:23:59 UTC
781174,mainnet,245,105840000,106269186,429187,401546,27641,0.06440316225794351,2021-11-11 01:25:49 UTC
781175,mainnet,245,105840000,106269363,429364,401714,27650,0.06439757408632303,2021-11-11 01:27:19 UTC
781177,mainnet,245,105840000,106269528,429529,401872,27657,0.06438913321335696,2021-11-11 01:28:48 UTC
781178,mainnet,245,105840000,106269760,429761,402099,27662,0.06436600808356273,2021-11-11 01:30:51 UTC
781180,mainnet,245,105840000,106269931,429932,402260,27672,0.06436366681242615,2021-11-11 01:32:21 UTC
781181,mainnet,245,105840000,106270098,430099,402413,27686,0.06437122615955862,2021-11-11 01:33:59 UTC
781183,mainnet,245,105840000,106270295,430296,402604,27692,0.06435569933255247,2021-11-11 01:35:28 UTC
781184,mainnet,245,105840000,106270476,430477,402775,27702,0.06435187013475749,2021-11-11 01:36:59 UTC
781186,mainnet,245,105840000,106270662,430663,402960,27703,0.06432639906376912,2021-11-11 01:38:30 UTC
781187,mainnet,245,105840000,106270832,430833,403121,27712,0.06432190663203607,2021-11-11 01:39:58 UTC
781189,mainnet,245,105840000,106271003,431004,403279,27725,0.06432654917355755,2021-11-11 01:41:25 UTC
781190,mainnet,245,105840000,106271185,431186,403459,27727,0.06430403584531966,2021-11-11 01:42:56 UTC
781192,mainnet,245,105840000,106271346,431347,403609,27738,0.06430553591424074,2021-11-11 01:44:26 UTC
781194,mainnet,245,105840000,106271543,431544,403790,27754,0.06431325658565523,2021-11-11 01:46:07 UTC
781195,mainnet,245,105840000,106271726,431727,403972,27755,0.06428831182668678,2021-11-11 01:47:38 UTC
781197,mainnet,245,105840000,106271924,431925,404145,27780,0.06431672165306476,2021-11-11 01:49:08 UTC
781198,mainnet,245,105840000,106271964,431965,404181,27784,0.06432002592802658,2021-11-11 01:50:36 UTC
781200,mainnet,245,105840000,106271964,431965,404181,27784,0.06432002592802658,2021-11-11 01:52:06 UTC
781204,mainnet,246,106272000,106273113,1114,856,258,0.23159784560143626,2021-11-11 02:01:27 UTC
781206,mainnet,246,106272000,106273228,1229,957,272,0.22131814483319773,2021-11-11 02:02:45 UTC
781207,mainnet,246,106272000,106273416,1417,1122,295,0.2081863091037403,2021-11-11 02:04:03 UTC
781209,mainnet,246,106272000,106273558,1559,1252,307,0.19692110327132778,2021-11-11 02:05:21 UTC
781210,mainnet,246,106272000,106273743,1744,1427,317,0.18176605504587157,2021-11-11 02:06:48 UTC
781212,mainnet,246,106272000,106273894,1895,1572,323,0.1704485488126649,2021-11-11 02:08:10 UTC
781213,mainnet,246,106272000,106274056,2057,1728,329,0.15994166261545942,2021-11-11 02:09:41 UTC
781215,mainnet,246,106272000,106274216,2217,1884,333,0.15020297699594046,2021-11-11 02:11:01 UTC
781216,mainnet,246,106272000,106274389,2390,2049,341,0.14267782426778242,2021-11-11 02:12:20 UTC
781217,mainnet,246,106272000,106274548,2549,2207,342,0.13417026284817576,2021-11-11 02:13:41 UTC
781219,mainnet,246,106272000,106274707,2708,2362,346,0.1277695716395864,2021-11-11 02:15:01 UTC
781220,mainnet,246,106272000,106274837,2838,2484,354,0.12473572938689217,2021-11-11 02:16:21 UTC
781222,mainnet,246,106272000,106275017,3018,2652,366,0.12127236580516898,2021-11-11 02:17:53 UTC
781223,mainnet,246,106272000,106275204,3205,2829,376,0.11731669266770671,2021-11-11 02:19:13 UTC
781225,mainnet,246,106272000,106275350,3351,2970,381,0.11369740376007162,2021-11-11 02:20:43 UTC
781226,mainnet,246,106272000,106275541,3542,3156,386,0.10897797854319594,2021-11-11 02:22:05 UTC
781228,mainnet,246,106272000,106275703,3704,3311,393,0.10610151187904968,2021-11-11 02:23:24 UTC
781229,mainnet,246,106272000,106275888,3889,3488,401,0.10311133967600926,2021-11-11 02:24:55 UTC
781231,mainnet,246,106272000,106276061,4062,3651,411,0.10118168389955687,2021-11-11 02:26:24 UTC
781232,mainnet,246,106272000,106276214,4215,3793,422,0.10011862396204033,2021-11-11 02:27:45 UTC
781234,mainnet,246,106272000,106276407,4408,3981,427,0.09686932849364792,2021-11-11 02:29:16 UTC
781235,mainnet,246,106272000,106276564,4565,4124,441,0.09660460021905805,2021-11-11 02:30:38 UTC
781237,mainnet,246,106272000,106276816,4817,4363,454,0.09424953290429729,2021-11-11 02:32:39 UTC
781238,mainnet,246,106272000,106276963,4964,4505,459,0.09246575342465753,2021-11-11 02:33:59 UTC
781240,mainnet,246,106272000,106277148,5149,4689,460,0.08933773548261799,2021-11-11 02:35:27 UTC
781241,mainnet,246,106272000,106277316,5317,4843,474,0.08914801579838255,2021-11-11 02:36:52 UTC
781243,mainnet,246,106272000,106277474,5475,4988,487,0.08894977168949772,2021-11-11 02:38:12 UTC
781244,mainnet,246,106272000,106277644,5645,5142,503,0.08910540301151461,2021-11-11 02:40:03 UTC
781246,mainnet,246,106272000,106277864,5865,5357,508,0.086615515771526,2021-11-11 02:41:25 UTC
781247,mainnet,246,106272000,106278033,6034,5519,515,0.08534968511766655,2021-11-11 02:42:56 UTC
781249,mainnet,246,106272000,106278199,6200,5680,520,0.08387096774193549,2021-11-11 02:44:30 UTC
781250,mainnet,246,106272000,106278419,6420,5891,529,0.082398753894081,2021-11-11 02:46:04 UTC
781252,mainnet,246,106272000,106278582,6583,6054,529,0.08035849916451467,2021-11-11 02:47:24 UTC
781253,mainnet,246,106272000,106278780,6781,6242,539,0.07948680135673204,2021-11-11 02:49:14 UTC
781255,mainnet,246,106272000,106278951,6952,6406,546,0.0785385500575374,2021-11-11 02:50:36 UTC
781256,mainnet,246,106272000,106279167,7168,6618,550,0.07672991071428571,2021-11-11 02:52:30 UTC
781258,mainnet,246,106272000,106279343,7344,6787,557,0.0758442265795207,2021-11-11 02:53:56 UTC
781259,mainnet,246,106272000,106279520,7521,6957,564,0.07499002792181891,2021-11-11 02:55:28 UTC
781261,mainnet,246,106272000,106279670,7671,7103,568,0.0740451049406857,2021-11-11 02:56:48 UTC
781262,mainnet,246,106272000,106279840,7841,7266,575,0.0733324831016452,2021-11-11 02:58:09 UTC
781264,mainnet,246,106272000,106280032,8033,7457,576,0.07170422009212,2021-11-11 02:59:45 UTC
781265,mainnet,246,106272000,106280191,8192,7613,579,0.0706787109375,2021-11-11 03:01:11 UTC
781267,mainnet,246,106272000,106280336,8337,7754,583,0.06992923113829914,2021-11-11 03:02:31 UTC
781268,mainnet,246,106272000,106280538,8539,7952,587,0.06874341257758519,2021-11-11 03:04:12 UTC
781270,mainnet,246,106272000,106280706,8707,8112,595,0.06833582175261284,2021-11-11 03:05:37 UTC
781271,mainnet,246,106272000,106280879,8880,8273,607,0.06835585585585585,2021-11-11 03:07:00 UTC
781273,mainnet,246,106272000,106281047,9048,8435,613,0.06774977895667551,2021-11-11 03:08:24 UTC
781274,mainnet,246,106272000,106281229,9230,8611,619,0.06706392199349946,2021-11-11 03:09:58 UTC
781276,mainnet,246,106272000,106281442,9443,8810,633,0.06703378163719156,2021-11-11 03:11:32 UTC
781277,mainnet,246,106272000,106281612,9613,8971,642,0.06678456257151774,2021-11-11 03:13:05 UTC
781279,mainnet,246,106272000,106281787,9788,9144,644,0.06579485083776053,2021-11-11 03:14:29 UTC
781280,mainnet,246,106272000,106281921,9922,9273,649,0.06541019955654102,2021-11-11 03:15:52 UTC
781282,mainnet,246,106272000,106282076,10077,9413,664,0.06589262677384142,2021-11-11 03:17:27 UTC
781283,mainnet,246,106272000,106282243,10244,9566,678,0.06618508395158142,2021-11-11 03:18:50 UTC
781285,mainnet,246,106272000,106282396,10397,9709,688,0.06617293450033664,2021-11-11 03:20:13 UTC
781286,mainnet,246,106272000,106282554,10555,9856,699,0.06622453813358598,2021-11-11 03:21:45 UTC
781288,mainnet,246,106272000,106282754,10755,10031,724,0.06731752673175267,2021-11-11 03:23:10 UTC
781289,mainnet,246,106272000,106282911,10912,10187,725,0.06644061583577712,2021-11-11 03:24:36 UTC
781291,mainnet,246,106272000,106283049,11050,10315,735,0.0665158371040724,2021-11-11 03:25:57 UTC
781292,mainnet,246,106272000,106283204,11205,10454,751,0.06702365015618028,2021-11-11 03:27:22 UTC
781293,mainnet,246,106272000,106283331,11332,10567,765,0.06750794211083656,2021-11-11 03:28:45 UTC
781295,mainnet,246,106272000,106283506,11507,10726,781,0.06787173025115148,2021-11-11 03:30:09 UTC
781296,mainnet,246,106272000,106283658,11659,10865,794,0.06810189553134917,2021-11-11 03:31:42 UTC
781298,mainnet,246,106272000,106283806,11807,10996,811,0.06868806640128737,2021-11-11 03:33:07 UTC
781299,mainnet,246,106272000,106283980,11981,11153,828,0.06910942325348468,2021-11-11 03:34:31 UTC
781301,mainnet,246,106272000,106284156,12157,11329,828,0.06810890844780784,2021-11-11 03:35:56 UTC
781302,mainnet,246,106272000,106284320,12321,11493,828,0.06720233747260775,2021-11-11 03:37:21 UTC
781304,mainnet,246,106272000,106284479,12480,11645,835,0.06690705128205128,2021-11-11 03:38:44 UTC
781305,mainnet,246,106272000,106284624,12625,11780,845,0.06693069306930693,2021-11-11 03:40:16 UTC
781307,mainnet,246,106272000,106284810,12811,11956,855,0.06673952072437749,2021-11-11 03:41:37 UTC
781308,mainnet,246,106272000,106285008,13009,12152,857,0.06587746944423092,2021-11-11 03:43:14 UTC
781310,mainnet,246,106272000,106285214,13215,12356,859,0.06500189178963299,2021-11-11 03:44:56 UTC
781311,mainnet,246,106272000,106285412,13413,12547,866,0.06456422873331842,2021-11-11 03:46:33 UTC
781313,mainnet,246,106272000,106285568,13569,12694,875,0.06448522367160439,2021-11-11 03:47:57 UTC
781314,mainnet,246,106272000,106285740,13741,12862,879,0.06396914343934211,2021-11-11 03:49:21 UTC
781316,mainnet,246,106272000,106285884,13885,13001,884,0.0636658264314008,2021-11-11 03:50:47 UTC
781317,mainnet,246,106272000,106286072,14073,13160,913,0.06487600369501884,2021-11-11 03:52:12 UTC
781319,mainnet,246,106272000,106286254,14255,13333,922,0.06467905997895475,2021-11-11 03:53:40 UTC
781320,mainnet,246,106272000,106286431,14432,13506,926,0.0641629711751663,2021-11-11 03:55:06 UTC
781322,mainnet,246,106272000,106286621,14622,13691,931,0.06367118041307619,2021-11-11 03:56:48 UTC
781323,mainnet,246,106272000,106286794,14795,13855,940,0.06353497803311929,2021-11-11 03:58:08 UTC
781325,mainnet,246,106272000,106286945,14946,14002,944,0.0631607118961595,2021-11-11 03:59:32 UTC
781326,mainnet,246,106272000,106287190,15191,14226,965,0.0635244552695675,2021-11-11 04:01:38 UTC
781328,mainnet,246,106272000,106287376,15377,14399,978,0.0636014827339533,2021-11-11 04:03:42 UTC
781329,mainnet,246,106272000,106287587,15588,14601,987,0.06331793687451887,2021-11-11 04:05:05 UTC
781331,mainnet,246,106272000,106287761,15762,14765,997,0.06325339423930973,2021-11-11 04:06:29 UTC
781332,mainnet,246,106272000,106287933,15934,14936,998,0.06263336262081085,2021-11-11 04:07:57 UTC
781334,mainnet,246,106272000,106288114,16115,15104,1011,0.06273658082531802,2021-11-11 04:09:31 UTC
781335,mainnet,246,106272000,106288292,16293,15274,1019,0.0625421960351071,2021-11-11 04:10:57 UTC
781337,mainnet,246,106272000,106288485,16486,15459,1027,0.062295280844352784,2021-11-11 04:12:53 UTC
781339,mainnet,246,106272000,106288698,16699,15655,1044,0.06251871369543087,2021-11-11 04:14:17 UTC
781340,mainnet,246,106272000,106288884,16885,15835,1050,0.062185371631625706,2021-11-11 04:15:45 UTC
781341,mainnet,246,106272000,106289064,17065,16006,1059,0.062056841488426606,2021-11-11 04:17:10 UTC
781343,mainnet,246,106272000,106289233,17234,16170,1064,0.06173842404549147,2021-11-11 04:18:35 UTC
781344,mainnet,246,106272000,106289389,17390,16320,1070,0.06152961472110408,2021-11-11 04:19:59 UTC
781346,mainnet,246,106272000,106289565,17566,16488,1078,0.061368552886257546,2021-11-11 04:21:23 UTC
781347,mainnet,246,106272000,106289740,17741,16654,1087,0.0612705033538132,2021-11-11 04:22:49 UTC
781349,mainnet,246,106272000,106289912,17913,16813,1100,0.06140791603863116,2021-11-11 04:24:15 UTC
781350,mainnet,246,106272000,106290079,18080,16971,1109,0.06133849557522124,2021-11-11 04:25:39 UTC
781352,mainnet,246,106272000,106290290,18291,17166,1125,0.06150565852058389,2021-11-11 04:27:16 UTC
781353,mainnet,246,106272000,106290459,18460,17324,1136,0.06153846153846154,2021-11-11 04:28:39 UTC
781355,mainnet,246,106272000,106290628,18629,17489,1140,0.06119491116001932,2021-11-11 04:30:03 UTC
781356,mainnet,246,106272000,106290814,18815,17675,1140,0.0605899548232793,2021-11-11 04:31:32 UTC
781358,mainnet,246,106272000,106290987,18988,17848,1140,0.06003791868548557,2021-11-11 04:32:57 UTC
781359,mainnet,246,106272000,106291136,19137,17997,1140,0.059570465590217905,2021-11-11 04:34:19 UTC
781361,mainnet,246,106272000,106291352,19353,18193,1160,0.05993902754094972,2021-11-11 04:35:56 UTC
781362,mainnet,246,106272000,106291544,19545,18372,1173,0.0600153491941673,2021-11-11 04:37:32 UTC
781364,mainnet,246,106272000,106291713,19714,18532,1182,0.05995739068682155,2021-11-11 04:38:58 UTC
781365,mainnet,246,106272000,106291892,19893,18707,1186,0.059618961443723924,2021-11-11 04:40:26 UTC
781367,mainnet,246,106272000,106292056,20057,18868,1189,0.05928104901032059,2021-11-11 04:41:51 UTC
781368,mainnet,246,106272000,106292232,20233,19034,1199,0.059259625364503535,2021-11-11 04:43:16 UTC
781370,mainnet,246,106272000,106292403,20404,19201,1203,0.05895902764163889,2021-11-11 04:44:42 UTC
781371,mainnet,246,106272000,106292576,20577,19369,1208,0.05870632259318657,2021-11-11 04:46:10 UTC
781373,mainnet,246,106272000,106292765,20766,19541,1225,0.058990657806029086,2021-11-11 04:47:36 UTC
781374,mainnet,246,106272000,106292964,20965,19739,1226,0.058478416408299545,2021-11-11 04:49:24 UTC
781376,mainnet,246,106272000,106293184,21185,19950,1235,0.05829596412556054,2021-11-11 04:51:01 UTC
781377,mainnet,246,106272000,106293361,21362,20121,1241,0.058093811440876324,2021-11-11 04:52:37 UTC
781379,mainnet,246,106272000,106293567,21568,20321,1247,0.057817136498516324,2021-11-11 04:54:18 UTC
781380,mainnet,246,106272000,106293723,21724,20458,1266,0.058276560486098326,2021-11-11 04:55:43 UTC
781382,mainnet,246,106272000,106293892,21893,20625,1268,0.057918055999634586,2021-11-11 04:57:09 UTC
781383,mainnet,246,106272000,106294066,22067,20794,1273,0.05768795033307654,2021-11-11 04:58:36 UTC
781385,mainnet,246,106272000,106294236,22237,20955,1282,0.05765166164500607,2021-11-11 05:00:14 UTC
781386,mainnet,246,106272000,106294432,22433,21146,1287,0.0573708376053136,2021-11-11 05:01:46 UTC
781388,mainnet,246,106272000,106294598,22599,21295,1304,0.05770166821540776,2021-11-11 05:03:12 UTC
781389,mainnet,246,106272000,106294766,22767,21451,1316,0.05780296042517679,2021-11-11 05:04:37 UTC
781391,mainnet,246,106272000,106294941,22942,21605,1337,0.05827739517042978,2021-11-11 05:06:24 UTC
781392,mainnet,246,106272000,106295173,23174,21826,1348,0.05816863726590144,2021-11-11 05:08:21 UTC
781394,mainnet,246,106272000,106295339,23340,21978,1362,0.0583547557840617,2021-11-11 05:09:49 UTC
781395,mainnet,246,106272000,106295536,23537,22160,1377,0.058503632578493434,2021-11-11 05:11:24 UTC
781397,mainnet,246,106272000,106295708,23709,22324,1385,0.05841663503310979,2021-11-11 05:12:51 UTC
781399,mainnet,246,106272000,106295969,23970,22578,1392,0.05807259073842303,2021-11-11 05:15:04 UTC
781400,mainnet,246,106272000,106296134,24135,22737,1398,0.0579241765071473,2021-11-11 05:16:43 UTC
781402,mainnet,246,106272000,106296395,24396,22979,1417,0.05808329234300705,2021-11-11 05:18:43 UTC
781403,mainnet,246,106272000,106296572,24573,23147,1426,0.05803117242501933,2021-11-11 05:20:08 UTC
781405,mainnet,246,106272000,106296745,24746,23304,1442,0.058272043966701687,2021-11-11 05:21:35 UTC
781406,mainnet,246,106272000,106296913,24914,23461,1453,0.05832062294292366,2021-11-11 05:23:00 UTC
781408,mainnet,246,106272000,106297117,25118,23661,1457,0.058006210685564136,2021-11-11 05:25:02 UTC
781409,mainnet,246,106272000,106297331,25332,23862,1470,0.05802936996684036,2021-11-11 05:26:29 UTC
781411,mainnet,246,106272000,106297577,25578,24083,1495,0.05844866682305106,2021-11-11 05:28:37 UTC
781413,mainnet,246,106272000,106297790,25791,24276,1515,0.05874142142607886,2021-11-11 05:30:34 UTC
781414,mainnet,246,106272000,106298056,26057,24533,1524,0.05848716275856775,2021-11-11 05:32:39 UTC
781416,mainnet,246,106272000,106298228,26229,24700,1529,0.05829425445117999,2021-11-11 05:34:06 UTC
781417,mainnet,246,106272000,106298393,26394,24861,1533,0.058081382132302795,2021-11-11 05:35:31 UTC
781419,mainnet,246,106272000,106298568,26569,25035,1534,0.05773645978395875,2021-11-11 05:36:57 UTC
781420,mainnet,246,106272000,106298758,26759,25212,1547,0.05781232482529242,2021-11-11 05:38:24 UTC
781422,mainnet,246,106272000,106298940,26941,25386,1555,0.05771871868156342,2021-11-11 05:39:52 UTC
781423,mainnet,246,106272000,106299072,27073,25513,1560,0.057621985003509034,2021-11-11 05:41:17 UTC
781425,mainnet,246,106272000,106299285,27286,25710,1576,0.05775855750201569,2021-11-11 05:42:44 UTC
781426,mainnet,246,106272000,106299448,27449,25860,1589,0.05788917629057525,2021-11-11 05:44:11 UTC
781428,mainnet,246,106272000,106299612,27613,26015,1598,0.05787129250715243,2021-11-11 05:45:37 UTC
781429,mainnet,246,106272000,106299820,27821,26212,1609,0.05783401028000432,2021-11-11 05:47:15 UTC
781431,mainnet,246,106272000,106300001,28002,26384,1618,0.05778158702949789,2021-11-11 05:48:42 UTC
781432,mainnet,246,106272000,106300175,28176,26556,1620,0.05749574105621806,2021-11-11 05:50:10 UTC
781434,mainnet,246,106272000,106300351,28352,26726,1626,0.05735045146726862,2021-11-11 05:51:41 UTC
781435,mainnet,246,106272000,106300538,28539,26911,1628,0.05704474578646764,2021-11-11 05:53:12 UTC
781437,mainnet,246,106272000,106300717,28718,27086,1632,0.056828469949160805,2021-11-11 05:54:45 UTC
781438,mainnet,246,106272000,106300894,28895,27255,1640,0.05675722443329296,2021-11-11 05:56:12 UTC
781440,mainnet,246,106272000,106301086,29087,27440,1647,0.056623233747034755,2021-11-11 05:57:52 UTC
781441,mainnet,246,106272000,106301262,29263,27610,1653,0.05648771486177084,2021-11-11 05:59:18 UTC
781443,mainnet,246,106272000,106301437,29438,27782,1656,0.0562538215911407,2021-11-11 06:00:50 UTC
781444,mainnet,246,106272000,106301620,29621,27960,1661,0.05607508186759394,2021-11-11 06:02:29 UTC
781446,mainnet,246,106272000,106301797,29798,28124,1674,0.05617826699778509,2021-11-11 06:03:58 UTC
781447,mainnet,246,106272000,106301977,29978,28294,1684,0.05617452798719061,2021-11-11 06:05:28 UTC
781448,mainnet,246,106272000,106302146,30147,28458,1689,0.05602547517165887,2021-11-11 06:06:57 UTC
781450,mainnet,246,106272000,106302312,30313,28607,1706,0.056279484049747634,2021-11-11 06:08:28 UTC
781451,mainnet,246,106272000,106302500,30501,28780,1721,0.05642437952854005,2021-11-11 06:10:00 UTC
781453,mainnet,246,106272000,106302677,30678,28952,1726,0.05626181628528587,2021-11-11 06:11:27 UTC
781454,mainnet,246,106272000,106302856,30857,29131,1726,0.05593544414557475,2021-11-11 06:12:53 UTC
781456,mainnet,246,106272000,106303027,31028,29295,1733,0.05585277813587727,2021-11-11 06:14:19 UTC
781457,mainnet,246,106272000,106303225,31226,29484,1742,0.05578684429641965,2021-11-11 06:15:55 UTC
781459,mainnet,246,106272000,106303408,31409,29653,1756,0.055907542424145945,2021-11-11 06:17:28 UTC
781460,mainnet,246,106272000,106303579,31580,29811,1769,0.05601646611779607,2021-11-11 06:19:01 UTC
781462,mainnet,246,106272000,106303750,31751,29970,1781,0.05609272148908696,2021-11-11 06:20:28 UTC
781463,mainnet,246,106272000,106303929,31930,30136,1794,0.05618540557469465,2021-11-11 06:21:53 UTC
781465,mainnet,246,106272000,106304104,32105,30307,1798,0.05600373773555521,2021-11-11 06:23:19 UTC
781466,mainnet,246,106272000,106304292,32293,30482,1811,0.056080265072926024,2021-11-11 06:24:49 UTC
781468,mainnet,246,106272000,106304460,32461,30645,1816,0.055944055944055944,2021-11-11 06:26:16 UTC
781469,mainnet,246,106272000,106304626,32627,30809,1818,0.05572072210132712,2021-11-11 06:27:43 UTC
781471,mainnet,246,106272000,106304791,32792,30968,1824,0.055623322761649184,2021-11-11 06:29:08 UTC
781472,mainnet,246,106272000,106304983,32984,31153,1831,0.055511763279165655,2021-11-11 06:30:45 UTC
781474,mainnet,246,106272000,106305144,33145,31305,1840,0.05551365213456026,2021-11-11 06:32:16 UTC
781475,mainnet,246,106272000,106305339,33340,31478,1862,0.055848830233953206,2021-11-11 06:33:42 UTC
781477,mainnet,246,106272000,106305509,33510,31639,1871,0.05583407937928976,2021-11-11 06:35:10 UTC
781478,mainnet,246,106272000,106305702,33703,31818,1885,0.05592973919235676,2021-11-11 06:36:49 UTC
781480,mainnet,246,106272000,106305860,33861,31975,1886,0.05569829597472018,2021-11-11 06:38:17 UTC
781481,mainnet,246,106272000,106306050,34051,32161,1890,0.05550497782737658,2021-11-11 06:39:56 UTC
781483,mainnet,246,106272000,106306224,34225,32320,1905,0.05566106647187728,2021-11-11 06:41:35 UTC
781484,mainnet,246,106272000,106306468,34469,32545,1924,0.05581827149032464,2021-11-11 06:43:19 UTC
781486,mainnet,246,106272000,106306625,34626,32701,1925,0.055594062265349735,2021-11-11 06:44:47 UTC
781487,mainnet,246,106272000,106306813,34814,32872,1942,0.055782156603665194,2021-11-11 06:46:13 UTC
781489,mainnet,246,106272000,106306996,34997,33041,1956,0.05589050490042004,2021-11-11 06:47:40 UTC
781490,mainnet,246,106272000,106307152,35153,33189,1964,0.05587005376497027,2021-11-11 06:49:07 UTC
781492,mainnet,246,106272000,106307324,35325,33352,1973,0.055852795470629865,2021-11-11 06:50:32 UTC
781493,mainnet,246,106272000,106307488,35489,33506,1983,0.05587646876496943,2021-11-11 06:51:57 UTC
781495,mainnet,246,106272000,106307671,35672,33687,1985,0.05564588472751738,2021-11-11 06:53:25 UTC
781496,mainnet,246,106272000,106307886,35887,33893,1994,0.05556329590102265,2021-11-11 06:55:23 UTC
781498,mainnet,246,106272000,106308075,36076,34073,2003,0.05552167646080497,2021-11-11 06:56:49 UTC
781499,mainnet,246,106272000,106308274,36275,34261,2014,0.05552033080634045,2021-11-11 06:58:25 UTC
781501,mainnet,246,106272000,106308472,36473,34450,2023,0.05546568694650838,2021-11-11 07:00:00 UTC
781502,mainnet,246,106272000,106308657,36658,34626,2032,0.055431283757979156,2021-11-11 07:01:32 UTC
781504,mainnet,246,106272000,106308840,36841,34805,2036,0.05526451507830949,2021-11-11 07:03:02 UTC
781505,mainnet,246,106272000,106309040,37041,34998,2043,0.05515509840447072,2021-11-11 07:04:39 UTC
781507,mainnet,246,106272000,106309209,37210,35151,2059,0.055334587476484814,2021-11-11 07:06:06 UTC
781508,mainnet,246,106272000,106309396,37397,35318,2079,0.055592694601171215,2021-11-11 07:07:37 UTC
781510,mainnet,246,106272000,106309568,37569,35490,2079,0.0553381777529346,2021-11-11 07:09:06 UTC
781511,mainnet,246,106272000,106309748,37749,35658,2091,0.055392195819756816,2021-11-11 07:10:38 UTC
781513,mainnet,246,106272000,106309947,37948,35854,2094,0.05518077369031306,2021-11-11 07:12:17 UTC
781514,mainnet,246,106272000,106310115,38116,36017,2099,0.05506873753804177,2021-11-11 07:13:42 UTC
781516,mainnet,246,106272000,106310296,38297,36176,2121,0.05538292816669713,2021-11-11 07:15:09 UTC
781517,mainnet,246,106272000,106310488,38489,36350,2139,0.055574319935566004,2021-11-11 07:16:46 UTC
781519,mainnet,246,106272000,106310672,38673,36525,2148,0.055542626638740204,2021-11-11 07:18:14 UTC
781520,mainnet,246,106272000,106310848,38849,36696,2153,0.05541970192282942,2021-11-11 07:19:43 UTC
781522,mainnet,246,106272000,106311014,39015,36850,2165,0.055491477636806355,2021-11-11 07:21:10 UTC
781523,mainnet,246,106272000,106311186,39187,37013,2174,0.0554775818511241,2021-11-11 07:22:46 UTC
781525,mainnet,246,106272000,106311347,39348,37170,2178,0.05535224153705398,2021-11-11 07:24:16 UTC
781526,mainnet,246,106272000,106311580,39581,37359,2222,0.05613804603218716,2021-11-11 07:25:46 UTC
781528,mainnet,246,106272000,106311743,39744,37506,2238,0.05631038647342995,2021-11-11 07:27:15 UTC
781529,mainnet,246,106272000,106311925,39926,37680,2246,0.056254070029554674,2021-11-11 07:28:43 UTC
781531,mainnet,246,106272000,106312103,40104,37853,2251,0.05612906443247556,2021-11-11 07:30:09 UTC
781532,mainnet,246,106272000,106312299,40300,38048,2252,0.05588089330024814,2021-11-11 07:31:47 UTC
781534,mainnet,246,106272000,106312465,40466,38203,2263,0.0559234913260515,2021-11-11 07:33:18 UTC
781535,mainnet,246,106272000,106312624,40625,38354,2271,0.05590153846153846,2021-11-11 07:34:44 UTC
781537,mainnet,246,106272000,106312826,40827,38539,2288,0.056041345188233276,2021-11-11 07:36:12 UTC
781538,mainnet,246,106272000,106312988,40989,38688,2301,0.056137012369172214,2021-11-11 07:37:41 UTC
781540,mainnet,246,106272000,106313171,41172,38864,2308,0.0560575148158943,2021-11-11 07:39:14 UTC
781541,mainnet,246,106272000,106313345,41346,39028,2318,0.0560634644221932,2021-11-11 07:40:46 UTC
781543,mainnet,246,106272000,106313529,41530,39203,2327,0.0560317842523477,2021-11-11 07:42:14 UTC
781544,mainnet,246,106272000,106313702,41703,39376,2327,0.05579934297292761,2021-11-11 07:43:41 UTC
781546,mainnet,246,106272000,106313895,41896,39563,2333,0.05568550696963911,2021-11-11 07:45:17 UTC
781547,mainnet,246,106272000,106314063,42064,39727,2337,0.05555819703309243,2021-11-11 07:46:46 UTC
781549,mainnet,246,106272000,106314239,42240,39895,2345,0.05551609848484849,2021-11-11 07:48:14 UTC
781550,mainnet,246,106272000,106314423,42424,40066,2358,0.05558174618140675,2021-11-11 07:49:45 UTC
781552,mainnet,246,106272000,106314612,42613,40242,2371,0.05564029756177692,2021-11-11 07:51:16 UTC
781553,mainnet,246,106272000,106314827,42828,40451,2377,0.05550107406369665,2021-11-11 07:53:06 UTC
781555,mainnet,246,106272000,106315052,43053,40667,2386,0.055420063642487166,2021-11-11 07:54:58 UTC
781556,mainnet,246,106272000,106315252,43253,40860,2393,0.05532564215198946,2021-11-11 07:56:39 UTC
781558,mainnet,246,106272000,106315428,43429,41015,2414,0.05558497777982454,2021-11-11 07:58:07 UTC
781559,mainnet,246,106272000,106315597,43598,41179,2419,0.05548419652277627,2021-11-11 07:59:36 UTC
781561,mainnet,246,106272000,106315790,43791,41359,2432,0.05553652577013542,2021-11-11 08:01:09 UTC
781562,mainnet,246,106272000,106315959,43960,41527,2433,0.05534576888080073,2021-11-11 08:02:36 UTC
781564,mainnet,246,106272000,106316128,44129,41684,2445,0.05540574225565954,2021-11-11 08:04:04 UTC
781565,mainnet,246,106272000,106316310,44311,41849,2462,0.055561824377694025,2021-11-11 08:05:31 UTC
781567,mainnet,246,106272000,106316471,44472,42000,2472,0.05558553696708041,2021-11-11 08:06:59 UTC
781568,mainnet,246,106272000,106316640,44641,42162,2479,0.0555319101274613,2021-11-11 08:08:26 UTC
781570,mainnet,246,106272000,106316774,44775,42289,2486,0.05552205471803462,2021-11-11 08:09:51 UTC
781571,mainnet,246,106272000,106317017,45018,42503,2515,0.055866542271980096,2021-11-11 08:11:43 UTC
781573,mainnet,246,106272000,106317199,45200,42678,2522,0.05579646017699115,2021-11-11 08:13:21 UTC
781574,mainnet,246,106272000,106317353,45354,42830,2524,0.055651100233716985,2021-11-11 08:14:49 UTC
781576,mainnet,246,106272000,106317537,45538,42993,2545,0.05588739075058193,2021-11-11 08:16:18 UTC
781577,mainnet,246,106272000,106317720,45721,43172,2549,0.05575118654447628,2021-11-11 08:17:49 UTC
781579,mainnet,246,106272000,106317920,45921,43366,2555,0.055639032251039826,2021-11-11 08:19:24 UTC
781580,mainnet,246,106272000,106318112,46113,43550,2563,0.05558085572398239,2021-11-11 08:20:54 UTC
781582,mainnet,246,106272000,106318270,46271,43696,2575,0.05565040738259385,2021-11-11 08:22:24 UTC
781583,mainnet,246,106272000,106318462,46463,43866,2597,0.05589393711124981,2021-11-11 08:23:53 UTC
781585,mainnet,246,106272000,106318625,46626,44010,2616,0.05610603525929739,2021-11-11 08:25:24 UTC
781586,mainnet,246,106272000,106318796,46797,44180,2617,0.05592238818727696,2021-11-11 08:26:55 UTC
781588,mainnet,246,106272000,106318961,46962,44343,2619,0.05576849367573783,2021-11-11 08:28:28 UTC
781589,mainnet,246,106272000,106319147,47148,44521,2627,0.05571816407907016,2021-11-11 08:30:03 UTC
781591,mainnet,246,106272000,106319336,47337,44700,2637,0.055706952278344636,2021-11-11 08:31:29 UTC
781592,mainnet,246,106272000,106319508,47509,44863,2646,0.05569471047590983,2021-11-11 08:32:56 UTC
781594,mainnet,246,106272000,106319691,47692,45029,2663,0.055837457015851716,2021-11-11 08:34:28 UTC
781595,mainnet,246,106272000,106319875,47876,45208,2668,0.055727295513409644,2021-11-11 08:36:07 UTC
781597,mainnet,246,106272000,106320046,48047,45376,2671,0.05559140008741441,2021-11-11 08:37:49 UTC
781598,mainnet,246,106272000,106320253,48254,45575,2679,0.05551871347453061,2021-11-11 08:39:28 UTC
781600,mainnet,246,106272000,106320447,48448,45751,2697,0.055667932628797885,2021-11-11 08:41:09 UTC
781601,mainnet,246,106272000,106320630,48631,45914,2717,0.05586971273467541,2021-11-11 08:42:43 UTC
781603,mainnet,246,106272000,106320811,48812,46079,2733,0.055990330246660655,2021-11-11 08:44:15 UTC
781604,mainnet,246,106272000,106320979,48980,46232,2748,0.05610453246222948,2021-11-11 08:45:44 UTC
781606,mainnet,246,106272000,106321075,49076,46326,2750,0.05603553671855897,2021-11-11 08:47:13 UTC
781607,mainnet,246,106272000,106321313,49314,46534,2780,0.05637344364683457,2021-11-11 08:48:43 UTC
781609,mainnet,246,106272000,106321508,49509,46719,2790,0.05635339029267406,2021-11-11 08:50:15 UTC
781610,mainnet,246,106272000,106321684,49685,46890,2795,0.05625440273724464,2021-11-11 08:51:43 UTC
781612,mainnet,246,106272000,106321831,49832,47012,2820,0.056590142880077056,2021-11-11 08:53:10 UTC
781613,mainnet,246,106272000,106322031,50032,47207,2825,0.05646386312759834,2021-11-11 08:54:51 UTC
781615,mainnet,246,106272000,106322194,50195,47360,2835,0.05647972905667895,2021-11-11 08:56:20 UTC
781616,mainnet,246,106272000,106322388,50389,47551,2838,0.05632181626942388,2021-11-11 08:58:00 UTC
781618,mainnet,246,106272000,106322570,50571,47723,2848,0.05631686144232861,2021-11-11 08:59:37 UTC
781619,mainnet,246,106272000,106322745,50746,47879,2867,0.05649706380798487,2021-11-11 09:01:10 UTC
781621,mainnet,246,106272000,106322912,50913,48041,2872,0.0564099542356569,2021-11-11 09:02:38 UTC
781622,mainnet,246,106272000,106323102,51103,48218,2885,0.056454611275267595,2021-11-11 09:04:15 UTC
781624,mainnet,246,106272000,106323280,51281,48391,2890,0.05635615530118367,2021-11-11 09:05:46 UTC
781625,mainnet,246,106272000,106323453,51454,48560,2894,0.056244412484938,2021-11-11 09:07:14 UTC
781627,mainnet,246,106272000,106323627,51628,48733,2895,0.056074223289687766,2021-11-11 09:08:42 UTC
781628,mainnet,246,106272000,106323802,51803,48898,2905,0.05607783333011602,2021-11-11 09:10:11 UTC
781630,mainnet,246,106272000,106323975,51976,49061,2915,0.056083577035554874,2021-11-11 09:12:00 UTC
781631,mainnet,246,106272000,106324200,52201,49271,2930,0.056129192927338555,2021-11-11 09:13:39 UTC
781633,mainnet,246,106272000,106324378,52379,49446,2933,0.05599572347696596,2021-11-11 09:15:08 UTC
781635,mainnet,246,106272000,106324569,52570,49632,2938,0.055887388244245766,2021-11-11 09:16:47 UTC
781636,mainnet,246,106272000,106324792,52793,49840,2953,0.05593544598715739,2021-11-11 09:18:44 UTC
781638,mainnet,246,106272000,106324950,52951,49996,2955,0.055806311495533605,2021-11-11 09:20:15 UTC
781639,mainnet,246,106272000,106325118,53119,50152,2967,0.05585572017545511,2021-11-11 09:21:42 UTC
781641,mainnet,246,106272000,106325280,53281,50302,2979,0.0559111127794148,2021-11-11 09:23:08 UTC
781642,mainnet,246,106272000,106325456,53457,50468,2989,0.05591409918252053,2021-11-11 09:24:47 UTC
781644,mainnet,246,106272000,106325665,53666,50673,2993,0.05577087914135579,2021-11-11 09:26:25 UTC
781645,mainnet,246,106272000,106325836,53837,50835,3002,0.055760907925775954,2021-11-11 09:27:55 UTC
781647,mainnet,246,106272000,106326062,54063,51052,3011,0.05569428259623033,2021-11-11 09:29:58 UTC
781648,mainnet,246,106272000,106326250,54251,51224,3027,0.05579620652153877,2021-11-11 09:31:29 UTC
781650,mainnet,246,106272000,106326479,54480,51425,3055,0.05607562408223201,2021-11-11 09:33:09 UTC
781651,mainnet,246,106272000,106326641,54642,51579,3063,0.05605578126715713,2021-11-11 09:34:40 UTC
781653,mainnet,246,106272000,106326849,54850,51774,3076,0.05608021877848678,2021-11-11 09:36:21 UTC
781654,mainnet,246,106272000,106327036,55037,51956,3081,0.05598052219416029,2021-11-11 09:37:52 UTC
781656,mainnet,246,106272000,106327212,55213,52127,3086,0.055892633981127635,2021-11-11 09:39:20 UTC
781657,mainnet,246,106272000,106327388,55389,52298,3091,0.05580530430229829,2021-11-11 09:40:49 UTC
781659,mainnet,246,106272000,106327556,55557,52460,3097,0.055744550641683314,2021-11-11 09:42:15 UTC
781660,mainnet,246,106272000,106327738,55739,52632,3107,0.05574194011374441,2021-11-11 09:43:42 UTC
781662,mainnet,246,106272000,106327902,55903,52793,3110,0.055632076990501406,2021-11-11 09:45:12 UTC
781663,mainnet,246,106272000,106328061,56062,52946,3116,0.055581320680674964,2021-11-11 09:46:41 UTC
781665,mainnet,246,106272000,106328240,56241,53117,3124,0.05554666524421685,2021-11-11 09:48:16 UTC
781666,mainnet,246,106272000,106328436,56437,53307,3130,0.055460070521112036,2021-11-11 09:49:42 UTC
781668,mainnet,246,106272000,106328643,56644,53510,3134,0.055328013558364524,2021-11-11 09:51:21 UTC
781669,mainnet,246,106272000,106328812,56813,53669,3144,0.05533944695756253,2021-11-11 09:52:48 UTC
781671,mainnet,246,106272000,106328997,56998,53852,3146,0.05519491911996912,2021-11-11 09:54:26 UTC
781672,mainnet,246,106272000,106329205,57206,54056,3150,0.055064154109708774,2021-11-11 09:55:57 UTC
781674,mainnet,246,106272000,106329396,57397,54243,3154,0.05495060717459101,2021-11-11 09:57:30 UTC
781675,mainnet,246,106272000,106329584,57585,54419,3166,0.054979595380741514,2021-11-11 09:59:00 UTC
781677,mainnet,246,106272000,106329786,57787,54616,3171,0.05487393358367799,2021-11-11 10:00:38 UTC
781678,mainnet,246,106272000,106329972,57973,54793,3180,0.05485312128059614,2021-11-11 10:02:15 UTC
781680,mainnet,246,106272000,106330151,58152,54968,3184,0.05475306094373367,2021-11-11 10:03:45 UTC
781681,mainnet,246,106272000,106330345,58346,55154,3192,0.05470812052240085,2021-11-11 10:05:22 UTC
781683,mainnet,246,106272000,106330521,58522,55316,3206,0.05478281671849903,2021-11-11 10:06:50 UTC
781684,mainnet,246,106272000,106330710,58711,55495,3216,0.05477678799543527,2021-11-11 10:08:21 UTC
781686,mainnet,246,106272000,106330893,58894,55674,3220,0.054674499949061026,2021-11-11 10:09:51 UTC
781687,mainnet,246,106272000,106331095,59096,55862,3234,0.05472451604169487,2021-11-11 10:11:32 UTC
781689,mainnet,246,106272000,106331278,59279,56041,3238,0.054623053695237775,2021-11-11 10:12:58 UTC
781690,mainnet,246,106272000,106331461,59462,56214,3248,0.054623120648481384,2021-11-11 10:14:26 UTC
781692,mainnet,246,106272000,106331636,59637,56388,3249,0.054479601589617184,2021-11-11 10:15:56 UTC
781693,mainnet,246,106272000,106331804,59805,56552,3253,0.05439344536409999,2021-11-11 10:17:23 UTC
781695,mainnet,246,106272000,106331965,59966,56707,3259,0.05434746356268552,2021-11-11 10:18:51 UTC
781696,mainnet,246,106272000,106332168,60169,56905,3264,0.05424720370955143,2021-11-11 10:20:30 UTC
781698,mainnet,246,106272000,106332341,60342,57066,3276,0.0542905438997713,2021-11-11 10:21:57 UTC
781699,mainnet,246,106272000,106332522,60523,57235,3288,0.0543264544057631,2021-11-11 10:23:26 UTC
781701,mainnet,246,106272000,106332688,60689,57395,3294,0.05427672230552489,2021-11-11 10:24:53 UTC
781702,mainnet,246,106272000,106332867,60868,57566,3302,0.05424853781954393,2021-11-11 10:26:21 UTC
781704,mainnet,246,106272000,106333054,61055,57746,3309,0.0541970354598313,2021-11-11 10:28:01 UTC
781705,mainnet,246,106272000,106333263,61264,57951,3313,0.05407743536171324,2021-11-11 10:29:32 UTC
781707,mainnet,246,106272000,106333424,61425,58109,3316,0.05398453398453398,2021-11-11 10:31:00 UTC
781708,mainnet,246,106272000,106333594,61595,58274,3321,0.053916714018995046,2021-11-11 10:32:29 UTC
781710,mainnet,246,106272000,106333777,61778,58448,3330,0.05390268380329567,2021-11-11 10:33:54 UTC
781711,mainnet,246,106272000,106333933,61934,58599,3335,0.053847644266477215,2021-11-11 10:35:21 UTC
781713,mainnet,246,106272000,106334118,62119,58771,3348,0.053896553389462164,2021-11-11 10:37:09 UTC
781714,mainnet,246,106272000,106334380,62381,59021,3360,0.053862554303393664,2021-11-11 10:38:50 UTC
781716,mainnet,246,106272000,106334455,62456,59096,3360,0.053797873703086974,2021-11-11 10:40:17 UTC
781717,mainnet,246,106272000,106334697,62698,59305,3393,0.05411655874190564,2021-11-11 10:41:43 UTC
781719,mainnet,246,106272000,106334794,62795,59383,3412,0.05433553626881121,2021-11-11 10:43:20 UTC
781720,mainnet,246,106272000,106335034,63035,59597,3438,0.05454112794479257,2021-11-11 10:44:48 UTC
781722,mainnet,246,106272000,106335202,63203,59754,3449,0.054570194452794964,2021-11-11 10:46:20 UTC
781723,mainnet,246,106272000,106335350,63351,59902,3449,0.054442708086691605,2021-11-11 10:47:49 UTC
781725,mainnet,246,106272000,106335540,63541,60084,3457,0.05440581671676555,2021-11-11 10:49:16 UTC
781726,mainnet,246,106272000,106335708,63709,60251,3458,0.05427804548807861,2021-11-11 10:50:44 UTC
781728,mainnet,246,106272000,106335915,63916,60454,3462,0.05416484135427749,2021-11-11 10:52:32 UTC
781730,mainnet,246,106272000,106336158,64159,60689,3470,0.05408438410823111,2021-11-11 10:54:31 UTC
781731,mainnet,246,106272000,106336352,64353,60883,3470,0.05392134010846425,2021-11-11 10:56:02 UTC
781733,mainnet,246,106272000,106336556,64557,61081,3476,0.05384388989575104,2021-11-11 10:57:50 UTC
781734,mainnet,246,106272000,106336732,64733,61255,3478,0.05372839201025752,2021-11-11 10:59:17 UTC
781736,mainnet,246,106272000,106336962,64963,61475,3488,0.05369210165786679,2021-11-11 11:01:17 UTC
781737,mainnet,246,106272000,106337137,65138,61634,3504,0.05379348460192207,2021-11-11 11:02:46 UTC
781739,mainnet,246,106272000,106337325,65326,61821,3505,0.05365398156935983,2021-11-11 11:04:25 UTC
781740,mainnet,246,106272000,106337486,65487,61960,3527,0.05385801762181807,2021-11-11 11:05:54 UTC
781742,mainnet,246,106272000,106337682,65683,62146,3537,0.0538495501119011,2021-11-11 11:07:21 UTC
781743,mainnet,246,106272000,106337858,65859,62316,3543,0.053796747597139344,2021-11-11 11:08:52 UTC
781745,mainnet,246,106272000,106338029,66030,62470,3560,0.05391488717249735,2021-11-11 11:10:21 UTC
781746,mainnet,246,106272000,106338205,66206,62632,3574,0.05398302268676555,2021-11-11 11:11:51 UTC
781748,mainnet,246,106272000,106338382,66383,62805,3578,0.053899341698928946,2021-11-11 11:13:21 UTC
781749,mainnet,246,106272000,106338549,66550,62959,3591,0.05395942900075131,2021-11-11 11:14:48 UTC
781751,mainnet,246,106272000,106338716,66717,63120,3597,0.05391429470749584,2021-11-11 11:16:19 UTC
781752,mainnet,246,106272000,106338910,66911,63302,3609,0.053937319723214416,2021-11-11 11:17:57 UTC
781754,mainnet,246,106272000,106339079,67080,63461,3619,0.0539505068574836,2021-11-11 11:19:25 UTC
781755,mainnet,246,106272000,106339248,67249,63629,3620,0.05382979672560187,2021-11-11 11:20:52 UTC
781757,mainnet,246,106272000,106339397,67398,63773,3625,0.0537849787827532,2021-11-11 11:22:20 UTC
781758,mainnet,246,106272000,106339576,67577,63940,3637,0.05382008671589446,2021-11-11 11:23:48 UTC
781760,mainnet,246,106272000,106339755,67756,64117,3639,0.05370742074502627,2021-11-11 11:25:26 UTC
781761,mainnet,246,106272000,106339918,67919,64265,3654,0.053799378671653,2021-11-11 11:27:02 UTC
781763,mainnet,246,106272000,106340108,68109,64449,3660,0.053737391534158484,2021-11-11 11:28:30 UTC
781764,mainnet,246,106272000,106340288,68289,64623,3666,0.05368360936607653,2021-11-11 11:30:00 UTC
781766,mainnet,246,106272000,106340453,68454,64783,3671,0.053627253338008,2021-11-11 11:31:31 UTC
781767,mainnet,246,106272000,106340631,68632,64938,3694,0.05382328942767222,2021-11-11 11:32:58 UTC
781769,mainnet,246,106272000,106340758,68759,65063,3696,0.05375296324844748,2021-11-11 11:34:26 UTC
781770,mainnet,246,106272000,106340963,68964,65252,3712,0.05382518415405139,2021-11-11 11:35:55 UTC
781772,mainnet,246,106272000,106341141,69142,65428,3714,0.05371554192820572,2021-11-11 11:37:23 UTC
781773,mainnet,246,106272000,106341345,69346,65628,3718,0.05361520491448678,2021-11-11 11:39:07 UTC
781775,mainnet,246,106272000,106341516,69517,65789,3728,0.05362717033243667,2021-11-11 11:40:34 UTC
781776,mainnet,246,106272000,106341678,69679,65937,3742,0.0537034113577979,2021-11-11 11:42:00 UTC
781778,mainnet,246,106272000,106341840,69841,66091,3750,0.053693389269913086,2021-11-11 11:43:26 UTC
781779,mainnet,246,106272000,106341998,69999,66243,3756,0.0536579093987057,2021-11-11 11:44:54 UTC
781781,mainnet,246,106272000,106342154,70155,66389,3766,0.05368113463046112,2021-11-11 11:46:25 UTC
781782,mainnet,246,106272000,106342317,70318,66539,3779,0.05374157399243437,2021-11-11 11:47:52 UTC
781784,mainnet,246,106272000,106342489,70490,66701,3789,0.053752305291530716,2021-11-11 11:49:21 UTC
781785,mainnet,246,106272000,106342656,70657,66862,3795,0.053710177335578924,2021-11-11 11:50:49 UTC
781787,mainnet,246,106272000,106342841,70842,67038,3804,0.05369695943084611,2021-11-11 11:52:35 UTC
781788,mainnet,246,106272000,106343075,71076,67266,3810,0.05360459226743204,2021-11-11 11:54:31 UTC
781790,mainnet,246,106272000,106343239,71240,67426,3814,0.05353733857383492,2021-11-11 11:56:28 UTC
781792,mainnet,246,106272000,106343520,71521,67694,3827,0.0535087596649935,2021-11-11 11:58:25 UTC
781793,mainnet,246,106272000,106343738,71739,67910,3829,0.053374036437642006,2021-11-11 12:00:18 UTC
781795,mainnet,246,106272000,106343913,71914,68076,3838,0.05336930222209862,2021-11-11 12:01:47 UTC
781796,mainnet,246,106272000,106344106,72107,68254,3853,0.05343447931546175,2021-11-11 12:03:23 UTC
781798,mainnet,246,106272000,106344319,72320,68457,3863,0.05341537610619469,2021-11-11 12:05:20 UTC
781799,mainnet,246,106272000,106344495,72496,68632,3864,0.0532994923857868,2021-11-11 12:06:57 UTC
781801,mainnet,246,106272000,106344690,72691,68804,3887,0.053472919618659805,2021-11-11 12:08:36 UTC
781802,mainnet,246,106272000,106344875,72876,68969,3907,0.05361161424886108,2021-11-11 12:10:03 UTC
781804,mainnet,246,106272000,106345044,73045,69126,3919,0.053651858443425286,2021-11-11 12:11:33 UTC
781805,mainnet,246,106272000,106345210,73211,69288,3923,0.05358484380762454,2021-11-11 12:13:09 UTC
781807,mainnet,246,106272000,106345394,73395,69437,3958,0.05392737924926766,2021-11-11 12:14:48 UTC
781809,mainnet,246,106272000,106345590,73591,69617,3974,0.054001168621162915,2021-11-11 12:16:39 UTC
781810,mainnet,246,106272000,106345789,73790,69815,3975,0.05386908795229706,2021-11-11 12:18:22 UTC
781812,mainnet,246,106272000,106345974,73975,69986,3989,0.05392362284555593,2021-11-11 12:20:04 UTC
781813,mainnet,246,106272000,106346139,74140,70139,4001,0.05396547073104937,2021-11-11 12:21:38 UTC
781815,mainnet,246,106272000,106346302,74303,70294,4009,0.053954752836359234,2021-11-11 12:23:07 UTC
781816,mainnet,246,106272000,106346466,74467,70445,4022,0.05401050129587603,2021-11-11 12:24:41 UTC
781818,mainnet,246,106272000,106346632,74633,70603,4030,0.053997561400452886,2021-11-11 12:26:14 UTC
781819,mainnet,246,106272000,106346800,74801,70748,4053,0.054183767596689886,2021-11-11 12:27:41 UTC
781821,mainnet,246,106272000,106346956,74957,70903,4054,0.05408434168923516,2021-11-11 12:29:07 UTC
781822,mainnet,246,106272000,106347138,75139,71080,4059,0.054019883149895524,2021-11-11 12:30:39 UTC
781823,mainnet,246,106272000,106347272,75273,71201,4072,0.05409642235595765,2021-11-11 12:32:08 UTC
781825,mainnet,246,106272000,106347437,75438,71347,4091,0.05422996367878258,2021-11-11 12:33:35 UTC
781826,mainnet,246,106272000,106347600,75601,71495,4106,0.05431145090673404,2021-11-11 12:35:07 UTC
781828,mainnet,246,106272000,106347785,75786,71670,4116,0.05431082257936822,2021-11-11 12:36:44 UTC
781829,mainnet,246,106272000,106347964,75965,71832,4133,0.05440663463437109,2021-11-11 12:38:10 UTC
781831,mainnet,246,106272000,106348168,76169,72012,4157,0.054576008612427625,2021-11-11 12:39:51 UTC
781833,mainnet,246,106272000,106348337,76338,72175,4163,0.05453378396080589,2021-11-11 12:41:27 UTC
781834,mainnet,246,106272000,106348482,76483,72310,4173,0.054561144306577936,2021-11-11 12:42:55 UTC
781836,mainnet,246,106272000,106348672,76673,72483,4190,0.05464765954116834,2021-11-11 12:44:24 UTC
781837,mainnet,246,106272000,106348844,76845,72642,4203,0.054694514932656646,2021-11-11 12:45:50 UTC
781838,mainnet,246,106272000,106349024,77025,72812,4213,0.05469652710159039,2021-11-11 12:47:21 UTC
781840,mainnet,246,106272000,106349206,77207,72988,4219,0.054645304182263266,2021-11-11 12:49:02 UTC
781842,mainnet,246,106272000,106349395,77396,73165,4231,0.054666907850534914,2021-11-11 12:50:38 UTC
781843,mainnet,246,106272000,106349568,77569,73325,4244,0.054712578478515905,2021-11-11 12:52:04 UTC
781845,mainnet,246,106272000,106349720,77721,73451,4270,0.05494010627758263,2021-11-11 12:53:32 UTC
781846,mainnet,246,106272000,106349888,77889,73592,4297,0.05516825225641618,2021-11-11 12:55:01 UTC
781847,mainnet,246,106272000,106350063,78064,73755,4309,0.05519829883172781,2021-11-11 12:56:27 UTC
781849,mainnet,246,106272000,106350213,78214,73901,4313,0.05514358043317053,2021-11-11 12:57:59 UTC
781850,mainnet,246,106272000,106350395,78396,74073,4323,0.055143119546915656,2021-11-11 12:59:36 UTC
781852,mainnet,246,106272000,106350654,78655,74313,4342,0.05520310215498061,2021-11-11 13:01:50 UTC
781853,mainnet,246,106272000,106350850,78851,74500,4351,0.05518002308150816,2021-11-11 13:03:26 UTC
781854,mainnet,246,106272000,106351028,79029,74666,4363,0.0552075820268509,2021-11-11 13:04:58 UTC
781856,mainnet,246,106272000,106351222,79223,74852,4371,0.055173371369425545,2021-11-11 13:06:34 UTC
781857,mainnet,246,106272000,106351408,79409,75022,4387,0.05524562706997947,2021-11-11 13:08:11 UTC
781859,mainnet,246,106272000,106351567,79568,75173,4395,0.05523577317514579,2021-11-11 13:09:43 UTC
781861,mainnet,246,106272000,106351736,79737,75319,4418,0.0554071510089419,2021-11-11 13:11:37 UTC
781862,mainnet,246,106272000,106351995,79996,75564,4432,0.055402770138506925,2021-11-11 13:13:28 UTC
781863,mainnet,246,106272000,106352194,80195,75751,4444,0.05541492611758838,2021-11-11 13:15:05 UTC
781865,mainnet,246,106272000,106352388,80389,75937,4452,0.05538071129134583,2021-11-11 13:16:53 UTC
781867,mainnet,246,106272000,106352607,80608,76145,4463,0.055366712981341805,2021-11-11 13:18:41 UTC
781868,mainnet,246,106272000,106352855,80856,76377,4479,0.05539477589789255,2021-11-11 13:20:50 UTC
781870,mainnet,246,106272000,106352964,80965,76465,4500,0.05557957141974927,2021-11-11 13:22:22 UTC
781871,mainnet,246,106272000,106353194,81195,76669,4526,0.05574234866678983,2021-11-11 13:24:04 UTC
781873,mainnet,246,106272000,106353339,81340,76811,4529,0.05567986230636833,2021-11-11 13:25:36 UTC
781874,mainnet,246,106272000,106353552,81553,76997,4556,0.05586551077213591,2021-11-11 13:27:25 UTC
781876,mainnet,246,106272000,106353734,81735,77161,4574,0.055961338471890866,2021-11-11 13:28:55 UTC
781877,mainnet,246,106272000,106353940,81941,77365,4576,0.055845059249948134,2021-11-11 13:30:44 UTC
781879,mainnet,246,106272000,106354141,82142,77554,4588,0.05585449587300041,2021-11-11 13:32:32 UTC
781880,mainnet,246,106272000,106354292,82293,77694,4599,0.055885676789034305,2021-11-11 13:34:02 UTC
781882,mainnet,246,106272000,106354513,82514,77907,4607,0.05583294956007465,2021-11-11 13:35:53 UTC
781883,mainnet,246,106272000,106354687,82688,78073,4615,0.055812209752321984,2021-11-11 13:37:22 UTC
781885,mainnet,246,106272000,106354856,82857,78227,4630,0.05587940668863222,2021-11-11 13:39:03 UTC
781886,mainnet,246,106272000,106355027,83028,78374,4654,0.05605337958279135,2021-11-11 13:40:36 UTC
781888,mainnet,246,106272000,106355221,83222,78549,4673,0.056151017759726994,2021-11-11 13:42:17 UTC
781890,mainnet,246,106272000,106355412,83413,78729,4684,0.05615431647345138,2021-11-11 13:43:59 UTC
781891,mainnet,246,106272000,106355592,83593,78908,4685,0.05604536264998265,2021-11-11 13:45:37 UTC
781893,mainnet,246,106272000,106355760,83761,79065,4696,0.056064278124664225,2021-11-11 13:47:09 UTC
781894,mainnet,246,106272000,106355936,83937,79216,4721,0.0562445643756627,2021-11-11 13:48:49 UTC
781896,mainnet,246,106272000,106356123,84124,79399,4725,0.05616708668156531,2021-11-11 13:50:29 UTC
781897,mainnet,246,106272000,106356296,84297,79567,4730,0.05611113088247506,2021-11-11 13:51:57 UTC
781899,mainnet,246,106272000,106356481,84482,79751,4731,0.05600009469472787,2021-11-11 13:53:25 UTC
781900,mainnet,246,106272000,106356653,84654,79915,4739,0.05598081602759468,2021-11-11 13:54:55 UTC
781902,mainnet,246,106272000,106356807,84808,80066,4742,0.055914536364493915,2021-11-11 13:56:24 UTC
781903,mainnet,246,106272000,106357015,85016,80259,4757,0.055954173332078666,2021-11-11 13:58:04 UTC
781905,mainnet,246,106272000,106357181,85182,80415,4767,0.05596252729449884,2021-11-11 13:59:33 UTC
781906,mainnet,246,106272000,106357337,85338,80561,4777,0.05597740748552814,2021-11-11 14:01:05 UTC
781908,mainnet,246,106272000,106357502,85503,80711,4792,0.05604481714091903,2021-11-11 14:02:37 UTC
781909,mainnet,246,106272000,106357652,85653,80840,4813,0.0561918438350087,2021-11-11 14:04:06 UTC
781910,mainnet,246,106272000,106357807,85808,80982,4826,0.056241842252470635,2021-11-11 14:05:39 UTC
781912,mainnet,246,106272000,106357981,85982,81144,4838,0.05626759089111674,2021-11-11 14:07:18 UTC
781913,mainnet,246,106272000,106358132,86133,81278,4855,0.05636631720710993,2021-11-11 14:08:49 UTC
781915,mainnet,246,106272000,106358274,86275,81399,4876,0.0565169516082295,2021-11-11 14:10:21 UTC
781916,mainnet,246,106272000,106358432,86433,81538,4895,0.056633461756505035,2021-11-11 14:11:53 UTC
781918,mainnet,246,106272000,106358586,86587,81683,4904,0.05663667756129673,2021-11-11 14:13:34 UTC
781920,mainnet,246,106272000,106358769,86770,81828,4942,0.0569551688371557,2021-11-11 14:15:16 UTC
781921,mainnet,246,106272000,106358932,86933,81970,4963,0.05708994282953539,2021-11-11 14:16:56 UTC
781923,mainnet,246,106272000,106359139,87140,82170,4970,0.05703465687399587,2021-11-11 14:18:36 UTC
781924,mainnet,246,106272000,106359390,87391,82405,4986,0.05705393003856232,2021-11-11 14:20:53 UTC
781926,mainnet,246,106272000,106359565,87566,82560,5006,0.05716830733389672,2021-11-11 14:22:29 UTC
781927,mainnet,246,106272000,106359719,87720,82702,5018,0.057204742362061106,2021-11-11 14:23:57 UTC
781929,mainnet,246,106272000,106359876,87877,82842,5035,0.057295993263311217,2021-11-11 14:25:38 UTC
781930,mainnet,246,106272000,106360031,88032,82973,5059,0.05746773900399855,2021-11-11 14:27:10 UTC
781932,mainnet,246,106272000,106360212,88213,83136,5077,0.057553875279153864,2021-11-11 14:28:41 UTC
781933,mainnet,246,106272000,106360392,88393,83308,5085,0.05752717975405292,2021-11-11 14:30:18 UTC
781935,mainnet,246,106272000,106360552,88553,83453,5100,0.05759262814359762,2021-11-11 14:31:49 UTC
781936,mainnet,246,106272000,106360716,88717,83600,5117,0.05767778441561369,2021-11-11 14:33:17 UTC
781938,mainnet,246,106272000,106360916,88917,83773,5144,0.05785170439848398,2021-11-11 14:35:14 UTC
781939,mainnet,246,106272000,106361095,89096,83929,5167,0.05799362485408997,2021-11-11 14:36:49 UTC
781941,mainnet,246,106272000,106361277,89278,84101,5177,0.0579874101122337,2021-11-11 14:38:28 UTC
781943,mainnet,246,106272000,106361431,89432,84247,5185,0.05797701046605242,2021-11-11 14:40:10 UTC
781944,mainnet,246,106272000,106361614,89615,84415,5200,0.05802600011158846,2021-11-11 14:42:17 UTC
781946,mainnet,246,106272000,106361853,89854,84644,5210,0.05798295011908207,2021-11-11 14:44:13 UTC
781947,mainnet,246,106272000,106361998,89999,84781,5218,0.05797842198246647,2021-11-11 14:45:46 UTC
781948,mainnet,246,106272000,106362176,90177,84921,5256,0.05828537210153365,2021-11-11 14:47:12 UTC
781950,mainnet,246,106272000,106362347,90348,85087,5261,0.058230398016558195,2021-11-11 14:48:45 UTC
781951,mainnet,246,106272000,106362528,90529,85262,5267,0.0581802516320737,2021-11-11 14:50:18 UTC
781953,mainnet,246,106272000,106362771,90772,85488,5284,0.05821178336932094,2021-11-11 14:52:36 UTC
781955,mainnet,246,106272000,106362973,90974,85660,5314,0.05841229362235364,2021-11-11 14:54:05 UTC
781956,mainnet,246,106272000,106363147,91148,85820,5328,0.058454381884407776,2021-11-11 14:55:34 UTC
781958,mainnet,246,106272000,106363296,91297,85963,5334,0.05842470179743037,2021-11-11 14:57:13 UTC
781959,mainnet,246,106272000,106363486,91487,86145,5342,0.05839080962322516,2021-11-11 14:58:55 UTC
781960,mainnet,246,106272000,106363653,91654,86291,5363,0.058513540052807296,2021-11-11 15:00:32 UTC
781962,mainnet,246,106272000,106363830,91831,86446,5385,0.05864032842939748,2021-11-11 15:02:13 UTC
781963,mainnet,246,106272000,106363991,91992,86592,5400,0.05870075658752935,2021-11-11 15:03:52 UTC
781965,mainnet,246,106272000,106364163,92164,86759,5405,0.05864545809643679,2021-11-11 15:05:21 UTC
781967,mainnet,246,106272000,106364356,92357,86949,5408,0.05855538833006702,2021-11-11 15:07:03 UTC
781968,mainnet,246,106272000,106364507,92508,87081,5427,0.05866519652354391,2021-11-11 15:08:32 UTC
781969,mainnet,246,106272000,106364668,92669,87230,5439,0.05869276672889531,2021-11-11 15:09:58 UTC
781971,mainnet,246,106272000,106364848,92849,87398,5451,0.058708225182823724,2021-11-11 15:11:30 UTC
781972,mainnet,246,106272000,106365006,93007,87549,5458,0.058683754986183834,2021-11-11 15:12:59 UTC
781974,mainnet,246,106272000,106365150,93151,87691,5460,0.05861450762740067,2021-11-11 15:14:27 UTC
781975,mainnet,246,106272000,106365344,93345,87867,5478,0.05868552145267556,2021-11-11 15:16:05 UTC
781977,mainnet,246,106272000,106365534,93535,88033,5502,0.05882290051852248,2021-11-11 15:17:43 UTC
781978,mainnet,246,106272000,106365694,93695,88184,5511,0.05881850685735632,2021-11-11 15:19:12 UTC
781980,mainnet,246,106272000,106365874,93875,88348,5527,0.05887616511318242,2021-11-11 15:20:41 UTC
781981,mainnet,246,106272000,106366048,94049,88519,5530,0.05879913662027241,2021-11-11 15:22:11 UTC
781983,mainnet,246,106272000,106366209,94210,88663,5547,0.05887909988323957,2021-11-11 15:23:40 UTC
781984,mainnet,246,106272000,106366329,94330,88772,5558,0.05892080992261211,2021-11-11 15:25:07 UTC
781986,mainnet,246,106272000,106366511,94512,88938,5574,0.058976637887252416,2021-11-11 15:26:36 UTC
781987,mainnet,246,106272000,106366692,94693,89105,5588,0.059011753772718153,2021-11-11 15:28:06 UTC
781989,mainnet,246,106272000,106366855,94856,89262,5594,0.058973602091591464,2021-11-11 15:29:37 UTC
781990,mainnet,246,106272000,106367040,95041,89433,5608,0.059006113151166335,2021-11-11 15:31:08 UTC
781992,mainnet,246,106272000,106367176,95177,89560,5617,0.05901635899429484,2021-11-11 15:32:47 UTC
781993,mainnet,246,106272000,106367392,95393,89742,5651,0.05923914752654807,2021-11-11 15:34:16 UTC
781995,mainnet,246,106272000,106367538,95539,89877,5662,0.05926375616240488,2021-11-11 15:35:46 UTC
781996,mainnet,246,106272000,106367724,95725,90040,5685,0.059388874379733614,2021-11-11 15:37:19 UTC
781998,mainnet,246,106272000,106367882,95883,90182,5701,0.05945788095908555,2021-11-11 15:38:46 UTC
781999,mainnet,246,106272000,106368086,96087,90372,5715,0.05947734865278342,2021-11-11 15:40:38 UTC
782001,mainnet,246,106272000,106368254,96255,90531,5724,0.059467040673211784,2021-11-11 15:42:06 UTC
782002,mainnet,246,106272000,106368401,96402,90659,5743,0.05957345283292878,2021-11-11 15:43:35 UTC
782004,mainnet,246,106272000,106368590,96591,90842,5749,0.05951900280564442,2021-11-11 15:45:18 UTC
782005,mainnet,246,106272000,106368749,96750,90980,5770,0.05963824289405685,2021-11-11 15:46:46 UTC
782007,mainnet,246,106272000,106368913,96914,91135,5779,0.05963018758899643,2021-11-11 15:48:15 UTC
782008,mainnet,246,106272000,106369067,97068,91284,5784,0.05958709358387934,2021-11-11 15:49:43 UTC
782010,mainnet,246,106272000,106369252,97253,91447,5806,0.05969995784191747,2021-11-11 15:51:17 UTC
782011,mainnet,246,106272000,106369400,97401,91582,5819,0.0597427131138284,2021-11-11 15:52:46 UTC
782013,mainnet,246,106272000,106369592,97593,91756,5837,0.0598096174930579,2021-11-11 15:54:14 UTC
782014,mainnet,246,106272000,106369739,97740,91898,5842,0.05977082054430121,2021-11-11 15:55:41 UTC
782016,mainnet,246,106272000,106369939,97940,92080,5860,0.05983255054114764,2021-11-11 15:57:23 UTC
782017,mainnet,246,106272000,106370123,98124,92247,5877,0.05989360401125107,2021-11-11 15:58:55 UTC
782019,mainnet,246,106272000,106370330,98331,92454,5877,0.059767519907252036,2021-11-11 16:00:54 UTC
782020,mainnet,246,106272000,106370488,98489,92600,5889,0.05979347947486521,2021-11-11 16:02:26 UTC
782022,mainnet,246,106272000,106370707,98708,92805,5903,0.05980265024111521,2021-11-11 16:04:19 UTC
782023,mainnet,246,106272000,106370900,98901,92981,5920,0.05985783763561541,2021-11-11 16:06:12 UTC
782025,mainnet,246,106272000,106371089,99090,93142,5948,0.06002623877283278,2021-11-11 16:07:45 UTC
782026,mainnet,246,106272000,106371244,99245,93281,5964,0.06009370749156129,2021-11-11 16:09:16 UTC
782028,mainnet,246,106272000,106371395,99396,93425,5971,0.06007283995331804,2021-11-11 16:10:44 UTC
782029,mainnet,246,106272000,106371576,99577,93591,5986,0.06011428341886178,2021-11-11 16:12:31 UTC
782031,mainnet,246,106272000,106371777,99778,93762,6016,0.060293852352221934,2021-11-11 16:14:10 UTC
782032,mainnet,246,106272000,106371972,99973,93955,6018,0.060196252988306845,2021-11-11 16:15:49 UTC
782034,mainnet,246,106272000,106372173,100174,94149,6025,0.06014534709605287,2021-11-11 16:18:00 UTC
782036,mainnet,246,106272000,106372438,100439,94396,6043,0.06016587182269836,2021-11-11 16:19:57 UTC
782037,mainnet,246,106272000,106372604,100605,94557,6048,0.060116296406739225,2021-11-11 16:21:30 UTC
782039,mainnet,246,106272000,106372784,100785,94733,6052,0.060048618345984024,2021-11-11 16:22:59 UTC
782040,mainnet,246,106272000,106372958,100959,94897,6062,0.060044176348814864,2021-11-11 16:24:30 UTC
782042,mainnet,246,106272000,106373122,101123,95056,6067,0.059996242200092954,2021-11-11 16:25:55 UTC
782043,mainnet,246,106272000,106373284,101285,95202,6083,0.06005825146862813,2021-11-11 16:27:25 UTC
782045,mainnet,246,106272000,106373457,101458,95367,6091,0.060034694159159456,2021-11-11 16:28:53 UTC
782046,mainnet,246,106272000,106373627,101628,95533,6095,0.05997362931475578,2021-11-11 16:30:22 UTC
782048,mainnet,246,106272000,106373787,101788,95691,6097,0.05989900577671238,2021-11-11 16:31:54 UTC
782049,mainnet,246,106272000,106373957,101958,95853,6105,0.059877596657447185,2021-11-11 16:33:22 UTC
782051,mainnet,246,106272000,106374096,102097,95983,6114,0.059884227744204044,2021-11-11 16:34:51 UTC
782052,mainnet,246,106272000,106374289,102290,96158,6132,0.05994720891582755,2021-11-11 16:36:39 UTC
782054,mainnet,246,106272000,106374435,102436,96290,6146,0.05999843804912335,2021-11-11 16:38:07 UTC
782055,mainnet,246,106272000,106374628,102629,96463,6166,0.06008048407370237,2021-11-11 16:39:38 UTC
782057,mainnet,246,106272000,106374792,102793,96621,6172,0.0600429990368994,2021-11-11 16:41:07 UTC
782058,mainnet,246,106272000,106374955,102956,96780,6176,0.05998679047360037,2021-11-11 16:42:34 UTC
782060,mainnet,246,106272000,106375139,103140,96954,6186,0.05997673065735893,2021-11-11 16:44:11 UTC
782061,mainnet,246,106272000,106375326,103327,97132,6195,0.05995528758214213,2021-11-11 16:45:51 UTC
782063,mainnet,246,106272000,106375496,103497,97302,6195,0.05985680744369402,2021-11-11 16:47:23 UTC
782064,mainnet,246,106272000,106375673,103674,97467,6207,0.05987036286822154,2021-11-11 16:48:50 UTC
782066,mainnet,246,106272000,106375836,103837,97615,6222,0.059920837466413704,2021-11-11 16:50:21 UTC
782067,mainnet,246,106272000,106376016,104017,97779,6238,0.059970966284357365,2021-11-11 16:52:01 UTC
782069,mainnet,246,106272000,106376202,104203,97959,6244,0.0599214993810159,2021-11-11 16:53:40 UTC
782070,mainnet,246,106272000,106376392,104393,98145,6248,0.059850756276761855,2021-11-11 16:55:22 UTC
782072,mainnet,246,106272000,106376572,104573,98309,6264,0.05990073919654213,2021-11-11 16:57:00 UTC
782073,mainnet,246,106272000,106376726,104727,98454,6273,0.05989859348592053,2021-11-11 16:58:28 UTC
782075,mainnet,246,106272000,106376919,104920,98639,6281,0.05986465878764773,2021-11-11 17:00:06 UTC
782076,mainnet,246,106272000,106377084,105085,98802,6283,0.0597896940571918,2021-11-11 17:01:46 UTC
782078,mainnet,246,106272000,106377284,105285,98990,6295,0.05979009355558722,2021-11-11 17:03:24 UTC
782079,mainnet,246,106272000,106377479,105480,99179,6301,0.05973644292756921,2021-11-11 17:05:12 UTC
782081,mainnet,246,106272000,106377656,105657,99346,6311,0.05973101640213142,2021-11-11 17:06:39 UTC
782082,mainnet,246,106272000,106377834,105835,99508,6327,0.05978173572069731,2021-11-11 17:08:09 UTC
782084,mainnet,246,106272000,106378013,106014,99681,6333,0.05973739317448639,2021-11-11 17:09:43 UTC
782085,mainnet,246,106272000,106378191,106192,99847,6345,0.05975026367334639,2021-11-11 17:11:11 UTC
782087,mainnet,246,106272000,106378350,106351,100005,6346,0.05967033690327313,2021-11-11 17:12:38 UTC
782088,mainnet,246,106272000,106378508,106509,100150,6359,0.05970387478992386,2021-11-11 17:14:07 UTC
782090,mainnet,246,106272000,106378685,106686,100305,6381,0.05981103425004218,2021-11-11 17:15:33 UTC
782091,mainnet,246,106272000,106378883,106884,100485,6399,0.05986864264061974,2021-11-11 17:17:24 UTC
782093,mainnet,246,106272000,106379051,107052,100646,6406,0.05984007771923925,2021-11-11 17:18:54 UTC
782094,mainnet,246,106272000,106379215,107216,100800,6416,0.059841814654529174,2021-11-11 17:20:32 UTC
782096,mainnet,246,106272000,106379494,107495,101059,6436,0.05987255221173078,2021-11-11 17:22:39 UTC
782098,mainnet,246,106272000,106379731,107732,101284,6448,0.05985222589388482,2021-11-11 17:24:35 UTC
782099,mainnet,246,106272000,106379924,107925,101474,6451,0.05977299050266389,2021-11-11 17:26:19 UTC
782101,mainnet,246,106272000,106380101,108102,101638,6464,0.059795378438881795,2021-11-11 17:27:46 UTC
782102,mainnet,246,106272000,106380300,108301,101819,6482,0.059851709587169094,2021-11-11 17:29:37 UTC
782104,mainnet,246,106272000,106380480,108481,101987,6494,0.05986301748693319,2021-11-11 17:31:08 UTC
782105,mainnet,246,106272000,106380667,108668,102169,6499,0.05980601465012699,2021-11-11 17:33:02 UTC
782107,mainnet,246,106272000,106380898,108899,102381,6518,0.059853625836784545,2021-11-11 17:34:53 UTC
782108,mainnet,246,106272000,106381090,109091,102556,6535,0.059904116746569376,2021-11-11 17:36:28 UTC
782110,mainnet,246,106272000,106381289,109290,102750,6540,0.05984079055723305,2021-11-11 17:38:15 UTC
782112,mainnet,246,106272000,106381487,109488,102932,6556,0.05987870816893175,2021-11-11 17:40:08 UTC
782113,mainnet,246,106272000,106381710,109711,103119,6592,0.06008513275788207,2021-11-11 17:41:54 UTC
782115,mainnet,246,106272000,106381889,109890,103277,6613,0.06017836017836018,2021-11-11 17:43:32 UTC
782116,mainnet,246,106272000,106382095,110096,103457,6639,0.06030191832582474,2021-11-11 17:45:13 UTC
782118,mainnet,246,106272000,106382268,110269,103621,6648,0.06028892979894621,2021-11-11 17:46:43 UTC
782119,mainnet,246,106272000,106382440,110441,103791,6650,0.06021314548039224,2021-11-11 17:48:22 UTC
782121,mainnet,246,106272000,106382617,110618,103957,6661,0.06021623967166284,2021-11-11 17:49:51 UTC
782122,mainnet,246,106272000,106382776,110777,104101,6676,0.060265217509049715,2021-11-11 17:51:23 UTC
782124,mainnet,246,106272000,106382941,110942,104264,6678,0.06019361468154531,2021-11-11 17:52:53 UTC
782125,mainnet,246,106272000,106383114,111115,104431,6684,0.06015389461368852,2021-11-11 17:54:22 UTC
782127,mainnet,246,106272000,106383268,111269,104580,6689,0.06011557576683533,2021-11-11 17:55:48 UTC
782128,mainnet,246,106272000,106383459,111460,104760,6700,0.06011125067288713,2021-11-11 17:57:30 UTC
782130,mainnet,246,106272000,106383608,111609,104896,6713,0.06014747914594701,2021-11-11 17:58:57 UTC
782131,mainnet,246,106272000,106383787,111788,105057,6731,0.06021218735463556,2021-11-11 18:00:31 UTC
782133,mainnet,246,106272000,106383934,111935,105183,6752,0.06032072184750078,2021-11-11 18:01:59 UTC
782134,mainnet,246,106272000,106384103,112104,105343,6761,0.06031006922143724,2021-11-11 18:03:27 UTC
782136,mainnet,246,106272000,106384246,112247,105484,6763,0.06025105348027119,2021-11-11 18:04:57 UTC
782137,mainnet,246,106272000,106384410,112411,105632,6779,0.06030548611790661,2021-11-11 18:06:23 UTC
782139,mainnet,246,106272000,106384555,112556,105769,6787,0.06029887344966061,2021-11-11 18:07:50 UTC
782140,mainnet,246,106272000,106384706,112707,105910,6797,0.06030681324141358,2021-11-11 18:09:18 UTC
782142,mainnet,246,106272000,106384888,112889,106070,6819,0.06040446810583848,2021-11-11 18:10:56 UTC
782143,mainnet,246,106272000,106385056,113057,106219,6838,0.060482765330762356,2021-11-11 18:12:26 UTC
782145,mainnet,246,106272000,106385224,113225,106382,6843,0.060437182601015674,2021-11-11 18:14:06 UTC
782146,mainnet,246,106272000,106385404,113405,106553,6852,0.060420616374939375,2021-11-11 18:15:33 UTC
782148,mainnet,246,106272000,106385614,113615,106751,6864,0.060414557936892134,2021-11-11 18:17:12 UTC
782149,mainnet,246,106272000,106385772,113773,106906,6867,0.0603570267110826,2021-11-11 18:18:39 UTC
782151,mainnet,246,106272000,106385940,113941,107069,6872,0.06031191581608025,2021-11-11 18:20:09 UTC
782152,mainnet,246,106272000,106386107,114108,107215,6893,0.06040768394853998,2021-11-11 18:21:38 UTC
782153,mainnet,246,106272000,106386265,114266,107367,6899,0.06037666497470814,2021-11-11 18:23:08 UTC
782155,mainnet,246,106272000,106386427,114428,107520,6908,0.06036983954976055,2021-11-11 18:24:34 UTC
782157,mainnet,246,106272000,106386598,114599,107686,6913,0.06032338851124355,2021-11-11 18:26:15 UTC
782158,mainnet,246,106272000,106386768,114769,107834,6935,0.06042572471660466,2021-11-11 18:27:43 UTC
782159,mainnet,246,106272000,106386910,114911,107966,6945,0.06043807816484061,2021-11-11 18:29:12 UTC
782161,mainnet,246,106272000,106387085,115086,108129,6957,0.060450445753610346,2021-11-11 18:30:44 UTC
782162,mainnet,246,106272000,106387250,115251,108277,6974,0.060511405540949754,2021-11-11 18:32:15 UTC
782164,mainnet,246,106272000,106387424,115425,108446,6979,0.06046350444011263,2021-11-11 18:33:45 UTC
782166,mainnet,246,106272000,106387593,115594,108609,6985,0.06042701178261847,2021-11-11 18:35:35 UTC
782167,mainnet,246,106272000,106387768,115769,108764,7005,0.060508426262643716,2021-11-11 18:37:04 UTC
782169,mainnet,246,106272000,106387977,115978,108966,7012,0.06045974236493128,2021-11-11 18:38:55 UTC
782170,mainnet,246,106272000,106388160,116161,109139,7022,0.06045058152047589,2021-11-11 18:40:38 UTC
782172,mainnet,246,106272000,106388331,116332,109299,7033,0.060456280301206894,2021-11-11 18:42:10 UTC
782173,mainnet,246,106272000,106388507,116508,109460,7048,0.06049370000343324,2021-11-11 18:43:41 UTC
782175,mainnet,246,106272000,106388704,116705,109638,7067,0.06055438927209631,2021-11-11 18:45:20 UTC
782176,mainnet,246,106272000,106388872,116873,109786,7087,0.060638470818751976,2021-11-11 18:46:51 UTC
782178,mainnet,246,106272000,106389063,117064,109964,7100,0.06065058429576983,2021-11-11 18:48:23 UTC
782179,mainnet,246,106272000,106389197,117198,110091,7107,0.06064096656939538,2021-11-11 18:49:54 UTC
782181,mainnet,246,106272000,106389422,117423,110283,7140,0.06080580465496538,2021-11-11 18:51:33 UTC
782182,mainnet,246,106272000,106389596,117597,110443,7154,0.06083488524367118,2021-11-11 18:53:01 UTC
782184,mainnet,246,106272000,106389739,117740,110561,7179,0.06097333106845592,2021-11-11 18:54:42 UTC
782185,mainnet,246,106272000,106389876,117877,110672,7205,0.0611230350280377,2021-11-11 18:56:38 UTC
782187,mainnet,246,106272000,106390193,118194,110964,7230,0.06117061779785776,2021-11-11 18:58:56 UTC
782189,mainnet,246,106272000,106390441,118442,111199,7243,0.061152293949781326,2021-11-11 19:00:32 UTC
782190,mainnet,246,106272000,106390610,118611,111364,7247,0.0610988862753033,2021-11-11 19:02:05 UTC
782192,mainnet,246,106272000,106390777,118778,111513,7265,0.06116452541716479,2021-11-11 19:03:33 UTC
782193,mainnet,246,106272000,106390840,118841,111572,7269,0.061165759291826896,2021-11-11 19:05:12 UTC
782195,mainnet,246,106272000,106391172,119173,111875,7298,0.06123870339758167,2021-11-11 19:06:51 UTC
782196,mainnet,246,106272000,106391352,119353,112041,7312,0.06126364649401356,2021-11-11 19:08:32 UTC
782198,mainnet,246,106272000,106391552,119553,112211,7342,0.06141209338117822,2021-11-11 19:10:15 UTC
782199,mainnet,246,106272000,106391727,119728,112377,7351,0.061397501002271815,2021-11-11 19:11:47 UTC
782201,mainnet,246,106272000,106391907,119908,112554,7354,0.06133035327084098,2021-11-11 19:13:18 UTC
782202,mainnet,246,106272000,106392028,120029,112664,7365,0.061360171291937785,2021-11-11 19:15:01 UTC
782204,mainnet,246,106272000,106392274,120275,112865,7410,0.061608813136562045,2021-11-11 19:16:34 UTC
782205,mainnet,246,106272000,106392460,120461,113045,7416,0.061563493578834644,2021-11-11 19:18:04 UTC
782207,mainnet,246,106272000,106392672,120673,113240,7433,0.06159621456332402,2021-11-11 19:19:53 UTC
782208,mainnet,246,106272000,106392839,120840,113387,7453,0.06167659715326051,2021-11-11 19:21:26 UTC
782210,mainnet,246,106272000,106393035,121036,113570,7466,0.06168412703658416,2021-11-11 19:23:00 UTC
782211,mainnet,246,106272000,106393204,121205,113737,7468,0.06161461985891671,2021-11-11 19:24:28 UTC
782213,mainnet,246,106272000,106393408,121409,113935,7474,0.061560510341078505,2021-11-11 19:26:12 UTC
782214,mainnet,246,106272000,106393584,121585,114100,7485,0.06156187029650039,2021-11-11 19:27:44 UTC
782216,mainnet,246,106272000,106393753,121754,114264,7490,0.06151748607848613,2021-11-11 19:29:14 UTC
782217,mainnet,246,106272000,106393935,121936,114442,7494,0.06145847001705813,2021-11-11 19:30:43 UTC
782219,mainnet,246,106272000,106394126,122127,114627,7500,0.06141148149057948,2021-11-11 19:32:20 UTC
782220,mainnet,246,106272000,106394323,122324,114819,7505,0.06135345475949119,2021-11-11 19:34:04 UTC
782222,mainnet,246,106272000,106394488,122489,114970,7519,0.06138510396851962,2021-11-11 19:35:36 UTC
782223,mainnet,246,106272000,106394689,122690,115148,7542,0.06147200260819953,2021-11-11 19:37:12 UTC
782225,mainnet,246,106272000,106394828,122829,115283,7546,0.061435003134438934,2021-11-11 19:38:46 UTC
782226,mainnet,246,106272000,106395044,123045,115454,7591,0.0616928765898655,2021-11-11 19:40:23 UTC
782228,mainnet,246,106272000,106395230,123231,115627,7604,0.06170525273673021,2021-11-11 19:42:05 UTC
782229,mainnet,246,106272000,106395415,123416,115802,7614,0.06169378362611007,2021-11-11 19:43:41 UTC
782231,mainnet,246,106272000,106395586,123587,115963,7624,0.06168933625704969,2021-11-11 19:45:15 UTC
782232,mainnet,246,106272000,106395771,123772,116144,7628,0.061629447694147306,2021-11-11 19:46:48 UTC
782234,mainnet,246,106272000,106395974,123975,116341,7634,0.061576930832829196,2021-11-11 19:48:33 UTC
782235,mainnet,246,106272000,106396144,124145,116490,7655,0.06166176648274196,2021-11-11 19:50:04 UTC
782237,mainnet,246,106272000,106396332,124333,116661,7672,0.06170525926342966,2021-11-11 19:51:41 UTC
782238,mainnet,246,106272000,106396512,124513,116831,7682,0.06169636905383374,2021-11-11 19:53:15 UTC
782240,mainnet,246,106272000,106396680,124681,116994,7687,0.061653339321949614,2021-11-11 19:54:47 UTC
782241,mainnet,246,106272000,106396908,124909,117218,7691,0.06157282501661209,2021-11-11 19:56:42 UTC
782243,mainnet,246,106272000,106397144,125145,117433,7712,0.06162451556194814,2021-11-11 19:58:46 UTC
782244,mainnet,246,106272000,106397340,125341,117619,7722,0.06160793355725581,2021-11-11 20:00:39 UTC
782246,mainnet,246,106272000,106397566,125567,117825,7742,0.06165632690117626,2021-11-11 20:02:37 UTC
782247,mainnet,246,106272000,106397787,125788,118040,7748,0.06159570070276974,2021-11-11 20:04:25 UTC
782249,mainnet,246,106272000,106397974,125975,118220,7755,0.061559833300257986,2021-11-11 20:06:03 UTC
782250,mainnet,246,106272000,106398132,126133,118369,7764,0.06155407387440242,2021-11-11 20:07:45 UTC
782252,mainnet,246,106272000,106398350,126351,118556,7795,0.0616932196816804,2021-11-11 20:09:18 UTC
782253,mainnet,246,106272000,106398515,126516,118711,7805,0.061691801827436846,2021-11-11 20:10:52 UTC
782255,mainnet,246,106272000,106398695,126696,118877,7819,0.06171465555345078,2021-11-11 20:12:29 UTC
782256,mainnet,246,106272000,106398834,126835,119012,7823,0.06167855875744077,2021-11-11 20:14:09 UTC
782258,mainnet,246,106272000,106399070,127071,119235,7836,0.06166631253393772,2021-11-11 20:15:53 UTC
782260,mainnet,246,106272000,106399258,127259,119407,7852,0.061700940601450587,2021-11-11 20:17:36 UTC
782261,mainnet,246,106272000,106399435,127436,119565,7871,0.061764336608179794,2021-11-11 20:19:11 UTC
782263,mainnet,246,106272000,106399705,127706,119825,7881,0.06171205738179882,2021-11-11 20:21:33 UTC
782264,mainnet,246,106272000,106399871,127872,119973,7899,0.06177271021021021,2021-11-11 20:23:10 UTC
782266,mainnet,246,106272000,106400034,128035,120133,7902,0.06171749912133401,2021-11-11 20:24:42 UTC
782267,mainnet,246,106272000,106400203,128204,120293,7911,0.06170634301581854,2021-11-11 20:26:14 UTC
782269,mainnet,246,106272000,106400392,128393,120468,7925,0.06172454884612089,2021-11-11 20:27:46 UTC
782270,mainnet,246,106272000,106400598,128599,120673,7926,0.06163344971578317,2021-11-11 20:29:41 UTC
782272,mainnet,246,106272000,106400799,128800,120860,7940,0.06164596273291925,2021-11-11 20:31:21 UTC
782273,mainnet,246,106272000,106400989,128990,121034,7956,0.06167919993797969,2021-11-11 20:33:11 UTC
782275,mainnet,246,106272000,106401141,129142,121173,7969,0.06170726796859271,2021-11-11 20:34:42 UTC
782276,mainnet,246,106272000,106401312,129313,121331,7982,0.061726199222042644,2021-11-11 20:36:15 UTC
782278,mainnet,246,106272000,106401480,129481,121492,7989,0.061700172226040885,2021-11-11 20:37:45 UTC
782279,mainnet,246,106272000,106401652,129653,121653,8000,0.06170316151573816,2021-11-11 20:39:14 UTC
782281,mainnet,246,106272000,106401820,129821,121805,8016,0.06174655872316497,2021-11-11 20:40:58 UTC
782282,mainnet,246,106272000,106402012,130013,121967,8046,0.061886119080399656,2021-11-11 20:42:28 UTC
782284,mainnet,246,106272000,106402167,130168,122103,8065,0.061958392231577654,2021-11-11 20:43:56 UTC
782285,mainnet,246,106272000,106402331,130332,122261,8071,0.06192646472086671,2021-11-11 20:45:26 UTC
782286,mainnet,246,106272000,106402506,130507,122412,8095,0.062027324204831924,2021-11-11 20:46:56 UTC
782288,mainnet,246,106272000,106402678,130679,122572,8107,0.062037511765471114,2021-11-11 20:48:26 UTC
782289,mainnet,246,106272000,106402857,130858,122734,8124,0.06208256277797307,2021-11-11 20:49:54 UTC
782291,mainnet,246,106272000,106403014,131015,122887,8128,0.06203869785902377,2021-11-11 20:51:23 UTC
782292,mainnet,246,106272000,106403195,131196,123057,8139,0.062036952346108114,2021-11-11 20:52:51 UTC
782294,mainnet,246,106272000,106403362,131363,123224,8139,0.061958085610103304,2021-11-11 20:54:21 UTC
782295,mainnet,246,106272000,106403516,131517,123374,8143,0.06191595002927378,2021-11-11 20:56:01 UTC
782297,mainnet,246,106272000,106403701,131702,123553,8149,0.06187453493492885,2021-11-11 20:57:40 UTC
782298,mainnet,246,106272000,106403876,131877,123699,8178,0.06201232967082964,2021-11-11 20:59:07 UTC
782300,mainnet,246,106272000,106404069,132070,123884,8186,0.06198228212311653,2021-11-11 21:00:52 UTC
782301,mainnet,246,106272000,106404247,132248,124053,8195,0.061966910652713085,2021-11-11 21:02:30 UTC
782303,mainnet,246,106272000,106404437,132438,124235,8203,0.06193841646657304,2021-11-11 21:04:14 UTC
782304,mainnet,246,106272000,106404593,132594,124378,8216,0.06196358809599228,2021-11-11 21:05:40 UTC
782306,mainnet,246,106272000,106404773,132774,124545,8229,0.0619774955940169,2021-11-11 21:07:09 UTC
782307,mainnet,246,106272000,106404940,132941,124707,8234,0.06193725035918189,2021-11-11 21:08:37 UTC
782309,mainnet,246,106272000,106405109,133110,124859,8251,0.06198632709788896,2021-11-11 21:10:06 UTC
782310,mainnet,246,106272000,106405296,133297,125045,8252,0.061906869621971984,2021-11-11 21:11:37 UTC
782312,mainnet,246,106272000,106405464,133465,125212,8253,0.06183643651893755,2021-11-11 21:13:06 UTC
782313,mainnet,246,106272000,106405639,133640,125379,8261,0.061815324753067946,2021-11-11 21:14:37 UTC
782315,mainnet,246,106272000,106405823,133824,125563,8261,0.06173033237685318,2021-11-11 21:16:10 UTC
782316,mainnet,246,106272000,106406005,134006,125740,8266,0.061683805202752115,2021-11-11 21:17:38 UTC
782318,mainnet,246,106272000,106406193,134194,125928,8266,0.06159738885494136,2021-11-11 21:19:12 UTC
782319,mainnet,246,106272000,106406354,134355,126088,8267,0.0615310185702058,2021-11-11 21:20:40 UTC
782321,mainnet,246,106272000,106406540,134541,126265,8276,0.06151284738481207,2021-11-11 21:22:09 UTC
782322,mainnet,246,106272000,106406715,134716,126422,8294,0.06156655482644972,2021-11-11 21:23:39 UTC
782323,mainnet,246,106272000,106406884,134885,126579,8306,0.061578381584312565,2021-11-11 21:25:08 UTC
782325,mainnet,246,106272000,106407108,135109,126786,8323,0.06160211384881836,2021-11-11 21:26:57 UTC
782327,mainnet,246,106272000,106407307,135308,126975,8333,0.06158541993082449,2021-11-11 21:28:37 UTC
782328,mainnet,246,106272000,106407482,135483,127146,8337,0.061535395584685904,2021-11-11 21:30:18 UTC
782330,mainnet,246,106272000,106407758,135759,127398,8361,0.06158707709986078,2021-11-11 21:32:37 UTC
782332,mainnet,246,106272000,106407983,135984,127612,8372,0.061566066596070126,2021-11-11 21:34:45 UTC
782333,mainnet,246,106272000,106408176,136177,127796,8381,0.06154490112133473,2021-11-11 21:36:13 UTC
782334,mainnet,246,106272000,106408366,136367,127966,8401,0.061605813723261495,2021-11-11 21:37:39 UTC
782336,mainnet,246,106272000,106408536,136537,128121,8416,0.06163896965657661,2021-11-11 21:39:07 UTC
782337,mainnet,246,106272000,106408728,136729,128308,8421,0.06158898258599127,2021-11-11 21:40:54 UTC
782339,mainnet,246,106272000,106408927,136928,128495,8433,0.06158711147464361,2021-11-11 21:42:31 UTC
782340,mainnet,246,106272000,106409088,137089,128651,8438,0.06155125502410842,2021-11-11 21:43:57 UTC
782342,mainnet,246,106272000,106409227,137228,128788,8440,0.06150348325414638,2021-11-11 21:45:25 UTC
782343,mainnet,246,106272000,106409455,137456,128994,8462,0.061561517867535796,2021-11-11 21:47:07 UTC
782345,mainnet,246,106272000,106409623,137624,129157,8467,0.06152269952915189,2021-11-11 21:48:35 UTC
782346,mainnet,246,106272000,106409810,137811,129333,8478,0.06151903694189869,2021-11-11 21:50:10 UTC
782348,mainnet,246,106272000,106409989,137990,129501,8489,0.06151895064859773,2021-11-11 21:51:37 UTC
782349,mainnet,246,106272000,106410157,138158,129664,8494,0.06148033411022163,2021-11-11 21:53:08 UTC
782351,mainnet,246,106272000,106410358,138359,129855,8504,0.06146329476217666,2021-11-11 21:54:40 UTC
782353,mainnet,246,106272000,106410621,138622,130102,8520,0.061462105582086535,2021-11-11 21:57:10 UTC
782354,mainnet,246,106272000,106410823,138824,130286,8538,0.06150233389039359,2021-11-11 21:58:37 UTC
782356,mainnet,246,106272000,106410994,138995,130443,8552,0.06152739307169323,2021-11-11 22:00:16 UTC
782357,mainnet,246,106272000,106411167,139168,130613,8555,0.061472464934467695,2021-11-11 22:01:48 UTC
782359,mainnet,246,106272000,106411382,139383,130816,8567,0.06146373661063401,2021-11-11 22:03:28 UTC
782360,mainnet,246,106272000,106411556,139557,130986,8571,0.061415765601152215,2021-11-11 22:04:53 UTC
782362,mainnet,246,106272000,106411828,139829,131244,8585,0.06139641991289361,2021-11-11 22:07:09 UTC
782363,mainnet,246,106272000,106411974,139975,131385,8590,0.06136810144668691,2021-11-11 22:08:37 UTC
782365,mainnet,246,106272000,106412159,140160,131556,8604,0.061386986301369864,2021-11-11 22:10:07 UTC
782366,mainnet,246,106272000,106412355,140356,131743,8613,0.06136538516344153,2021-11-11 22:11:42 UTC
782368,mainnet,246,106272000,106412525,140526,131909,8617,0.061319613452314875,2021-11-11 22:13:13 UTC
782369,mainnet,246,106272000,106412714,140715,132089,8626,0.0613012116689763,2021-11-11 22:14:42 UTC
782371,mainnet,246,106272000,106412889,140890,132249,8641,0.061331535240258354,2021-11-11 22:16:13 UTC
782372,mainnet,246,106272000,106413043,141044,132397,8647,0.06130710983806472,2021-11-11 22:17:39 UTC
782374,mainnet,246,106272000,106413247,141248,132591,8657,0.06128936338921613,2021-11-11 22:19:22 UTC
782375,mainnet,246,106272000,106413417,141418,132758,8660,0.06123690053599966,2021-11-11 22:20:57 UTC
782377,mainnet,246,106272000,106413622,141623,132949,8674,0.06124711381625866,2021-11-11 22:22:27 UTC
782378,mainnet,246,106272000,106413787,141788,133102,8686,0.06126047338279685,2021-11-11 22:23:53 UTC
782380,mainnet,246,106272000,106413962,141963,133260,8703,0.061304706155829336,2021-11-11 22:25:31 UTC
782381,mainnet,246,106272000,106414151,142152,133424,8728,0.061399065788733186,2021-11-11 22:26:58 UTC
782383,mainnet,246,106272000,106414285,142286,133552,8734,0.06138341087668499,2021-11-11 22:28:24 UTC
782384,mainnet,246,106272000,106414465,142466,133700,8766,0.061530470428031954,2021-11-11 22:30:00 UTC
782386,mainnet,246,106272000,106414636,142637,133871,8766,0.06145670478206917,2021-11-11 22:31:32 UTC
782387,mainnet,246,106272000,106414808,142809,134034,8775,0.061445707203327524,2021-11-11 22:32:59 UTC
782389,mainnet,246,106272000,106414968,142969,134190,8779,0.061404919947680964,2021-11-11 22:34:39 UTC
782390,mainnet,246,106272000,106415161,143162,134365,8797,0.06144787024489739,2021-11-11 22:36:06 UTC
782392,mainnet,246,106272000,106415314,143315,134510,8805,0.061438090918605866,2021-11-11 22:37:33 UTC
782393,mainnet,246,106272000,106415503,143504,134693,8811,0.06139898539413535,2021-11-11 22:39:20 UTC
782395,mainnet,246,106272000,106415740,143741,134919,8822,0.06137427734605993,2021-11-11 22:41:10 UTC
782396,mainnet,246,106272000,106415944,143945,135117,8828,0.06132897981868075,2021-11-11 22:42:51 UTC
782398,mainnet,246,106272000,106416100,144101,135273,8828,0.06126258665796906,2021-11-11 22:44:19 UTC
782399,mainnet,246,106272000,106416300,144301,135447,8854,0.061357856147913045,2021-11-11 22:45:58 UTC
782401,mainnet,246,106272000,106416442,144443,135580,8863,0.06135984436767444,2021-11-11 22:47:24 UTC
782402,mainnet,246,106272000,106416628,144629,135743,8886,0.061439960173962346,2021-11-11 22:48:52 UTC
782404,mainnet,246,106272000,106416792,144793,135904,8889,0.06139108934824197,2021-11-11 22:50:23 UTC
782405,mainnet,246,106272000,106416976,144977,136079,8898,0.06137525262627865,2021-11-11 22:51:54 UTC
782407,mainnet,246,106272000,106417172,145173,136267,8906,0.061347495746454234,2021-11-11 22:53:43 UTC
782408,mainnet,246,106272000,106417402,145403,136492,8911,0.06128484281617298,2021-11-11 22:55:30 UTC
782410,mainnet,246,106272000,106417582,145583,136662,8921,0.061277759079013346,2021-11-11 22:57:08 UTC
782411,mainnet,246,106272000,106417763,145764,136833,8931,0.06127027249526632,2021-11-11 22:58:37 UTC
782413,mainnet,246,106272000,106417939,145940,137000,8940,0.061258051253939974,2021-11-11 23:00:09 UTC
782414,mainnet,246,106272000,106418092,146093,137141,8952,0.061276036497299666,2021-11-11 23:01:44 UTC
782416,mainnet,246,106272000,106418276,146277,137312,8965,0.061287830622722646,2021-11-11 23:03:13 UTC
782417,mainnet,246,106272000,106418452,146453,137482,8971,0.061255146702355025,2021-11-11 23:04:44 UTC
782419,mainnet,246,106272000,106418646,146647,137663,8984,0.061262760233758616,2021-11-11 23:06:19 UTC
782420,mainnet,246,106272000,106418822,146823,137830,8993,0.061250621496632,2021-11-11 23:07:49 UTC
782421,mainnet,246,106272000,106418992,146993,137990,9003,0.06124781452177995,2021-11-11 23:09:19 UTC
782423,mainnet,246,106272000,106419168,147169,138160,9009,0.0612153374691681,2021-11-11 23:10:50 UTC
782424,mainnet,246,106272000,106419360,147361,138332,9029,0.061271299733308,2021-11-11 23:12:22 UTC
782426,mainnet,246,106272000,106419525,147526,138492,9034,0.06123666336781313,2021-11-11 23:13:54 UTC
782427,mainnet,246,106272000,106419724,147725,138687,9038,0.06118124894229142,2021-11-11 23:15:36 UTC
782429,mainnet,246,106272000,106419908,147909,138845,9064,0.06128092272951612,2021-11-11 23:17:07 UTC
782430,mainnet,246,106272000,106420091,148092,139028,9064,0.06120519676957567,2021-11-11 23:18:40 UTC
782432,mainnet,246,106272000,106420290,148291,139218,9073,0.061183753565624346,2021-11-11 23:20:21 UTC
782433,mainnet,246,106272000,106420469,148470,139380,9090,0.061224489795918366,2021-11-11 23:21:53 UTC
782435,mainnet,246,106272000,106420653,148654,139554,9100,0.06121597804297227,2021-11-11 23:23:21 UTC
782436,mainnet,246,106272000,106420817,148818,139704,9114,0.06124259162198121,2021-11-11 23:24:48 UTC
782438,mainnet,246,106272000,106421009,149010,139887,9123,0.06122407892087779,2021-11-11 23:26:28 UTC
782439,mainnet,246,106272000,106421200,149201,140074,9127,0.06117251224857742,2021-11-11 23:28:05 UTC
782441,mainnet,246,106272000,106421398,149399,140262,9137,0.061158374554046546,2021-11-11 23:29:36 UTC
782442,mainnet,246,106272000,106421582,149583,140442,9141,0.061109885481638954,2021-11-11 23:31:05 UTC
782444,mainnet,246,106272000,106421748,149749,140602,9147,0.06108221089957195,2021-11-11 23:32:32 UTC
782445,mainnet,246,106272000,106421911,149912,140761,9151,0.06104247825390896,2021-11-11 23:34:01 UTC
782447,mainnet,246,106272000,106422075,150076,140920,9156,0.061009088728377625,2021-11-11 23:35:30 UTC
782448,mainnet,246,106272000,106422267,150268,141105,9163,0.06097771980727766,2021-11-11 23:37:09 UTC
782450,mainnet,246,106272000,106422440,150441,141265,9176,0.060994010941166306,2021-11-11 23:38:35 UTC
782451,mainnet,246,106272000,106422630,150631,141442,9189,0.061003379118508144,2021-11-11 23:40:15 UTC
782453,mainnet,246,106272000,106422802,150803,141607,9196,0.060980219226407964,2021-11-11 23:41:43 UTC
782454,mainnet,246,106272000,106422978,150979,141767,9212,0.06101510806138602,2021-11-11 23:43:10 UTC
782456,mainnet,246,106272000,106423143,151144,141919,9225,0.061034510136029216,2021-11-11 23:44:37 UTC
782457,mainnet,246,106272000,106423316,151317,142080,9237,0.06104403338686334,2021-11-11 23:46:06 UTC
782459,mainnet,246,106272000,106423509,151510,142249,9261,0.06112467823906013,2021-11-11 23:47:39 UTC
782460,mainnet,246,106272000,106423712,151713,142449,9264,0.06106266437286192,2021-11-11 23:49:20 UTC
782462,mainnet,246,106272000,106423881,151882,142616,9266,0.061007887702295205,2021-11-11 23:50:50 UTC
782463,mainnet,246,106272000,106424052,152053,142777,9276,0.06100504429376599,2021-11-11 23:52:18 UTC
782465,mainnet,246,106272000,106424251,152252,142966,9286,0.060990988624123166,2021-11-11 23:53:55 UTC
782466,mainnet,246,106272000,106424459,152460,143158,9302,0.06101272464908829,2021-11-11 23:55:33 UTC
782468,mainnet,246,106272000,106424640,152641,143326,9315,0.06102554359575737,2021-11-11 23:57:05 UTC
782469,mainnet,246,106272000,106424812,152813,143488,9325,0.061022295223573914,2021-11-11 23:58:42 UTC
782471,mainnet,246,106272000,106425023,153024,143689,9335,0.061003502718527815,2021-11-12 00:00:33 UTC
782472,mainnet,246,106272000,106425221,153222,143873,9349,0.061016042082729635,2021-11-12 00:02:24 UTC
782474,mainnet,246,106272000,106425416,153417,144057,9360,0.06101018791920061,2021-11-12 00:04:16 UTC
782476,mainnet,246,106272000,106425651,153652,144252,9400,0.061177205633509486,2021-11-12 00:06:16 UTC
782477,mainnet,246,106272000,106425852,153853,144425,9428,0.06127927307234828,2021-11-12 00:08:02 UTC
782479,mainnet,246,106272000,106426020,154021,144585,9436,0.061264373040039996,2021-11-12 00:09:32 UTC
782480,mainnet,246,106272000,106426198,154199,144741,9458,0.06133632513829532,2021-11-12 00:11:04 UTC
782482,mainnet,246,106272000,106426371,154372,144896,9476,0.061384188842536214,2021-11-12 00:12:38 UTC
782483,mainnet,246,106272000,106426562,154563,145064,9499,0.061457140454054336,2021-11-12 00:14:21 UTC
782485,mainnet,246,106272000,106426760,154761,145242,9519,0.06150774419911993,2021-11-12 00:16:10 UTC
782486,mainnet,246,106272000,106426941,154942,145421,9521,0.06144880019620245,2021-11-12 00:17:47 UTC
782488,mainnet,246,106272000,106427128,155129,145596,9533,0.061452081815779123,2021-11-12 00:19:12 UTC
782489,mainnet,246,106272000,106427315,155316,145750,9566,0.06159056375389529,2021-11-12 00:21:03 UTC
782491,mainnet,246,106272000,106427500,155501,145929,9572,0.06155587423875088,2021-11-12 00:22:41 UTC
782492,mainnet,246,106272000,106427680,155681,146096,9585,0.06156820678181666,2021-11-12 00:24:10 UTC
782494,mainnet,246,106272000,106427838,155839,146241,9598,0.06158920424284037,2021-11-12 00:25:35 UTC
782495,mainnet,246,106272000,106428027,156028,146415,9613,0.06161073653446817,2021-11-12 00:27:25 UTC
782497,mainnet,246,106272000,106428212,156213,146586,9627,0.061627393366749245,2021-11-12 00:28:56 UTC
782499,mainnet,246,106272000,106428471,156472,146831,9641,0.06161485761030727,2021-11-12 00:31:05 UTC
782500,mainnet,246,106272000,106428628,156629,146974,9655,0.061642480000510765,2021-11-12 00:32:31 UTC
782502,mainnet,246,106272000,106428790,156791,147119,9672,0.061687214189589966,2021-11-12 00:34:01 UTC
782503,mainnet,246,106272000,106428952,156953,147274,9679,0.06166814269239836,2021-11-12 00:35:39 UTC
782505,mainnet,246,106272000,106429140,157141,147453,9688,0.06165163770117283,2021-11-12 00:37:06 UTC
782506,mainnet,246,106272000,106429312,157313,147617,9696,0.061635084195203194,2021-11-12 00:38:35 UTC
782508,mainnet,246,106272000,106429476,157477,147777,9700,0.06159629660204347,2021-11-12 00:40:00 UTC
782509,mainnet,246,106272000,106429639,157640,147930,9710,0.0615960416138036,2021-11-12 00:41:30 UTC
782511,mainnet,246,106272000,106429838,157839,148115,9724,0.06160708063279671,2021-11-12 00:43:10 UTC
782512,mainnet,246,106272000,106430068,158069,148330,9739,0.06161233385420291,2021-11-12 00:45:06 UTC
782514,mainnet,246,106272000,106430237,158238,148484,9754,0.06164132509258206,2021-11-12 00:46:36 UTC
782515,mainnet,246,106272000,106430411,158412,148658,9754,0.06157361816024039,2021-11-12 00:48:12 UTC
782517,mainnet,246,106272000,106430628,158629,148865,9764,0.061552427361957776,2021-11-12 00:49:52 UTC
782518,mainnet,246,106272000,106430807,158808,149043,9765,0.061489345624905545,2021-11-12 00:51:19 UTC
782520,mainnet,246,106272000,106430986,158987,149211,9776,0.06148930415694365,2021-11-12 00:52:58 UTC
782521,mainnet,246,106272000,106431204,159205,149424,9781,0.061436512672340696,2021-11-12 00:54:35 UTC
782523,mainnet,246,106272000,106431393,159394,149603,9791,0.06142640249946673,2021-11-12 00:56:11 UTC
782524,mainnet,246,106272000,106431563,159564,149768,9796,0.06139229400115314,2021-11-12 00:57:49 UTC
782526,mainnet,246,106272000,106431779,159780,149961,9819,0.061453248216297406,2021-11-12 00:59:28 UTC
782527,mainnet,246,106272000,106431986,159987,150159,9828,0.061429991186783925,2021-11-12 01:01:14 UTC
782529,mainnet,246,106272000,106432192,160193,150353,9840,0.061425905002091226,2021-11-12 01:03:00 UTC
782530,mainnet,246,106272000,106432373,160374,150528,9846,0.06139399154476411,2021-11-12 01:04:32 UTC
782532,mainnet,246,106272000,106432568,160569,150708,9861,0.06141285055023074,2021-11-12 01:06:14 UTC
782533,mainnet,246,106272000,106432752,160753,150879,9874,0.061423426001381,2021-11-12 01:07:48 UTC
782535,mainnet,246,106272000,106432952,160953,151066,9887,0.06142787024783632,2021-11-12 01:09:22 UTC
782536,mainnet,246,106272000,106433112,161113,151223,9890,0.06138548720463277,2021-11-12 01:10:55 UTC
782537,mainnet,246,106272000,106433303,161304,151400,9904,0.06139959331448693,2021-11-12 01:12:29 UTC
782539,mainnet,246,106272000,106433483,161484,151575,9909,0.061362116370662106,2021-11-12 01:14:06 UTC
782540,mainnet,246,106272000,106433648,161649,151721,9928,0.06141702082908029,2021-11-12 01:15:41 UTC
782542,mainnet,246,106272000,106433841,161842,151910,9932,0.06136849519902127,2021-11-12 01:17:23 UTC
782543,mainnet,246,106272000,106434016,162017,152064,9953,0.06143182505539542,2021-11-12 01:19:03 UTC
782544,mainnet,246,106272000,106434192,162193,152219,9974,0.06149463910279728,2021-11-12 01:20:40 UTC
782546,mainnet,246,106272000,106434386,162387,152387,10000,0.06158128421610104,2021-11-12 01:22:19 UTC
782547,mainnet,246,106272000,106434571,162572,152555,10017,0.061615776394459074,2021-11-12 01:24:02 UTC
782549,mainnet,246,106272000,106434748,162749,152711,10038,0.061677798327485885,2021-11-12 01:25:54 UTC
782550,mainnet,246,106272000,106434968,162969,152910,10059,0.06172339524694881,2021-11-12 01:27:35 UTC
782552,mainnet,246,106272000,106435127,163128,153058,10070,0.06173066548967682,2021-11-12 01:29:03 UTC
782553,mainnet,246,106272000,106435242,163243,153159,10084,0.06177293972789032,2021-11-12 01:30:36 UTC
782555,mainnet,246,106272000,106435473,163474,153337,10137,0.06200986089531057,2021-11-12 01:32:20 UTC
782556,mainnet,246,106272000,106435640,163641,153486,10155,0.06205657506370653,2021-11-12 01:34:00 UTC
782558,mainnet,246,106272000,106435808,163809,153645,10164,0.06204787282750032,2021-11-12 01:36:00 UTC
782559,mainnet,246,106272000,106436008,164009,153840,10169,0.062002694974056305,2021-11-12 01:37:36 UTC
782561,mainnet,246,106272000,106436206,164207,154026,10181,0.062001010919144735,2021-11-12 01:39:23 UTC
782563,mainnet,246,106272000,106436434,164435,154236,10199,0.06202450816432025,2021-11-12 01:41:06 UTC
782564,mainnet,246,106272000,106436597,164598,154373,10225,0.06212104642826766,2021-11-12 01:42:33 UTC
782566,mainnet,246,106272000,106436839,164840,154586,10254,0.062205775297257945,2021-11-12 01:44:51 UTC
782568,mainnet,246,106272000,106437097,165098,154820,10278,0.06225393402706272,2021-11-12 01:46:48 UTC
782569,mainnet,246,106272000,106437273,165274,154969,10305,0.06235100499776129,2021-11-12 01:48:18 UTC
782571,mainnet,246,106272000,106437426,165427,155108,10319,0.0623779673209331,2021-11-12 01:49:44 UTC
782572,mainnet,246,106272000,106437588,165589,155262,10327,0.062365253730622204,2021-11-12 01:51:13 UTC
782574,mainnet,246,106272000,106437764,165765,155433,10332,0.06232920097728712,2021-11-12 01:52:42 UTC
782575,mainnet,246,106272000,106437934,165935,155597,10338,0.062301503600807544,2021-11-12 01:54:08 UTC
782577,mainnet,246,106272000,106438131,166132,155775,10357,0.06234199311390942,2021-11-12 01:55:47 UTC
782578,mainnet,246,106272000,106438317,166318,155958,10360,0.06229031133130509,2021-11-12 01:57:25 UTC
782580,mainnet,246,106272000,106438506,166507,156130,10377,0.062321704192616525,2021-11-12 01:59:03 UTC
782581,mainnet,246,106272000,106438676,166677,156288,10389,0.06233013553159704,2021-11-12 02:00:36 UTC
782583,mainnet,246,106272000,106438848,166849,156450,10399,0.06232581555777979,2021-11-12 02:02:02 UTC
782584,mainnet,246,106272000,106439014,167015,156612,10403,0.06228781845941981,2021-11-12 02:03:33 UTC
782586,mainnet,246,106272000,106439207,167208,156792,10416,0.06229367015932252,2021-11-12 02:05:10 UTC
782587,mainnet,246,106272000,106439383,167384,156954,10430,0.062311809969889595,2021-11-12 02:06:37 UTC
782589,mainnet,246,106272000,106439571,167572,157139,10433,0.062259804740648794,2021-11-12 02:08:23 UTC
782590,mainnet,246,106272000,106439792,167793,157346,10447,0.06226123854987991,2021-11-12 02:10:14 UTC
782592,mainnet,246,106272000,106439945,167946,157495,10451,0.06222833529825063,2021-11-12 02:11:41 UTC
782593,mainnet,246,106272000,106440139,168140,157658,10482,0.0623409063875342,2021-11-12 02:13:12 UTC
782595,mainnet,246,106272000,106440308,168309,157806,10503,0.06240308004919523,2021-11-12 02:14:49 UTC
782596,mainnet,246,106272000,106440468,168469,157961,10508,0.06237349304619841,2021-11-12 02:16:19 UTC
782598,mainnet,246,106272000,106440644,168645,158137,10508,0.06230839930030538,2021-11-12 02:17:44 UTC
782599,mainnet,246,106272000,106440828,168829,158317,10512,0.06226418447067743,2021-11-12 02:19:24 UTC
782601,mainnet,246,106272000,106441025,169026,158500,10526,0.06227444298510288,2021-11-12 02:20:55 UTC
782602,mainnet,246,106272000,106441195,169196,158662,10534,0.06225915506276744,2021-11-12 02:22:21 UTC
782604,mainnet,246,106272000,106441378,169379,158816,10563,0.0623631028639914,2021-11-12 02:23:47 UTC
782605,mainnet,246,106272000,106441534,169535,158949,10586,0.06244138378505913,2021-11-12 02:25:14 UTC
782607,mainnet,246,106272000,106441684,169685,159087,10598,0.062456905442437455,2021-11-12 02:26:43 UTC
782608,mainnet,246,106272000,106441861,169862,159251,10611,0.06246835666599946,2021-11-12 02:28:08 UTC
782610,mainnet,246,106272000,106442072,170073,159454,10619,0.0624378943159702,2021-11-12 02:29:49 UTC
782611,mainnet,246,106272000,106442262,170263,159633,10630,0.0624328245126657,2021-11-12 02:31:35 UTC
782613,mainnet,246,106272000,106442458,170459,159811,10648,0.06246663420529277,2021-11-12 02:33:15 UTC
782614,mainnet,246,106272000,106442600,170601,159934,10667,0.06252601098469528,2021-11-12 02:34:41 UTC
782616,mainnet,246,106272000,106442746,170747,160069,10678,0.0625369699028387,2021-11-12 02:36:10 UTC
782617,mainnet,246,106272000,106442904,170905,160202,10703,0.06262543518328896,2021-11-12 02:37:42 UTC
782619,mainnet,246,106272000,106443079,171080,160362,10718,0.06264905307458499,2021-11-12 02:39:11 UTC
782621,mainnet,246,106272000,106443236,171237,160507,10730,0.06266169110647815,2021-11-12 02:40:40 UTC
782622,mainnet,246,106272000,106443408,171409,160676,10733,0.06261631536267057,2021-11-12 02:42:09 UTC
782624,mainnet,246,106272000,106443590,171591,160857,10734,0.06255572844729619,2021-11-12 02:43:36 UTC
782625,mainnet,246,106272000,106443770,171771,161019,10752,0.06259496655430777,2021-11-12 02:45:03 UTC
782627,mainnet,246,106272000,106443990,171991,161230,10761,0.06256722735491974,2021-11-12 02:47:01 UTC
782628,mainnet,246,106272000,106444183,172184,161412,10772,0.06256098127584445,2021-11-12 02:48:40 UTC
782630,mainnet,246,106272000,106444352,172353,161570,10783,0.06256345987595226,2021-11-12 02:50:11 UTC
782632,mainnet,246,106272000,106444522,172523,161722,10801,0.06260614526758751,2021-11-12 02:52:29 UTC
782633,mainnet,246,106272000,106444814,172815,161991,10824,0.06263345195729537,2021-11-12 02:54:16 UTC
782635,mainnet,246,106272000,106445030,173031,162187,10844,0.06267085088799117,2021-11-12 02:56:06 UTC
782636,mainnet,246,106272000,106445205,173206,162352,10854,0.06266526563744905,2021-11-12 02:57:34 UTC
782638,mainnet,246,106272000,106445371,173372,162509,10863,0.06265717647601689,2021-11-12 02:59:01 UTC
782639,mainnet,246,106272000,106445620,173621,162726,10895,0.06275162566740199,2021-11-12 03:01:06 UTC
782641,mainnet,246,106272000,106445780,173781,162869,10912,0.06279167457892405,2021-11-12 03:02:32 UTC
782642,mainnet,246,106272000,106445964,173965,163043,10922,0.06278274365533297,2021-11-12 03:04:12 UTC
782644,mainnet,246,106272000,106446166,174167,163234,10933,0.06277308560175004,2021-11-12 03:05:58 UTC
782645,mainnet,246,106272000,106446368,174369,163404,10965,0.06288388417665984,2021-11-12 03:07:35 UTC
782647,mainnet,246,106272000,106446485,174486,163513,10973,0.06288756691081233,2021-11-12 03:08:47 UTC
782648,mainnet,246,106272000,106446605,174606,163616,10990,0.06294170876144005,2021-11-12 03:10:15 UTC
782650,mainnet,246,106272000,106446815,174816,163805,11011,0.06298622551711514,2021-11-12 03:11:47 UTC
782651,mainnet,246,106272000,106446988,174989,163968,11021,0.06298110166924778,2021-11-12 03:13:15 UTC
782653,mainnet,246,106272000,106447166,175167,164144,11023,0.06292851964125663,2021-11-12 03:14:42 UTC
782654,mainnet,246,106272000,106447331,175332,164308,11024,0.06287500285173271,2021-11-12 03:16:10 UTC
782656,mainnet,246,106272000,106447495,175496,164463,11033,0.06286752974426768,2021-11-12 03:17:39 UTC
782657,mainnet,246,106272000,106447671,175672,164625,11047,0.06288423880868892,2021-11-12 03:19:09 UTC
782659,mainnet,246,106272000,106447838,175839,164781,11058,0.06288707283367172,2021-11-12 03:20:45 UTC
782660,mainnet,246,106272000,106448026,176027,164951,11076,0.06292216534963387,2021-11-12 03:22:28 UTC
782662,mainnet,246,106272000,106448201,176202,165118,11084,0.0629050748572661,2021-11-12 03:23:54 UTC
782663,mainnet,246,106272000,106448381,176382,165292,11090,0.0628748965313921,2021-11-12 03:25:43 UTC
782665,mainnet,246,106272000,106448569,176570,165469,11101,0.06287024975930226,2021-11-12 03:27:12 UTC
782666,mainnet,246,106272000,106448742,176743,165636,11107,0.06284265854941921,2021-11-12 03:28:41 UTC
782668,mainnet,246,106272000,106448937,176938,165822,11116,0.06282426612711797,2021-11-12 03:30:21 UTC
782669,mainnet,246,106272000,106449107,177108,165980,11128,0.06283171849944666,2021-11-12 03:31:48 UTC
782671,mainnet,246,106272000,106449304,177305,166151,11154,0.06290854741829052,2021-11-12 03:33:32 UTC
782672,mainnet,246,106272000,106449508,177509,166345,11164,0.0628925857280476,2021-11-12 03:35:18 UTC
782674,mainnet,246,106272000,106449696,177697,166516,11181,0.0629217150542778,2021-11-12 03:36:55 UTC
782676,mainnet,246,106272000,106449857,177858,166677,11181,0.06286475727827817,2021-11-12 03:38:24 UTC
782677,mainnet,246,106272000,106450053,178054,166857,11197,0.06288541678367236,2021-11-12 03:40:02 UTC
782679,mainnet,246,106272000,106450240,178241,167030,11211,0.06289798643409765,2021-11-12 03:41:36 UTC
782680,mainnet,246,106272000,106450445,178446,167229,11217,0.06285935240913218,2021-11-12 03:43:15 UTC
782682,mainnet,246,106272000,106450632,178633,167404,11229,0.0628607256218056,2021-11-12 03:44:46 UTC
782683,mainnet,246,106272000,106450801,178802,167569,11233,0.06282368206172191,2021-11-12 03:46:24 UTC
782685,mainnet,246,106272000,106450979,178980,167737,11243,0.06281707453346742,2021-11-12 03:47:51 UTC
782686,mainnet,246,106272000,106451173,179174,167922,11252,0.062799290075569,2021-11-12 03:49:33 UTC
782688,mainnet,246,106272000,106451354,179355,168095,11260,0.062780519082267,2021-11-12 03:51:21 UTC
782689,mainnet,246,106272000,106451558,179559,168288,11271,0.06277045427965182,2021-11-12 03:53:00 UTC
782691,mainnet,246,106272000,106451735,179736,168456,11280,0.06275871277874215,2021-11-12 03:54:38 UTC
782692,mainnet,246,106272000,106451887,179888,168600,11288,0.06275015565240594,2021-11-12 03:56:06 UTC
782694,mainnet,246,106272000,106452106,180107,168804,11303,0.06275713881192846,2021-11-12 03:57:46 UTC
782695,mainnet,246,106272000,106452280,180281,168974,11307,0.06271875572023675,2021-11-12 03:59:12 UTC
782697,mainnet,246,106272000,106452471,180472,169158,11314,0.06269116538853672,2021-11-12 04:00:47 UTC
782698,mainnet,246,106272000,106452627,180628,169311,11317,0.06265363066634187,2021-11-12 04:02:24 UTC
782700,mainnet,246,106272000,106452824,180825,169507,11318,0.06259090280658094,2021-11-12 04:04:02 UTC
782701,mainnet,246,106272000,106453018,181019,169683,11336,0.06262326054171109,2021-11-12 04:05:29 UTC
782703,mainnet,246,106272000,106453212,181213,169870,11343,0.06259484694806663,2021-11-12 04:07:16 UTC
782704,mainnet,246,106272000,106453416,181417,170065,11352,0.06257406968475943,2021-11-12 04:08:55 UTC
782706,mainnet,246,106272000,106453581,181582,170223,11359,0.06255575993215187,2021-11-12 04:10:24 UTC
782708,mainnet,246,106272000,106453771,181772,170394,11378,0.0625948991043725,2021-11-12 04:12:02 UTC
782709,mainnet,246,106272000,106453988,181989,170584,11405,0.0626686228288523,2021-11-12 04:13:57 UTC
782711,mainnet,246,106272000,106454149,182150,170708,11442,0.0628163601427395,2021-11-12 04:15:24 UTC
782712,mainnet,246,106272000,106454363,182364,170912,11452,0.0627974819591586,2021-11-12 04:17:21 UTC
782714,mainnet,246,106272000,106454571,182572,171104,11468,0.06281357491838836,2021-11-12 04:19:02 UTC
782715,mainnet,246,106272000,106454709,182710,171238,11472,0.06278802473865688,2021-11-12 04:20:29 UTC
782717,mainnet,246,106272000,106454900,182901,171403,11498,0.06286460981623938,2021-11-12 04:22:08 UTC
782719,mainnet,246,106272000,106455185,183186,171665,11521,0.06289236076992784,2021-11-12 04:24:39 UTC
782720,mainnet,246,106272000,106455369,183370,171832,11538,0.06292196106233298,2021-11-12 04:26:07 UTC
782722,mainnet,246,106272000,106455552,183553,172003,11550,0.0629246048825135,2021-11-12 04:27:47 UTC
782723,mainnet,246,106272000,106455731,183732,172154,11578,0.06301569677573858,2021-11-12 04:29:14 UTC
782725,mainnet,246,106272000,106455833,183834,172251,11583,0.06300793106824636,2021-11-12 04:30:42 UTC
782726,mainnet,246,106272000,106456055,184056,172457,11599,0.06301886382405354,2021-11-12 04:32:09 UTC
782727,mainnet,246,106272000,106456191,184192,172584,11608,0.06302119527449618,2021-11-12 04:33:39 UTC
782728,mainnet,246,106272000,106456358,184359,172742,11617,0.06301292586746511,2021-11-12 04:35:05 UTC
782730,mainnet,246,106272000,106456524,184525,172908,11617,0.0629562389920065,2021-11-12 04:36:35 UTC
782731,mainnet,246,106272000,106456692,184693,173068,11625,0.06294228801308117,2021-11-12 04:38:04 UTC
782733,mainnet,246,106272000,106456902,184903,173256,11647,0.06298978383260412,2021-11-12 04:39:52 UTC
782734,mainnet,246,106272000,106457093,185094,173427,11667,0.06303283736912056,2021-11-12 04:41:32 UTC
782736,mainnet,246,106272000,106457262,185263,173594,11669,0.06298613322681809,2021-11-12 04:43:08 UTC
782738,mainnet,246,106272000,106457466,185467,173788,11679,0.06297077108056959,2021-11-12 04:44:57 UTC
782739,mainnet,246,106272000,106457666,185667,173975,11692,0.06297295696057996,2021-11-12 04:46:38 UTC
782741,mainnet,246,106272000,106457820,185821,174123,11698,0.06295305697418484,2021-11-12 04:48:05 UTC
782742,mainnet,246,106272000,106458012,186013,174291,11722,0.06301710095530957,2021-11-12 04:49:31 UTC
782744,mainnet,246,106272000,106458199,186200,174474,11726,0.06297529538131041,2021-11-12 04:51:02 UTC
782745,mainnet,246,106272000,106458366,186367,174630,11737,0.06297788771617292,2021-11-12 04:52:30 UTC
782747,mainnet,246,106272000,106458548,186549,174800,11749,0.06298077180794322,2021-11-12 04:53:58 UTC
782748,mainnet,246,106272000,106458732,186733,174980,11753,0.06294013377389106,2021-11-12 04:55:25 UTC
782750,mainnet,246,106272000,106458905,186906,175138,11768,0.06296213069671386,2021-11-12 04:56:54 UTC
782751,mainnet,246,106272000,106459071,187072,175293,11779,0.06296506158056792,2021-11-12 04:58:25 UTC
782753,mainnet,246,106272000,106459222,187223,175435,11788,0.06296234971130683,2021-11-12 04:59:50 UTC
782754,mainnet,246,106272000,106459397,187398,175592,11806,0.0629996051185178,2021-11-12 05:01:21 UTC
782755,mainnet,246,106272000,106459560,187561,175748,11813,0.06298217646525664,2021-11-12 05:02:50 UTC
782757,mainnet,246,106272000,106459710,187711,175891,11820,0.06296913872921672,2021-11-12 05:04:26 UTC
782758,mainnet,246,106272000,106459892,187893,176063,11830,0.06296136630954852,2021-11-12 05:05:54 UTC
782760,mainnet,246,106272000,106460057,188058,176211,11847,0.06299652234948792,2021-11-12 05:07:21 UTC
782761,mainnet,246,106272000,106460215,188216,176363,11853,0.06297551749054278,2021-11-12 05:09:02 UTC
782763,mainnet,246,106272000,106460406,188407,176549,11858,0.06293821354832889,2021-11-12 05:10:48 UTC
782764,mainnet,246,106272000,106460628,188629,176754,11875,0.06295426472069512,2021-11-12 05:12:25 UTC
782766,mainnet,246,106272000,106460814,188815,176932,11883,0.06293461854195906,2021-11-12 05:13:55 UTC
782767,mainnet,246,106272000,106460980,188981,177083,11898,0.06295871013488129,2021-11-12 05:15:22 UTC
782769,mainnet,246,106272000,106461142,189143,177234,11909,0.0629629433814627,2021-11-12 05:16:50 UTC
782770,mainnet,246,106272000,106461302,189303,177388,11915,0.06294142195316503,2021-11-12 05:18:18 UTC
782772,mainnet,246,106272000,106461463,189464,177527,11937,0.06300405354051429,2021-11-12 05:19:44 UTC
782773,mainnet,246,106272000,106461621,189622,177664,11958,0.06306230289734313,2021-11-12 05:21:25 UTC
782775,mainnet,246,106272000,106461784,189785,177802,11983,0.06313986879890403,2021-11-12 05:23:00 UTC
782776,mainnet,246,106272000,106462001,190002,177993,12009,0.06320459784633846,2021-11-12 05:24:48 UTC
782778,mainnet,246,106272000,106462219,190220,178195,12025,0.0632162758910735,2021-11-12 05:26:45 UTC
782779,mainnet,246,106272000,106462416,190417,178386,12031,0.06318238392580494,2021-11-12 05:28:31 UTC
782781,mainnet,246,106272000,106462668,190669,178621,12048,0.063188037908627,2021-11-12 05:31:10 UTC
782783,mainnet,246,106272000,106462889,190890,178835,12055,0.06315155325056315,2021-11-12 05:32:40 UTC
782784,mainnet,246,106272000,106463056,191057,178998,12059,0.06311728960467296,2021-11-12 05:34:05 UTC
782786,mainnet,246,106272000,106463241,191242,179171,12071,0.06311898014034574,2021-11-12 05:35:32 UTC
782787,mainnet,246,106272000,106463401,191402,179321,12081,0.06311846271198839,2021-11-12 05:36:58 UTC
782789,mainnet,246,106272000,106463608,191609,179517,12092,0.06310768283326984,2021-11-12 05:38:48 UTC
782790,mainnet,246,106272000,106463810,191811,179710,12101,0.06308814405847422,2021-11-12 05:40:34 UTC
782792,mainnet,246,106272000,106464011,192012,179889,12123,0.06313667895756515,2021-11-12 05:42:26 UTC
782793,mainnet,246,106272000,106464179,192180,180046,12134,0.0631387241128109,2021-11-12 05:43:53 UTC
782794,mainnet,246,106272000,106464332,192333,180186,12147,0.06315608865873251,2021-11-12 05:45:22 UTC
782796,mainnet,246,106272000,106464506,192507,180355,12152,0.06312497727355369,2021-11-12 05:46:58 UTC
782797,mainnet,246,106272000,106464680,192681,180515,12166,0.06314063140631407,2021-11-12 05:48:28 UTC
782799,mainnet,246,106272000,106464836,192837,180658,12179,0.0631569667646769,2021-11-12 05:49:53 UTC
782800,mainnet,246,106272000,106465008,193009,180816,12193,0.06317321990166262,2021-11-12 05:51:27 UTC
782802,mainnet,246,106272000,106465176,193177,180974,12203,0.06317004612350331,2021-11-12 05:52:56 UTC
782803,mainnet,246,106272000,106465350,193351,181147,12204,0.06311837021789388,2021-11-12 05:54:37 UTC
782805,mainnet,246,106272000,106465546,193547,181333,12214,0.06310611892718565,2021-11-12 05:56:24 UTC
782806,mainnet,246,106272000,106465746,193747,181511,12236,0.06315452626363247,2021-11-12 05:57:55 UTC
782808,mainnet,246,106272000,106465911,193912,181665,12247,0.0631575147489583,2021-11-12 05:59:24 UTC
782809,mainnet,246,106272000,106466096,194097,181846,12251,0.06311792557329583,2021-11-12 06:00:58 UTC
782811,mainnet,246,106272000,106466258,194259,182000,12259,0.06310647125744495,2021-11-12 06:02:27 UTC
782812,mainnet,246,106272000,106466437,194438,182160,12278,0.06314609284193419,2021-11-12 06:03:55 UTC
782814,mainnet,246,106272000,106466593,194594,182306,12288,0.06314685961540438,2021-11-12 06:05:35 UTC
782815,mainnet,246,106272000,106466804,194805,182507,12298,0.0631297964631298,2021-11-12 06:07:13 UTC
782817,mainnet,246,106272000,106466961,194962,182659,12303,0.0631046049999487,2021-11-12 06:08:40 UTC
782818,mainnet,246,106272000,106467133,195134,182813,12321,0.06314122602929269,2021-11-12 06:10:19 UTC
782820,mainnet,246,106272000,106467311,195312,182978,12334,0.06315024166461866,2021-11-12 06:11:56 UTC
782821,mainnet,246,106272000,106467472,195473,183128,12345,0.06315450215630804,2021-11-12 06:13:25 UTC
782822,mainnet,246,106272000,106467654,195655,183303,12352,0.06313153254452991,2021-11-12 06:15:05 UTC
782824,mainnet,246,106272000,106467819,195820,183458,12362,0.06312940455520376,2021-11-12 06:16:34 UTC
782825,mainnet,246,106272000,106467986,195987,183620,12367,0.06310112405414645,2021-11-12 06:18:02 UTC
782827,mainnet,246,106272000,106468163,196164,183779,12385,0.06313594747252299,2021-11-12 06:19:29 UTC
782828,mainnet,246,106272000,106468340,196341,183947,12394,0.0631248694872696,2021-11-12 06:20:57 UTC
782829,mainnet,246,106272000,106468475,196476,184073,12403,0.06312730308027444,2021-11-12 06:22:27 UTC
782831,mainnet,246,106272000,106468653,196654,184235,12419,0.06315152501347544,2021-11-12 06:23:53 UTC
782832,mainnet,246,106272000,106468822,196823,184397,12426,0.06313286556957266,2021-11-12 06:25:21 UTC
782834,mainnet,246,106272000,106469000,197001,184562,12439,0.06314181146288597,2021-11-12 06:26:56 UTC
782835,mainnet,246,106272000,106469173,197174,184725,12449,0.06313712761317415,2021-11-12 06:28:25 UTC
782837,mainnet,246,106272000,106469368,197369,184912,12457,0.06311528152850751,2021-11-12 06:30:03 UTC
782838,mainnet,246,106272000,106469546,197547,185080,12467,0.06310903228092556,2021-11-12 06:31:30 UTC
782840,mainnet,246,106272000,106469720,197721,185246,12475,0.06309395562433935,2021-11-12 06:32:59 UTC
782841,mainnet,246,106272000,106469880,197881,185401,12480,0.06306820766015939,2021-11-12 06:34:38 UTC
782843,mainnet,246,106272000,106470107,198108,185602,12506,0.06312718315262382,2021-11-12 06:36:37 UTC
782845,mainnet,246,106272000,106470279,198280,185765,12515,0.0631178131934638,2021-11-12 06:38:05 UTC
782846,mainnet,246,106272000,106470448,198449,185918,12531,0.06314468704805769,2021-11-12 06:39:33 UTC
782848,mainnet,246,106272000,106470626,198627,186090,12537,0.06311830717878233,2021-11-12 06:41:22 UTC
782849,mainnet,246,106272000,106470840,198841,186274,12567,0.06320125125099954,2021-11-12 06:43:23 UTC
782851,mainnet,246,106272000,106471007,199008,186427,12581,0.06321856407782601,2021-11-12 06:44:50 UTC
782852,mainnet,246,106272000,106471158,199159,186571,12588,0.06320578030618752,2021-11-12 06:46:15 UTC
782854,mainnet,246,106272000,106471340,199341,186737,12604,0.06322833737163955,2021-11-12 06:47:43 UTC
782855,mainnet,246,106272000,106471514,199515,186901,12614,0.06322331654261584,2021-11-12 06:49:29 UTC
782857,mainnet,246,106272000,106471679,199680,187051,12629,0.0632461939102564,2021-11-12 06:50:58 UTC
782858,mainnet,246,106272000,106471837,199838,187192,12646,0.06328125781883326,2021-11-12 06:52:25 UTC
782860,mainnet,246,106272000,106472016,200017,187361,12656,0.06327462165715914,2021-11-12 06:54:06 UTC
782862,mainnet,246,106272000,106472157,200158,187481,12677,0.06333496537735189,2021-11-12 06:56:02 UTC
782863,mainnet,246,106272000,106472401,200402,187695,12707,0.06340755082284608,2021-11-12 06:58:02 UTC
782865,mainnet,246,106272000,106472548,200549,187833,12716,0.06340595066542341,2021-11-12 06:59:28 UTC
782866,mainnet,246,106272000,106472727,200728,187990,12738,0.06345900920648838,2021-11-12 07:01:03 UTC
782868,mainnet,246,106272000,106472915,200916,188152,12764,0.06352903701049195,2021-11-12 07:02:39 UTC
782869,mainnet,246,106272000,106473070,201071,188303,12768,0.06349995772637526,2021-11-12 07:04:10 UTC
782871,mainnet,246,106272000,106473260,201261,188472,12789,0.06354435285524766,2021-11-12 07:05:48 UTC
782873,mainnet,246,106272000,106473560,201561,188769,12792,0.06346465834164347,2021-11-12 07:08:24 UTC
782874,mainnet,246,106272000,106473707,201708,188912,12796,0.06343823745215857,2021-11-12 07:09:53 UTC
782876,mainnet,246,106272000,106473885,201886,189070,12816,0.0634813706745391,2021-11-12 07:11:25 UTC
782877,mainnet,246,106272000,106474064,202065,189244,12821,0.06344987998911242,2021-11-12 07:12:52 UTC
782879,mainnet,246,106272000,106474240,202241,189412,12829,0.06343421956972127,2021-11-12 07:14:24 UTC
782880,mainnet,246,106272000,106474425,202426,189578,12848,0.06347010759487418,2021-11-12 07:15:55 UTC
782882,mainnet,246,106272000,106474621,202622,189749,12873,0.06353209424445519,2021-11-12 07:17:26 UTC
782883,mainnet,246,106272000,106474780,202781,189902,12879,0.0635118674826537,2021-11-12 07:18:57 UTC
782885,mainnet,246,106272000,106474954,202955,190061,12894,0.06353132467788426,2021-11-12 07:20:27 UTC
782886,mainnet,246,106272000,106475136,203137,190230,12907,0.06353840019297322,2021-11-12 07:21:56 UTC
782888,mainnet,246,106272000,106475292,203293,190378,12915,0.0635289950957485,2021-11-12 07:23:35 UTC
782889,mainnet,246,106272000,106475474,203475,190538,12937,0.06358029241921612,2021-11-12 07:25:04 UTC
782891,mainnet,246,106272000,106475654,203655,190714,12941,0.06354373818467507,2021-11-12 07:26:50 UTC
782892,mainnet,246,106272000,106475855,203856,190899,12957,0.06355957146220861,2021-11-12 07:28:18 UTC
782894,mainnet,246,106272000,106476023,204024,191056,12968,0.06356114966866643,2021-11-12 07:29:55 UTC
782895,mainnet,246,106272000,106476186,204187,191204,12983,0.06358387164706862,2021-11-12 07:31:25 UTC
782897,mainnet,246,106272000,106476354,204355,191360,12995,0.06359032076533483,2021-11-12 07:32:55 UTC
782898,mainnet,246,106272000,106476543,204544,191535,13009,0.06360000782227784,2021-11-12 07:34:27 UTC
782900,mainnet,246,106272000,106476706,204707,191698,13009,0.06354936567875061,2021-11-12 07:36:07 UTC
782901,mainnet,246,106272000,106476916,204917,191898,13019,0.06353304020652265,2021-11-12 07:37:39 UTC
782903,mainnet,246,106272000,106477075,205076,192039,13037,0.06357155396048295,2021-11-12 07:39:17 UTC
782904,mainnet,246,106272000,106477222,205223,192172,13051,0.06359423651345122,2021-11-12 07:40:55 UTC
782906,mainnet,246,106272000,106477378,205379,192318,13061,0.06359462262451371,2021-11-12 07:42:26 UTC
782907,mainnet,246,106272000,106477556,205557,192463,13094,0.06370009291826598,2021-11-12 07:43:55 UTC
782909,mainnet,246,106272000,106477746,205747,192647,13100,0.06367043018853252,2021-11-12 07:45:36 UTC
782910,mainnet,246,106272000,106477894,205895,192789,13106,0.06365380412346099,2021-11-12 07:47:04 UTC
782912,mainnet,246,106272000,106478064,206065,192943,13122,0.06367893625797685,2021-11-12 07:48:36 UTC
782913,mainnet,246,106272000,106478230,206231,193097,13134,0.06368586681924637,2021-11-12 07:50:07 UTC
782915,mainnet,246,106272000,106478396,206397,193241,13156,0.06374123654898085,2021-11-12 07:51:46 UTC
782916,mainnet,246,106272000,106478568,206569,193399,13170,0.06375593627310971,2021-11-12 07:53:17 UTC
782918,mainnet,246,106272000,106478717,206718,193542,13176,0.06373900676283632,2021-11-12 07:54:43 UTC
782919,mainnet,246,106272000,106478876,206877,193687,13190,0.0637576917685388,2021-11-12 07:56:11 UTC
782921,mainnet,246,106272000,106479094,207095,193888,13207,0.06377266471909027,2021-11-12 07:58:14 UTC
782922,mainnet,246,106272000,106479279,207280,194052,13228,0.06381705905055964,2021-11-12 07:59:45 UTC
782924,mainnet,246,106272000,106479546,207547,194296,13251,0.06384577951018323,2021-11-12 08:02:25 UTC
782926,mainnet,246,106272000,106479792,207793,194509,13284,0.0639290062706636,2021-11-12 08:04:39 UTC
782927,mainnet,246,106272000,106479943,207944,194648,13296,0.0639402916169738,2021-11-12 08:06:06 UTC
782929,mainnet,246,106272000,106480170,208171,194839,13332,0.06404350269730173,2021-11-12 08:08:17 UTC
782930,mainnet,246,106272000,106480338,208339,194984,13355,0.06410225641862541,2021-11-12 08:09:46 UTC
782932,mainnet,246,106272000,106480499,208500,195138,13362,0.0640863309352518,2021-11-12 08:11:14 UTC
782934,mainnet,246,106272000,106480763,208764,195388,13376,0.06407234963882662,2021-11-12 08:13:41 UTC
782935,mainnet,246,106272000,106480946,208947,195546,13401,0.06413588134790162,2021-11-12 08:15:07 UTC
782937,mainnet,246,106272000,106481119,209120,195713,13407,0.06411151491966335,2021-11-12 08:16:57 UTC
782938,mainnet,246,106272000,106481303,209304,195886,13418,0.06410770936054734,2021-11-12 08:18:28 UTC
782940,mainnet,246,106272000,106481477,209478,196051,13427,0.06409742311841816,2021-11-12 08:20:00 UTC
782941,mainnet,246,106272000,106481609,209610,196172,13438,0.06410953675874242,2021-11-12 08:21:32 UTC
782943,mainnet,246,106272000,106481794,209795,196332,13463,0.0641721680688291,2021-11-12 08:23:01 UTC
782944,mainnet,246,106272000,106481984,209985,196505,13480,0.06419506155201563,2021-11-12 08:24:41 UTC
782946,mainnet,246,106272000,106482155,210156,196667,13489,0.06418565256285806,2021-11-12 08:26:10 UTC
782947,mainnet,246,106272000,106482331,210332,196836,13496,0.06416522450221554,2021-11-12 08:27:50 UTC
782949,mainnet,246,106272000,106482514,210515,197015,13500,0.06412844690402109,2021-11-12 08:29:21 UTC
782950,mainnet,246,106272000,106482685,210686,197174,13512,0.06413335485034602,2021-11-12 08:30:49 UTC
782952,mainnet,246,106272000,106482870,210871,197350,13521,0.06411976990672022,2021-11-12 08:32:29 UTC
782953,mainnet,246,106272000,106483042,211043,197500,13543,0.06417175646669163,2021-11-12 08:33:58 UTC
782955,mainnet,246,106272000,106483221,211222,197678,13544,0.06412210849248658,2021-11-12 08:35:29 UTC
782956,mainnet,246,106272000,106483386,211387,197834,13553,0.06411463335020602,2021-11-12 08:36:55 UTC
782958,mainnet,246,106272000,106483564,211565,197987,13578,0.06417885756150592,2021-11-12 08:38:35 UTC
782959,mainnet,246,106272000,106483723,211724,198135,13589,0.06418261510268085,2021-11-12 08:40:05 UTC
782961,mainnet,246,106272000,106483869,211870,198273,13597,0.06417614574975221,2021-11-12 08:41:38 UTC
782962,mainnet,246,106272000,106484044,212045,198444,13601,0.06414204532056875,2021-11-12 08:43:10 UTC
782964,mainnet,246,106272000,106484220,212221,198611,13610,0.06413125939468761,2021-11-12 08:44:45 UTC
782965,mainnet,246,106272000,106484367,212368,198745,13623,0.06414808257364575,2021-11-12 08:46:17 UTC
782967,mainnet,246,106272000,106484555,212556,198908,13648,0.0642089614031126,2021-11-12 08:48:00 UTC
782968,mainnet,246,106272000,106484752,212753,199102,13651,0.06416360756370063,2021-11-12 08:49:43 UTC
782970,mainnet,246,106272000,106484927,212928,199265,13663,0.06416723023745116,2021-11-12 08:51:16 UTC
782971,mainnet,246,106272000,106485112,213113,199434,13679,0.06418660522821226,2021-11-12 08:52:44 UTC
782973,mainnet,246,106272000,106485287,213288,199609,13679,0.06413394096245452,2021-11-12 08:54:16 UTC
782974,mainnet,246,106272000,106485460,213461,199773,13688,0.06412412571851532,2021-11-12 08:55:47 UTC
782976,mainnet,246,106272000,106485646,213647,199938,13709,0.06416659255688122,2021-11-12 08:57:23 UTC
782977,mainnet,246,106272000,106485834,213835,200117,13718,0.06415226693478616,2021-11-12 08:58:53 UTC
782979,mainnet,246,106272000,106485994,213995,200272,13723,0.06412766653426481,2021-11-12 09:00:27 UTC
782980,mainnet,246,106272000,106486174,214175,200427,13748,0.06419049842418582,2021-11-12 09:01:58 UTC
782982,mainnet,246,106272000,106486336,214337,200568,13769,0.0642399585699156,2021-11-12 09:03:27 UTC
782983,mainnet,246,106272000,106486522,214523,200751,13772,0.06419824447728216,2021-11-12 09:04:56 UTC
782985,mainnet,246,106272000,106486749,214750,200966,13784,0.06418626309662398,2021-11-12 09:07:02 UTC
782987,mainnet,246,106272000,106486901,214902,201109,13793,0.06418274376227304,2021-11-12 09:08:31 UTC
782988,mainnet,246,106272000,106487087,215088,201283,13805,0.06418303206129584,2021-11-12 09:10:01 UTC
782989,mainnet,246,106272000,106487272,215273,201453,13820,0.06419755380377475,2021-11-12 09:11:32 UTC
782991,mainnet,246,106272000,106487449,215450,201621,13829,0.06418658621489905,2021-11-12 09:13:04 UTC
782993,mainnet,246,106272000,106487636,215637,201791,13846,0.06420975992060732,2021-11-12 09:14:46 UTC
782994,mainnet,246,106272000,106487829,215830,201962,13868,0.0642542741972849,2021-11-12 09:16:16 UTC
782996,mainnet,246,106272000,106488014,216015,202132,13883,0.06426868504502002,2021-11-12 09:17:44 UTC
782997,mainnet,246,106272000,106488244,216245,202340,13905,0.06430206478762515,2021-11-12 09:19:44 UTC
782999,mainnet,246,106272000,106488498,216499,202580,13919,0.06429129002905325,2021-11-12 09:22:04 UTC
783000,mainnet,246,106272000,106488674,216675,202751,13924,0.0642621437637014,2021-11-12 09:23:33 UTC
783002,mainnet,246,106272000,106488858,216859,202933,13926,0.06421684135774858,2021-11-12 09:25:16 UTC
783003,mainnet,246,106272000,106488998,216999,203071,13928,0.06418462757892894,2021-11-12 09:26:44 UTC
783005,mainnet,246,106272000,106489196,217197,203256,13941,0.06418596941946712,2021-11-12 09:28:25 UTC
783007,mainnet,246,106272000,106489344,217345,203391,13954,0.06420207504198394,2021-11-12 09:29:57 UTC
783008,mainnet,246,106272000,106489502,217503,203522,13981,0.0642795731553128,2021-11-12 09:31:48 UTC
783010,mainnet,246,106272000,106489675,217676,203673,14003,0.06432955401606057,2021-11-12 09:33:25 UTC
783011,mainnet,246,106272000,106489850,217851,203819,14032,0.06441099650678675,2021-11-12 09:34:54 UTC
783013,mainnet,246,106272000,106490107,218108,204042,14066,0.06449098611696957,2021-11-12 09:37:35 UTC
783015,mainnet,246,106272000,106490340,218341,204257,14084,0.06450460518180277,2021-11-12 09:39:13 UTC
783016,mainnet,246,106272000,106490500,218501,204409,14092,0.0644939840092265,2021-11-12 09:40:45 UTC
783018,mainnet,246,106272000,106490695,218696,204598,14098,0.06446391337747376,2021-11-12 09:42:44 UTC
783019,mainnet,246,106272000,106490938,218939,204803,14136,0.06456592932277941,2021-11-12 09:45:11 UTC
783021,mainnet,246,106272000,106491122,219123,204972,14151,0.06458016730329541,2021-11-12 09:46:53 UTC
783023,mainnet,246,106272000,106491315,219316,205137,14179,0.06465100585456601,2021-11-12 09:48:41 UTC
783024,mainnet,246,106272000,106491488,219489,205295,14194,0.0646683888486439,2021-11-12 09:50:09 UTC
783025,mainnet,246,106272000,106491643,219644,205445,14199,0.06464551729161734,2021-11-12 09:51:38 UTC
783027,mainnet,246,106272000,106491791,219792,205569,14223,0.06471118148067263,2021-11-12 09:53:09 UTC
783028,mainnet,246,106272000,106491959,219960,205713,14247,0.0647708674304419,2021-11-12 09:54:37 UTC
783030,mainnet,246,106272000,106492112,220113,205853,14260,0.064784905934679,2021-11-12 09:56:07 UTC
783031,mainnet,246,106272000,106492282,220283,206003,14280,0.06482570148400013,2021-11-12 09:57:42 UTC
783033,mainnet,246,106272000,106492436,220437,206143,14294,0.06484392366072846,2021-11-12 09:59:13 UTC
783034,mainnet,246,106272000,106492589,220590,206286,14304,0.06484428124575004,2021-11-12 10:00:51 UTC
783036,mainnet,246,106272000,106492738,220739,206412,14327,0.06490470646328922,2021-11-12 10:02:23 UTC
783037,mainnet,246,106272000,106492918,220919,206577,14342,0.0649197217079563,2021-11-12 10:03:53 UTC
783039,mainnet,246,106272000,106493085,221086,206726,14360,0.06495210008774865,2021-11-12 10:05:19 UTC
783040,mainnet,246,106272000,106493233,221234,206863,14371,0.06495836987081552,2021-11-12 10:06:47 UTC
783042,mainnet,246,106272000,106493392,221393,207005,14388,0.06498850460493331,2021-11-12 10:08:20 UTC
783043,mainnet,246,106272000,106493573,221574,207164,14410,0.06503470623809653,2021-11-12 10:09:48 UTC
783045,mainnet,246,106272000,106493725,221726,207301,14425,0.06505777400936291,2021-11-12 10:11:14 UTC
783046,mainnet,246,106272000,106493897,221898,207457,14441,0.06507945091889066,2021-11-12 10:12:53 UTC
783048,mainnet,246,106272000,106494029,222030,207582,14448,0.06507228752871233,2021-11-12 10:14:23 UTC
783049,mainnet,246,106272000,106494220,222221,207754,14467,0.06510185806021933,2021-11-12 10:15:48 UTC
783051,mainnet,246,106272000,106494356,222357,207889,14468,0.06506653714522143,2021-11-12 10:17:16 UTC
783052,mainnet,246,106272000,106494539,222540,208044,14496,0.06513885144243732,2021-11-12 10:18:45 UTC
783054,mainnet,246,106272000,106494695,222696,208194,14502,0.06512016381075547,2021-11-12 10:20:13 UTC
783055,mainnet,246,106272000,106494852,222853,208341,14512,0.06511915926642226,2021-11-12 10:21:42 UTC
783057,mainnet,246,106272000,106495019,223020,208496,14524,0.06512420410725496,2021-11-12 10:23:22 UTC
783058,mainnet,246,106272000,106495194,223195,208664,14531,0.06510450502923452,2021-11-12 10:24:55 UTC
783060,mainnet,246,106272000,106495368,223369,208829,14540,0.06509408198989117,2021-11-12 10:26:27 UTC
783061,mainnet,246,106272000,106495560,223561,209004,14557,0.06511421938531319,2021-11-12 10:28:04 UTC
783063,mainnet,246,106272000,106495725,223726,209158,14568,0.06511536432958172,2021-11-12 10:29:36 UTC
783064,mainnet,246,106272000,106495886,223887,209317,14570,0.06507747211763076,2021-11-12 10:31:07 UTC
783065,mainnet,246,106272000,106496077,224078,209495,14583,0.0650800167798713,2021-11-12 10:32:51 UTC
783067,mainnet,246,106272000,106496256,224257,209662,14595,0.06508158050807779,2021-11-12 10:34:26 UTC
783068,mainnet,246,106272000,106496436,224437,209833,14604,0.0650694849779671,2021-11-12 10:35:54 UTC
783070,mainnet,246,106272000,106496665,224666,210048,14618,0.06506547497173581,2021-11-12 10:38:00 UTC
783071,mainnet,246,106272000,106496856,224857,210221,14636,0.06509025736356884,2021-11-12 10:39:46 UTC
783073,mainnet,246,106272000,106497059,225060,210412,14648,0.06508486625788679,2021-11-12 10:41:32 UTC
783074,mainnet,246,106272000,106497239,225240,210582,14658,0.06507725093233883,2021-11-12 10:43:03 UTC
783076,mainnet,246,106272000,106497416,225417,210753,14664,0.06505276886836396,2021-11-12 10:44:33 UTC
783077,mainnet,246,106272000,106497593,225594,210923,14671,0.065032757963421,2021-11-12 10:46:15 UTC
783079,mainnet,246,106272000,106497756,225757,211066,14691,0.06507439414946159,2021-11-12 10:48:17 UTC
783081,mainnet,246,106272000,106498019,226020,211301,14719,0.06512255552605964,2021-11-12 10:50:21 UTC
783082,mainnet,246,106272000,106498141,226142,211410,14732,0.06514490895101308,2021-11-12 10:52:04 UTC
783084,mainnet,246,106272000,106498386,226387,211633,14754,0.06517158670771732,2021-11-12 10:53:35 UTC
783085,mainnet,246,106272000,106498619,226620,211854,14766,0.06515753243314801,2021-11-12 10:55:38 UTC
783087,mainnet,246,106272000,106498770,226771,211995,14776,0.06515824333799296,2021-11-12 10:57:04 UTC
783088,mainnet,246,106272000,106498934,226935,212140,14795,0.06519487959107233,2021-11-12 10:58:32 UTC
783090,mainnet,246,106272000,106499063,227064,212256,14808,0.0652150935419089,2021-11-12 11:00:01 UTC
783091,mainnet,246,106272000,106499276,227277,212442,14835,0.06527277287187001,2021-11-12 11:01:58 UTC
783093,mainnet,246,106272000,106499441,227442,212607,14835,0.06522542010710423,2021-11-12 11:03:30 UTC
783094,mainnet,246,106272000,106499582,227583,212737,14846,0.06523334343953635,2021-11-12 11:04:55 UTC
783096,mainnet,246,106272000,106499758,227759,212890,14869,0.06528391852791766,2021-11-12 11:06:26 UTC
783097,mainnet,246,106272000,106499916,227917,213046,14871,0.06524743656682037,2021-11-12 11:07:54 UTC
783099,mainnet,246,106272000,106500096,228097,213210,14887,0.06526609293414644,2021-11-12 11:09:25 UTC
783100,mainnet,246,106272000,106500257,228258,213369,14889,0.06522882001945167,2021-11-12 11:10:53 UTC
783102,mainnet,246,106272000,106500428,228429,213520,14909,0.06526754483887773,2021-11-12 11:12:21 UTC
783103,mainnet,246,106272000,106500594,228595,213677,14918,0.06525952011198845,2021-11-12 11:13:53 UTC
783105,mainnet,246,106272000,106500772,228773,213846,14927,0.06524808434561771,2021-11-12 11:15:19 UTC
783106,mainnet,246,106272000,106500922,228923,213988,14935,0.06524027729848028,2021-11-12 11:16:46 UTC
783108,mainnet,246,106272000,106501114,229115,214167,14948,0.06524234554699605,2021-11-12 11:18:34 UTC
783109,mainnet,246,106272000,106501274,229275,214320,14955,0.0652273470722931,2021-11-12 11:20:05 UTC
783111,mainnet,246,106272000,106501463,229464,214467,14997,0.06535665725342538,2021-11-12 11:21:34 UTC
783112,mainnet,246,106272000,106501646,229647,214641,15006,0.06534376673764516,2021-11-12 11:23:03 UTC
783114,mainnet,246,106272000,106501801,229802,214794,15008,0.06530839592344714,2021-11-12 11:24:42 UTC
783115,mainnet,246,106272000,106502000,230001,214974,15027,0.0653344985456585,2021-11-12 11:26:11 UTC
783117,mainnet,246,106272000,106502180,230181,215135,15046,0.06536595114279632,2021-11-12 11:27:51 UTC
783118,mainnet,246,106272000,106502333,230334,215284,15050,0.06533989771375481,2021-11-12 11:29:20 UTC
783120,mainnet,246,106272000,106502487,230488,215418,15070,0.06538301343236957,2021-11-12 11:30:49 UTC
783121,mainnet,246,106272000,106502663,230664,215589,15075,0.06535480178961607,2021-11-12 11:32:19 UTC
783123,mainnet,246,106272000,106502852,230853,215753,15100,0.06540958965228955,2021-11-12 11:33:47 UTC
783124,mainnet,246,106272000,106503054,231055,215949,15106,0.06537837311462638,2021-11-12 11:35:28 UTC
783126,mainnet,246,106272000,106503254,231255,216136,15119,0.06537804588008908,2021-11-12 11:37:06 UTC
783127,mainnet,246,106272000,106503436,231437,216313,15124,0.06534823731728288,2021-11-12 11:38:44 UTC
783129,mainnet,246,106272000,106503603,231604,216464,15140,0.06537020086008877,2021-11-12 11:40:13 UTC
783130,mainnet,246,106272000,106503772,231773,216620,15153,0.06537862477510323,2021-11-12 11:41:42 UTC
783132,mainnet,246,106272000,106503929,231930,216762,15168,0.06539904281464234,2021-11-12 11:43:12 UTC
783133,mainnet,246,106272000,106504105,232106,216932,15174,0.06537530266343826,2021-11-12 11:44:50 UTC
783135,mainnet,246,106272000,106504239,232240,217044,15196,0.06543231140199793,2021-11-12 11:46:18 UTC
783136,mainnet,246,106272000,106504425,232426,217204,15222,0.06549181244783286,2021-11-12 11:47:55 UTC
783138,mainnet,246,106272000,106504583,232584,217356,15228,0.06547311938912392,2021-11-12 11:49:24 UTC
783139,mainnet,246,106272000,106504764,232765,217519,15246,0.06549953816080596,2021-11-12 11:50:57 UTC
783141,mainnet,246,106272000,106504902,232903,217642,15261,0.06552513278059965,2021-11-12 11:52:24 UTC
783142,mainnet,246,106272000,106505085,233086,217802,15284,0.0655723638485366,2021-11-12 11:53:53 UTC
783144,mainnet,246,106272000,106505249,233250,217952,15298,0.06558628081457664,2021-11-12 11:55:24 UTC
783145,mainnet,246,106272000,106505459,233460,218153,15307,0.0655658356891973,2021-11-12 11:57:23 UTC
783147,mainnet,246,106272000,106505650,233651,218322,15329,0.0656063958639167,2021-11-12 11:58:53 UTC
783148,mainnet,246,106272000,106505831,233832,218494,15338,0.06559410174826372,2021-11-12 12:00:27 UTC
783150,mainnet,246,106272000,106505995,233996,218640,15356,0.06562505341971657,2021-11-12 12:01:57 UTC
783151,mainnet,246,106272000,106506154,234155,218783,15372,0.06564882236125644,2021-11-12 12:03:26 UTC
783153,mainnet,246,106272000,106506312,234313,218924,15389,0.0656771071174028,2021-11-12 12:05:03 UTC
783154,mainnet,246,106272000,106506488,234489,219081,15408,0.0657088392206031,2021-11-12 12:06:55 UTC
783156,mainnet,246,106272000,106506655,234656,219217,15439,0.06579418382653757,2021-11-12 12:08:34 UTC
783157,mainnet,246,106272000,106506811,234812,219357,15455,0.06581861233667785,2021-11-12 12:10:02 UTC
783159,mainnet,246,106272000,106506924,234925,219455,15470,0.0658508034479089,2021-11-12 12:12:03 UTC
783161,mainnet,246,106272000,106507231,235232,219724,15508,0.06592640457080669,2021-11-12 12:13:43 UTC
783162,mainnet,246,106272000,106507391,235392,219871,15521,0.06593682028276238,2021-11-12 12:15:24 UTC
783164,mainnet,246,106272000,106507592,235593,220063,15530,0.06591876668661632,2021-11-12 12:17:24 UTC
783165,mainnet,246,106272000,106507744,235745,220194,15551,0.06596534390973298,2021-11-12 12:18:51 UTC
783167,mainnet,246,106272000,106507883,235884,220307,15577,0.06603669600312018,2021-11-12 12:20:18 UTC
783168,mainnet,246,106272000,106508064,236065,220461,15604,0.06610043843856565,2021-11-12 12:21:45 UTC
783170,mainnet,246,106272000,106508213,236214,220606,15608,0.0660756771402203,2021-11-12 12:23:12 UTC
783171,mainnet,246,106272000,106508382,236383,220756,15627,0.06610881493169983,2021-11-12 12:24:43 UTC
783173,mainnet,246,106272000,106508631,236632,220990,15642,0.06610264038676088,2021-11-12 12:27:08 UTC
783175,mainnet,246,106272000,106508839,236840,221194,15646,0.0660614761020098,2021-11-12 12:28:54 UTC
783176,mainnet,246,106272000,106509035,237036,221373,15663,0.06607857034374526,2021-11-12 12:30:31 UTC
783178,mainnet,246,106272000,106509210,237211,221543,15668,0.06605089983179532,2021-11-12 12:32:03 UTC
783179,mainnet,246,106272000,106509367,237368,221694,15674,0.06603248963634525,2021-11-12 12:33:34 UTC
783181,mainnet,246,106272000,106509563,237564,221864,15700,0.06608745432809685,2021-11-12 12:35:16 UTC
783182,mainnet,246,106272000,106509730,237731,222026,15705,0.066062061742053,2021-11-12 12:36:49 UTC
783184,mainnet,246,106272000,106509908,237909,222194,15715,0.06605466796127932,2021-11-12 12:38:23 UTC
783185,mainnet,246,106272000,106510096,238097,222374,15723,0.06603611133277613,2021-11-12 12:39:53 UTC
783187,mainnet,246,106272000,106510267,238268,222539,15729,0.06601390031393221,2021-11-12 12:41:23 UTC
783188,mainnet,246,106272000,106510429,238430,222691,15739,0.06601098855009856,2021-11-12 12:42:51 UTC
783189,mainnet,246,106272000,106510606,238607,222849,15758,0.0660416500773238,2021-11-12 12:44:21 UTC
783191,mainnet,246,106272000,106510774,238775,223015,15760,0.06600355983666632,2021-11-12 12:45:56 UTC
783192,mainnet,246,106272000,106510940,238941,223165,15776,0.06602466717725296,2021-11-12 12:47:21 UTC
783194,mainnet,246,106272000,106511104,239105,223323,15782,0.0660044750214341,2021-11-12 12:48:48 UTC
783195,mainnet,246,106272000,106511262,239263,223469,15794,0.06601104224221882,2021-11-12 12:50:18 UTC
783197,mainnet,246,106272000,106511408,239409,223601,15808,0.06602926372859834,2021-11-12 12:51:50 UTC
783198,mainnet,246,106272000,106511546,239547,223711,15836,0.0661081123954798,2021-11-12 12:53:17 UTC
783200,mainnet,246,106272000,106511735,239736,223885,15851,0.06611856375346215,2021-11-12 12:54:56 UTC
783201,mainnet,246,106272000,106511918,239919,224053,15866,0.06613065242852796,2021-11-12 12:56:35 UTC
783203,mainnet,246,106272000,106512092,240093,224214,15879,0.06613687196211468,2021-11-12 12:58:04 UTC
783204,mainnet,246,106272000,106512268,240269,224362,15907,0.06620496193849394,2021-11-12 12:59:34 UTC
783206,mainnet,246,106272000,106512420,240421,224500,15921,0.06622133673847126,2021-11-12 13:01:07 UTC
783207,mainnet,246,106272000,106512614,240615,224656,15959,0.06632587328304552,2021-11-12 13:03:04 UTC
783209,mainnet,246,106272000,106512778,240779,224779,16000,0.06645097786767118,2021-11-12 13:04:32 UTC
783210,mainnet,246,106272000,106512943,240944,224929,16015,0.06646772694069991,2021-11-12 13:06:05 UTC
783212,mainnet,246,106272000,106513102,241103,225083,16020,0.06644463154751289,2021-11-12 13:07:37 UTC
783213,mainnet,246,106272000,106513251,241252,225224,16028,0.06643675492845655,2021-11-12 13:09:13 UTC
783215,mainnet,246,106272000,106513428,241429,225379,16050,0.06647917193046403,2021-11-12 13:10:48 UTC
783216,mainnet,246,106272000,106513569,241570,225505,16065,0.0665024630541872,2021-11-12 13:12:21 UTC
783218,mainnet,246,106272000,106513725,241726,225641,16085,0.06654228341179683,2021-11-12 13:14:02 UTC
783219,mainnet,246,106272000,106513868,241869,225776,16093,0.06653601743092336,2021-11-12 13:15:38 UTC
783221,mainnet,246,106272000,106513945,241946,225841,16105,0.06656443999900805,2021-11-12 13:17:13 UTC
783222,mainnet,246,106272000,106514245,242246,226098,16148,0.06665951140576108,2021-11-12 13:19:11 UTC
783224,mainnet,246,106272000,106514415,242416,226236,16180,0.06674476932215695,2021-11-12 13:20:44 UTC
783225,mainnet,246,106272000,106514551,242552,226366,16186,0.06673208219268445,2021-11-12 13:22:19 UTC
783226,mainnet,246,106272000,106514727,242728,226515,16213,0.06679493095151774,2021-11-12 13:23:53 UTC
783227,mainnet,246,106272000,106514892,242893,226668,16225,0.06679896085930842,2021-11-12 13:25:27 UTC
783229,mainnet,246,106272000,106515103,243104,226862,16242,0.06681091220218507,2021-11-12 13:27:28 UTC
783231,mainnet,246,106272000,106515248,243249,227001,16248,0.06679575250052415,2021-11-12 13:28:55 UTC
783232,mainnet,246,106272000,106515470,243471,227218,16253,0.06675538359804659,2021-11-12 13:30:58 UTC
783234,mainnet,246,106272000,106515684,243685,227406,16279,0.06680345528038246,2021-11-12 13:32:44 UTC
783235,mainnet,246,106272000,106515909,243910,227613,16297,0.06681562871550982,2021-11-12 13:34:40 UTC
783237,mainnet,246,106272000,106516079,244080,227777,16303,0.06679367420517864,2021-11-12 13:36:10 UTC
783238,mainnet,246,106272000,106516254,244255,227938,16317,0.06680313606681541,2021-11-12 13:37:42 UTC
783240,mainnet,246,106272000,106516468,244469,228139,16330,0.06679783530836221,2021-11-12 13:39:41 UTC
783242,mainnet,246,106272000,106516633,244634,228293,16341,0.0667977468381337,2021-11-12 13:41:21 UTC
783243,mainnet,246,106272000,106516803,244804,228454,16350,0.06678812437705266,2021-11-12 13:42:48 UTC
783245,mainnet,246,106272000,106516878,244879,228524,16355,0.066788087177749,2021-11-12 13:44:28 UTC
783246,mainnet,246,106272000,106517120,245121,228716,16405,0.06692613036010786,2021-11-12 13:46:06 UTC
783248,mainnet,246,106272000,106517283,245284,228833,16451,0.06706919326168849,2021-11-12 13:47:47 UTC
783249,mainnet,246,106272000,106517407,245408,228926,16482,0.06716162472291042,2021-11-12 13:49:13 UTC
783251,mainnet,246,106272000,106517504,245505,228991,16514,0.06726543247591699,2021-11-12 13:50:37 UTC
783252,mainnet,246,106272000,106517704,245705,229140,16565,0.06741824545695041,2021-11-12 13:52:05 UTC
783254,mainnet,246,106272000,106517855,245856,229256,16600,0.06751919822985814,2021-11-12 13:53:41 UTC
783255,mainnet,246,106272000,106517957,245958,229331,16627,0.06760097252376422,2021-11-12 13:55:07 UTC
783257,mainnet,246,106272000,106518152,246153,229465,16688,0.0677952330461136,2021-11-12 13:56:42 UTC
783258,mainnet,246,106272000,106518257,246258,229531,16727,0.06792469686264,2021-11-12 13:58:06 UTC
783260,mainnet,246,106272000,106518375,246376,229607,16769,0.06806263597103614,2021-11-12 13:59:34 UTC
783261,mainnet,246,106272000,106518469,246470,229663,16807,0.06819085487077535,2021-11-12 14:01:06 UTC
783263,mainnet,246,106272000,106518690,246691,229789,16902,0.06851486272300165,2021-11-12 14:02:31 UTC
783264,mainnet,246,106272000,106518810,246811,229893,16918,0.06854637759257083,2021-11-12 14:04:06 UTC
783266,mainnet,246,106272000,106518924,246925,229977,16948,0.06863622557456718,2021-11-12 14:05:34 UTC
783267,mainnet,246,106272000,106519084,247085,230084,17001,0.06880628123924964,2021-11-12 14:07:03 UTC
783269,mainnet,246,106272000,106519175,247176,230164,17012,0.06882545230928569,2021-11-12 14:08:41 UTC
783270,mainnet,246,106272000,106519324,247325,230282,17043,0.06890932982917214,2021-11-12 14:10:16 UTC
783272,mainnet,246,106272000,106519445,247446,230389,17057,0.06893221147240206,2021-11-12 14:11:47 UTC
783273,mainnet,246,106272000,106519584,247585,230484,17101,0.06907122806308945,2021-11-12 14:13:16 UTC
783274,mainnet,246,106272000,106519738,247739,230599,17140,0.06918571561199488,2021-11-12 14:14:46 UTC
783275,mainnet,246,106272000,106519873,247874,230691,17183,0.06932151012207816,2021-11-12 14:16:16 UTC
783277,mainnet,246,106272000,106519978,247979,230778,17201,0.06936474459530848,2021-11-12 14:17:42 UTC
783278,mainnet,246,106272000,106520110,248111,230872,17239,0.06948099842409244,2021-11-12 14:19:07 UTC
783280,mainnet,246,106272000,106520244,248245,230976,17269,0.06956434167858366,2021-11-12 14:20:37 UTC
783281,mainnet,246,106272000,106520382,248383,231082,17301,0.06965452547074477,2021-11-12 14:22:06 UTC
783283,mainnet,246,106272000,106520498,248499,231166,17333,0.06975078370536703,2021-11-12 14:23:34 UTC
783284,mainnet,246,106272000,106520595,248596,231246,17350,0.06979195160018664,2021-11-12 14:25:07 UTC
783285,mainnet,246,106272000,106520723,248724,231348,17376,0.0698605683408115,2021-11-12 14:26:47 UTC
783286,mainnet,246,106272000,106520885,248886,231475,17411,0.06995572270035277,2021-11-12 14:28:27 UTC
783287,mainnet,246,106272000,106521027,249028,231587,17441,0.07003630113882776,2021-11-12 14:30:00 UTC
783288,mainnet,246,106272000,106521149,249150,231692,17458,0.07007023881196067,2021-11-12 14:31:28 UTC
783289,mainnet,246,106272000,106521287,249288,231803,17485,0.07013975803087193,2021-11-12 14:33:13 UTC
783291,mainnet,246,106272000,106521416,249417,231901,17516,0.0702277711623506,2021-11-12 14:34:40 UTC
783293,mainnet,246,106272000,106521610,249611,232080,17531,0.07023328298832984,2021-11-12 14:36:19 UTC
783294,mainnet,246,106272000,106521768,249769,232215,17554,0.07028093958817948,2021-11-12 14:37:59 UTC
783296,mainnet,246,106272000,106521889,249890,232332,17558,0.07026291568290048,2021-11-12 14:39:24 UTC
783297,mainnet,246,106272000,106522044,250045,232463,17582,0.07031534323821712,2021-11-12 14:40:56 UTC
783299,mainnet,246,106272000,106522264,250265,232658,17607,0.07035342536910874,2021-11-12 14:43:04 UTC
783300,mainnet,246,106272000,106522446,250447,232833,17614,0.07033024951386921,2021-11-12 14:44:43 UTC
783302,mainnet,246,106272000,106522585,250586,232957,17629,0.07035109702856504,2021-11-12 14:46:22 UTC
783303,mainnet,246,106272000,106522786,250787,233135,17652,0.07038642353870017,2021-11-12 14:48:00 UTC
783305,mainnet,246,106272000,106522933,250934,233271,17663,0.07038902659663497,2021-11-12 14:49:38 UTC
783306,mainnet,246,106272000,106523117,251118,233439,17679,0.0704011659857119,2021-11-12 14:51:08 UTC
783308,mainnet,246,106272000,106523253,251254,233568,17686,0.07039091914954587,2021-11-12 14:52:34 UTC
783309,mainnet,246,106272000,106523410,251411,233707,17704,0.07041855766056378,2021-11-12 14:54:12 UTC
783311,mainnet,246,106272000,106523677,251678,233943,17735,0.0704670253260118,2021-11-12 14:56:12 UTC
783312,mainnet,246,106272000,106523818,251819,234076,17743,0.07045933785774704,2021-11-12 14:57:47 UTC
783314,mainnet,246,106272000,106524022,252023,234254,17769,0.07050546973887303,2021-11-12 14:59:25 UTC
783315,mainnet,246,106272000,106524225,252226,234450,17776,0.07047647744483122,2021-11-12 15:01:18 UTC
783317,mainnet,246,106272000,106524420,252421,234628,17793,0.07048938083598433,2021-11-12 15:03:23 UTC
783319,mainnet,246,106272000,106524571,252572,234767,17805,0.0704947500118778,2021-11-12 15:04:55 UTC
783320,mainnet,246,106272000,106524724,252725,234908,17817,0.07049955485211198,2021-11-12 15:06:26 UTC
783322,mainnet,246,106272000,106524870,252871,235028,17843,0.07056166978419827,2021-11-12 15:07:57 UTC
783323,mainnet,246,106272000,106525050,253051,235177,17874,0.0706339828730177,2021-11-12 15:09:31 UTC
783325,mainnet,246,106272000,106525197,253198,235288,17910,0.07073515588590747,2021-11-12 15:11:10 UTC
783326,mainnet,246,106272000,106525384,253385,235453,17932,0.07076977721648874,2021-11-12 15:12:46 UTC
783328,mainnet,246,106272000,106525550,253551,235606,17945,0.07077471593486123,2021-11-12 15:14:26 UTC
783330,mainnet,246,106272000,106525687,253688,235730,17958,0.07078773927028476,2021-11-12 15:15:57 UTC
783331,mainnet,246,106272000,106525832,253833,235856,17977,0.07082215472377508,2021-11-12 15:17:25 UTC
783333,mainnet,246,106272000,106526017,254018,236011,18007,0.0708886771803573,2021-11-12 15:19:01 UTC
783334,mainnet,246,106272000,106526152,254153,236120,18033,0.07095332339181516,2021-11-12 15:20:29 UTC
783336,mainnet,246,106272000,106526343,254344,236283,18061,0.07101012801560092,2021-11-12 15:22:30 UTC
783338,mainnet,246,106272000,106526552,254553,236474,18079,0.07102253754620845,2021-11-12 15:24:37 UTC
783339,mainnet,246,106272000,106526715,254716,236611,18105,0.07107916267529327,2021-11-12 15:26:07 UTC
783341,mainnet,246,106272000,106526881,254882,236751,18131,0.07113487810045432,2021-11-12 15:27:45 UTC
783342,mainnet,246,106272000,106527058,255059,236910,18149,0.07115608545473792,2021-11-12 15:29:23 UTC
783344,mainnet,246,106272000,106527194,255195,237023,18172,0.07120829169850507,2021-11-12 15:30:53 UTC
783345,mainnet,246,106272000,106527348,255349,237165,18184,0.0712123407571598,2021-11-12 15:32:33 UTC
783347,mainnet,246,106272000,106527523,255524,237320,18204,0.07124184029680186,2021-11-12 15:34:11 UTC
783348,mainnet,246,106272000,106527676,255677,237448,18229,0.0712969879965738,2021-11-12 15:35:39 UTC
783350,mainnet,246,106272000,106527824,255825,237586,18239,0.07129483045050328,2021-11-12 15:37:12 UTC
783351,mainnet,246,106272000,106528004,256005,237743,18262,0.07133454424718268,2021-11-12 15:38:50 UTC
783353,mainnet,246,106272000,106528180,256181,237902,18279,0.07135189572997216,2021-11-12 15:40:27 UTC
783354,mainnet,246,106272000,106528314,256315,238033,18282,0.07132629771960283,2021-11-12 15:41:54 UTC
783356,mainnet,246,106272000,106528479,256480,238177,18303,0.07136228945726762,2021-11-12 15:43:25 UTC
783357,mainnet,246,106272000,106528640,256641,238325,18316,0.07136817577861682,2021-11-12 15:44:58 UTC
783358,mainnet,246,106272000,106528798,256799,238454,18345,0.07143719407007036,2021-11-12 15:46:31 UTC
783360,mainnet,246,106272000,106528944,256945,238572,18373,0.07150557512308081,2021-11-12 15:48:05 UTC
783362,mainnet,246,106272000,106529146,257147,238750,18397,0.07154273625591588,2021-11-12 15:49:50 UTC
783363,mainnet,246,106272000,106529301,257302,238876,18426,0.07161234658106039,2021-11-12 15:51:35 UTC
783365,mainnet,246,106272000,106529470,257471,239012,18459,0.07169351111387302,2021-11-12 15:53:02 UTC
783366,mainnet,246,106272000,106529640,257641,239163,18478,0.07171995140524993,2021-11-12 15:54:33 UTC
783368,mainnet,246,106272000,106529777,257778,239289,18489,0.07172450713404557,2021-11-12 15:56:05 UTC
783369,mainnet,246,106272000,106529954,257955,239444,18511,0.07176057839545658,2021-11-12 15:57:35 UTC
783371,mainnet,246,106272000,106530103,258104,239573,18531,0.07179664011406255,2021-11-12 15:59:09 UTC
783372,mainnet,246,106272000,106530259,258260,239724,18536,0.07177263223108496,2021-11-12 16:00:43 UTC
783374,mainnet,246,106272000,106530420,258421,239872,18549,0.07177822235809009,2021-11-12 16:02:15 UTC
783375,mainnet,246,106272000,106530583,258584,240022,18562,0.07178325031711165,2021-11-12 16:04:14 UTC
783377,mainnet,246,106272000,106530799,258800,240213,18587,0.07181993817619783,2021-11-12 16:05:52 UTC
783379,mainnet,246,106272000,106530926,258927,240301,18626,0.07193533312478034,2021-11-12 16:07:27 UTC
783380,mainnet,246,106272000,106531104,259105,240438,18667,0.07204415198471661,2021-11-12 16:08:57 UTC
783382,mainnet,246,106272000,106531275,259276,240588,18688,0.07207763155864792,2021-11-12 16:10:38 UTC
783383,mainnet,246,106272000,106531455,259456,240761,18695,0.07205460656142082,2021-11-12 16:12:17 UTC
783385,mainnet,246,106272000,106531608,259609,240907,18702,0.07203910496169239,2021-11-12 16:13:45 UTC
783386,mainnet,246,106272000,106531791,259792,241073,18719,0.07205379688366077,2021-11-12 16:15:22 UTC
783388,mainnet,246,106272000,106531958,259959,241228,18731,0.07205367000180797,2021-11-12 16:17:03 UTC
783389,mainnet,246,106272000,106532111,260112,241373,18739,0.07204204342744663,2021-11-12 16:18:33 UTC
783391,mainnet,246,106272000,106532269,260270,241513,18757,0.07206746839820187,2021-11-12 16:20:14 UTC
783392,mainnet,246,106272000,106532456,260457,241678,18779,0.07210019312208925,2021-11-12 16:21:42 UTC
783394,mainnet,246,106272000,106532604,260605,241819,18786,0.07208610732718099,2021-11-12 16:23:20 UTC
783396,mainnet,246,106272000,106532846,260847,242040,18807,0.07209973662721826,2021-11-12 16:25:39 UTC
783397,mainnet,246,106272000,106533022,261023,242205,18818,0.07209326381200123,2021-11-12 16:27:19 UTC
783399,mainnet,246,106272000,106533186,261187,242352,18835,0.07211308372928209,2021-11-12 16:28:51 UTC
783401,mainnet,246,106272000,106533429,261430,242585,18845,0.0720843055502429,2021-11-12 16:31:21 UTC
783402,mainnet,246,106272000,106533604,261605,242742,18863,0.0721048909615642,2021-11-12 16:33:04 UTC
783404,mainnet,246,106272000,106533708,261709,242829,18880,0.07214119499138356,2021-11-12 16:34:38 UTC
783405,mainnet,246,106272000,106533952,261953,243052,18901,0.07215416506014438,2021-11-12 16:36:12 UTC
783407,mainnet,246,106272000,106534076,262077,243155,18922,0.07220015491630323,2021-11-12 16:37:39 UTC
783408,mainnet,246,106272000,106534230,262231,243296,18935,0.07220732865298153,2021-11-12 16:39:08 UTC
783410,mainnet,246,106272000,106534373,262374,243414,18960,0.07226325779231174,2021-11-12 16:40:39 UTC
783411,mainnet,246,106272000,106534525,262526,243548,18978,0.07228998270647478,2021-11-12 16:42:09 UTC
783413,mainnet,246,106272000,106534658,262659,243672,18987,0.07228764291343528,2021-11-12 16:43:39 UTC
783414,mainnet,246,106272000,106534790,262791,243791,19000,0.07230080177783867,2021-11-12 16:45:08 UTC
783416,mainnet,246,106272000,106534941,262942,243920,19022,0.07234295015630823,2021-11-12 16:46:44 UTC
783417,mainnet,246,106272000,106535123,263124,244079,19045,0.07238032258554902,2021-11-12 16:48:15 UTC
783419,mainnet,246,106272000,106535252,263253,244206,19047,0.07235245182391084,2021-11-12 16:49:47 UTC
783420,mainnet,246,106272000,106535420,263421,244345,19076,0.07241639808519443,2021-11-12 16:51:21 UTC
783422,mainnet,246,106272000,106535568,263569,244474,19095,0.07244782201245215,2021-11-12 16:52:48 UTC
783423,mainnet,246,106272000,106535758,263759,244633,19126,0.07251316542753043,2021-11-12 16:54:29 UTC
783425,mainnet,246,106272000,106535909,263910,244756,19154,0.07257777272555038,2021-11-12 16:55:59 UTC
783426,mainnet,246,106272000,106536055,264056,244871,19185,0.0726550428696943,2021-11-12 16:57:26 UTC
783428,mainnet,246,106272000,106536204,264205,244987,19218,0.07273897163187676,2021-11-12 16:58:55 UTC
783429,mainnet,246,106272000,106536342,264343,245098,19245,0.07280313834676916,2021-11-12 17:00:32 UTC
783431,mainnet,246,106272000,106536518,264519,245251,19268,0.07284164842601099,2021-11-12 17:02:09 UTC
783432,mainnet,246,106272000,106536670,264671,245384,19287,0.07287160285788771,2021-11-12 17:03:39 UTC
783434,mainnet,246,106272000,106536798,264799,245491,19308,0.07291568321632634,2021-11-12 17:05:07 UTC
783435,mainnet,246,106272000,106536958,264959,245628,19331,0.07295845772364781,2021-11-12 17:06:39 UTC
783437,mainnet,246,106272000,106537111,265112,245764,19348,0.0729804761761067,2021-11-12 17:08:05 UTC
783438,mainnet,246,106272000,106537229,265230,245871,19359,0.07298948082796064,2021-11-12 17:09:33 UTC
783440,mainnet,246,106272000,106537388,265389,246004,19385,0.07304372072693292,2021-11-12 17:11:02 UTC
783441,mainnet,246,106272000,106537554,265555,246159,19396,0.07303948334619947,2021-11-12 17:12:32 UTC
783443,mainnet,246,106272000,106537703,265704,246289,19415,0.0730700328184747,2021-11-12 17:13:58 UTC
783444,mainnet,246,106272000,106537883,265884,246446,19438,0.07310706924824359,2021-11-12 17:15:37 UTC
783446,mainnet,246,106272000,106538015,266016,246566,19450,0.07311590280283893,2021-11-12 17:17:03 UTC
783447,mainnet,246,106272000,106538176,266177,246706,19471,0.07315057273919234,2021-11-12 17:18:44 UTC
783449,mainnet,246,106272000,106538334,266335,246851,19484,0.07315598775977622,2021-11-12 17:20:11 UTC
783450,mainnet,246,106272000,106538501,266502,247008,19494,0.07314766868541324,2021-11-12 17:21:48 UTC
783452,mainnet,246,106272000,106538672,266673,247170,19503,0.07313451305531493,2021-11-12 17:23:30 UTC
783453,mainnet,246,106272000,106538835,266836,247324,19512,0.07312356653525012,2021-11-12 17:25:01 UTC
783455,mainnet,246,106272000,106538976,266977,247461,19516,0.07309992995651311,2021-11-12 17:26:30 UTC
783457,mainnet,246,106272000,106539178,267179,247637,19542,0.07314197597865102,2021-11-12 17:28:35 UTC
783458,mainnet,246,106272000,106539357,267358,247788,19570,0.07319773487234345,2021-11-12 17:30:16 UTC
783460,mainnet,246,106272000,106539513,267514,247929,19585,0.07321112166092242,2021-11-12 17:31:42 UTC
783461,mainnet,246,106272000,106539680,267681,248079,19602,0.07322895536104543,2021-11-12 17:33:21 UTC
783463,mainnet,246,106272000,106539871,267872,248249,19623,0.0732551367817465,2021-11-12 17:34:59 UTC
783464,mainnet,246,106272000,106540085,268086,248447,19639,0.07325634311377692,2021-11-12 17:36:49 UTC
783466,mainnet,246,106272000,106540249,268250,248601,19649,0.07324883504193849,2021-11-12 17:38:20 UTC
783467,mainnet,246,106272000,106540415,268416,248747,19669,0.07327804601812113,2021-11-12 17:39:46 UTC
783469,mainnet,246,106272000,106540560,268561,248881,19680,0.0732794411697901,2021-11-12 17:41:22 UTC
783470,mainnet,246,106272000,106540826,268827,249131,19696,0.07326645017055579,2021-11-12 17:43:08 UTC
783472,mainnet,246,106272000,106540984,268985,249270,19715,0.07329404985408108,2021-11-12 17:45:03 UTC
783474,mainnet,246,106272000,106541201,269202,249453,19749,0.07336126774689639,2021-11-12 17:46:45 UTC
783475,mainnet,246,106272000,106541338,269339,249583,19756,0.07334994189478687,2021-11-12 17:48:12 UTC
783477,mainnet,246,106272000,106541512,269513,249733,19780,0.07339163602497839,2021-11-12 17:49:48 UTC
783478,mainnet,246,106272000,106541687,269688,249900,19788,0.07337367624810892,2021-11-12 17:51:33 UTC
783480,mainnet,246,106272000,106541908,269909,250106,19803,0.0733691725729783,2021-11-12 17:53:35 UTC
783481,mainnet,246,106272000,106542062,270063,250256,19807,0.07334214609183783,2021-11-12 17:55:03 UTC
783483,mainnet,246,106272000,106542215,270216,250399,19817,0.07333762619534002,2021-11-12 17:56:35 UTC
783484,mainnet,246,106272000,106542361,270362,250530,19832,0.07335350382080322,2021-11-12 17:58:09 UTC
783486,mainnet,246,106272000,106542524,270525,250670,19855,0.07339432584788837,2021-11-12 17:59:41 UTC
783487,mainnet,246,106272000,106542775,270776,250891,19885,0.07343708452743226,2021-11-12 18:02:00 UTC
783489,mainnet,246,106272000,106542957,270958,251063,19895,0.07342466360100089,2021-11-12 18:03:43 UTC
783490,mainnet,246,106272000,106543111,271112,251208,19904,0.07341615273392546,2021-11-12 18:05:17 UTC
783492,mainnet,246,106272000,106543266,271267,251350,19917,0.07342212653953485,2021-11-12 18:06:46 UTC
783493,mainnet,246,106272000,106543425,271426,251483,19943,0.07347490660437836,2021-11-12 18:08:28 UTC
783495,mainnet,246,106272000,106543576,271577,251623,19954,0.07347455786020171,2021-11-12 18:10:00 UTC
783496,mainnet,246,106272000,106543750,271751,251772,19979,0.07351950866786139,2021-11-12 18:11:34 UTC
783498,mainnet,246,106272000,106543911,271912,251915,19997,0.07354217540969137,2021-11-12 18:13:05 UTC
783499,mainnet,246,106272000,106544075,272076,252074,20002,0.07351622340816537,2021-11-12 18:14:39 UTC
783501,mainnet,246,106272000,106544228,272229,252214,20015,0.07352265923174973,2021-11-12 18:16:10 UTC
783502,mainnet,246,106272000,106544401,272402,252364,20038,0.07356039970337956,2021-11-12 18:17:47 UTC
783504,mainnet,246,106272000,106544551,272552,252511,20041,0.07353092253955208,2021-11-12 18:19:17 UTC
783505,mainnet,246,106272000,106544705,272706,252653,20053,0.07353340227204389,2021-11-12 18:20:50 UTC
783507,mainnet,246,106272000,106544855,272856,252789,20067,0.07354428709649045,2021-11-12 18:22:20 UTC
783508,mainnet,246,106272000,106545032,273033,252950,20083,0.07355521127482759,2021-11-12 18:23:57 UTC
783510,mainnet,246,106272000,106545178,273179,253081,20098,0.07357080888355254,2021-11-12 18:25:27 UTC
783511,mainnet,246,106272000,106545332,273333,253225,20108,0.07356594337310167,2021-11-12 18:27:01 UTC
783513,mainnet,246,106272000,106545496,273497,253368,20129,0.07359861351312812,2021-11-12 18:28:33 UTC
783514,mainnet,246,106272000,106545654,273655,253501,20154,0.0736474758363633,2021-11-12 18:30:06 UTC
783516,mainnet,246,106272000,106545814,273815,253648,20167,0.07365191826598251,2021-11-12 18:31:41 UTC
783517,mainnet,246,106272000,106546005,274006,253827,20179,0.07364437275096165,2021-11-12 18:33:25 UTC
783519,mainnet,246,106272000,106546175,274176,253977,20199,0.07367165616246499,2021-11-12 18:34:57 UTC
783521,mainnet,246,106272000,106546321,274322,254108,20214,0.0736871268071828,2021-11-12 18:36:34 UTC
783522,mainnet,246,106272000,106546489,274490,254262,20228,0.07369303071150134,2021-11-12 18:38:18 UTC
783524,mainnet,246,106272000,106546672,274673,254420,20253,0.07373495028634049,2021-11-12 18:39:49 UTC
783525,mainnet,246,106272000,106546840,274841,254585,20256,0.07370079427741857,2021-11-12 18:41:22 UTC
783527,mainnet,246,106272000,106547002,275003,254741,20262,0.07367919622695025,2021-11-12 18:42:52 UTC
783528,mainnet,246,106272000,106547174,275175,254902,20273,0.07367311710729536,2021-11-12 18:44:26 UTC
783530,mainnet,246,106272000,106547316,275317,255011,20306,0.07375498062233717,2021-11-12 18:46:01 UTC
783531,mainnet,246,106272000,106547476,275477,255154,20323,0.0737738540785619,2021-11-12 18:47:30 UTC
783533,mainnet,246,106272000,106547640,275641,255298,20343,0.07380251849325753,2021-11-12 18:49:01 UTC
783534,mainnet,246,106272000,106547794,275795,255447,20348,0.07377943762577277,2021-11-12 18:50:29 UTC
783536,mainnet,246,106272000,106547929,275930,255575,20355,0.07376870945529664,2021-11-12 18:52:02 UTC
783537,mainnet,246,106272000,106548109,276110,255723,20387,0.07383651443265365,2021-11-12 18:53:33 UTC
783539,mainnet,246,106272000,106548243,276244,255848,20396,0.07383327782684873,2021-11-12 18:55:16 UTC
783540,mainnet,246,106272000,106548489,276490,256075,20415,0.07383630511049225,2021-11-12 18:56:47 UTC
783542,mainnet,246,106272000,106548626,276627,256186,20441,0.07389372693193362,2021-11-12 18:58:19 UTC
783543,mainnet,246,106272000,106548824,276825,256362,20463,0.07392034678948795,2021-11-12 18:59:50 UTC
783545,mainnet,246,106272000,106549031,277032,256556,20476,0.0739120390424211,2021-11-12 19:01:50 UTC
783546,mainnet,246,106272000,106549236,277237,256743,20494,0.07392231195691773,2021-11-12 19:03:53 UTC
783548,mainnet,246,106272000,106549398,277399,256881,20518,0.07396565957339428,2021-11-12 19:05:27 UTC
783549,mainnet,246,106272000,106549551,277552,257027,20525,0.07395010664668242,2021-11-12 19:06:57 UTC
783551,mainnet,246,106272000,106549704,277705,257166,20539,0.07395977746169496,2021-11-12 19:08:29 UTC
783552,mainnet,246,106272000,106549872,277873,257320,20553,0.0739654446455755,2021-11-12 19:10:01 UTC
783554,mainnet,246,106272000,106550053,278054,257498,20556,0.07392808591136973,2021-11-12 19:11:43 UTC
783555,mainnet,246,106272000,106550230,278231,257657,20574,0.0739457501141138,2021-11-12 19:13:17 UTC
783557,mainnet,246,106272000,106550406,278407,257826,20581,0.07392414702216539,2021-11-12 19:15:20 UTC
783559,mainnet,246,106272000,106550693,278694,258094,20600,0.07391619482299583,2021-11-12 19:17:34 UTC
783560,mainnet,246,106272000,106550903,278904,258286,20618,0.07392507816309554,2021-11-12 19:19:25 UTC
783562,mainnet,246,106272000,106551099,279100,258476,20624,0.0738946614116804,2021-11-12 19:21:07 UTC
783564,mainnet,246,106272000,106551239,279240,258605,20635,0.07389700615957599,2021-11-12 19:22:39 UTC
783565,mainnet,246,106272000,106551410,279411,258753,20658,0.07393409708279201,2021-11-12 19:24:12 UTC
783567,mainnet,246,106272000,106551580,279581,258913,20668,0.07392490906034387,2021-11-12 19:25:46 UTC
783568,mainnet,246,106272000,106551749,279750,259062,20688,0.07395174262734584,2021-11-12 19:27:17 UTC
783570,mainnet,246,106272000,106551915,279916,259219,20697,0.07394003915460352,2021-11-12 19:28:57 UTC
783571,mainnet,246,106272000,106552097,280098,259387,20711,0.07394197745074937,2021-11-12 19:30:31 UTC
783573,mainnet,246,106272000,106552280,280281,259553,20728,0.07395435295292938,2021-11-12 19:32:13 UTC
783574,mainnet,246,106272000,106552463,280464,259729,20735,0.07393105710536825,2021-11-12 19:33:51 UTC
783576,mainnet,246,106272000,106552637,280638,259889,20749,0.07393510501072556,2021-11-12 19:35:28 UTC
783577,mainnet,246,106272000,106552809,280810,260052,20758,0.07392186887931342,2021-11-12 19:37:04 UTC
783579,mainnet,246,106272000,106553009,281010,260231,20779,0.07394398775844276,2021-11-12 19:38:43 UTC
783580,mainnet,246,106272000,106553183,281184,260387,20797,0.07396224536246727,2021-11-12 19:40:23 UTC
783582,mainnet,246,106272000,106553427,281428,260598,20830,0.07401537871142885,2021-11-12 19:42:11 UTC
783583,mainnet,246,106272000,106553579,281580,260738,20842,0.07401804105405213,2021-11-12 19:43:47 UTC
783585,mainnet,246,106272000,106553732,281733,260877,20856,0.07402753671028953,2021-11-12 19:45:23 UTC
783586,mainnet,246,106272000,106553928,281929,261038,20891,0.07410021672123124,2021-11-12 19:46:59 UTC
783588,mainnet,246,106272000,106554087,282088,261180,20908,0.07411871472731914,2021-11-12 19:48:37 UTC
783589,mainnet,246,106272000,106554283,282284,261369,20915,0.07409204914199884,2021-11-12 19:50:28 UTC
783591,mainnet,246,106272000,106554508,282509,261579,20930,0.0740861353089636,2021-11-12 19:52:24 UTC
783592,mainnet,246,106272000,106554700,282701,261747,20954,0.07412071411137562,2021-11-12 19:54:04 UTC
783594,mainnet,246,106272000,106554851,282852,261898,20954,0.07408114490970542,2021-11-12 19:55:41 UTC
783595,mainnet,246,106272000,106555049,283050,262073,20977,0.0741105811694047,2021-11-12 19:57:28 UTC
783597,mainnet,246,106272000,106555224,283225,262243,20982,0.0740824432871392,2021-11-12 19:59:07 UTC
783598,mainnet,246,106272000,106555402,283403,262404,20999,0.0740958987731252,2021-11-12 20:00:58 UTC
783600,mainnet,246,106272000,106555582,283583,262567,21016,0.07410881470327911,2021-11-12 20:02:39 UTC
783601,mainnet,246,106272000,106555767,283768,262747,21021,0.0740781201544924,2021-11-12 20:04:22 UTC
783603,mainnet,246,106272000,106555933,283934,262910,21024,0.0740453767424824,2021-11-12 20:05:59 UTC
783604,mainnet,246,106272000,106556095,284096,263064,21032,0.0740313133588646,2021-11-12 20:07:37 UTC
783606,mainnet,246,106272000,106556296,284297,263241,21056,0.07406339145330411,2021-11-12 20:09:14 UTC
783607,mainnet,246,106272000,106556448,284449,263387,21062,0.07404490787452232,2021-11-12 20:10:51 UTC
783609,mainnet,246,106272000,106556627,284628,263559,21069,0.07402293519962899,2021-11-12 20:12:42 UTC
783610,mainnet,246,106272000,106556789,284790,263714,21076,0.07400540749324064,2021-11-12 20:14:18 UTC
783612,mainnet,246,106272000,106556972,284973,263852,21121,0.07411579342604387,2021-11-12 20:15:49 UTC
783613,mainnet,246,106272000,106557141,285142,264009,21133,0.0741139502423354,2021-11-12 20:17:25 UTC
783615,mainnet,246,106272000,106557313,285314,264165,21149,0.07412534961481035,2021-11-12 20:19:01 UTC
783616,mainnet,246,106272000,106557471,285472,264311,21161,0.07412635915256137,2021-11-12 20:20:41 UTC
783618,mainnet,246,106272000,106557640,285641,264460,21181,0.07415252012141114,2021-11-12 20:22:19 UTC
783619,mainnet,246,106272000,106557843,285844,264634,21210,0.07420131260407775,2021-11-12 20:23:59 UTC
783621,mainnet,246,106272000,106558012,286013,264801,21212,0.07416446105596598,2021-11-12 20:25:35 UTC
783622,mainnet,246,106272000,106558180,286181,264960,21221,0.07415237210017436,2021-11-12 20:27:12 UTC
783624,mainnet,246,106272000,106558367,286368,265126,21242,0.07417728237791932,2021-11-12 20:28:50 UTC
783625,mainnet,246,106272000,106558536,286537,265274,21263,0.0742068214576128,2021-11-12 20:30:27 UTC
783626,mainnet,246,106272000,106558711,286712,265432,21280,0.0742208208934401,2021-11-12 20:32:03 UTC
783628,mainnet,246,106272000,106558869,286870,265576,21294,0.07422874472757696,2021-11-12 20:33:44 UTC
783629,mainnet,246,106272000,106559069,287070,265767,21303,0.07420838123105862,2021-11-12 20:35:17 UTC
783631,mainnet,246,106272000,106559291,287292,265985,21307,0.07416496108488924,2021-11-12 20:37:13 UTC
783632,mainnet,246,106272000,106559505,287506,266187,21319,0.07415149596877978,2021-11-12 20:39:07 UTC
783634,mainnet,246,106272000,106559708,287709,266380,21329,0.07413393394019652,2021-11-12 20:41:20 UTC
783636,mainnet,246,106272000,106559962,287963,266627,21336,0.07409285220670711,2021-11-12 20:43:02 UTC
783637,mainnet,246,106272000,106560135,288136,266789,21347,0.0740865424660577,2021-11-12 20:44:42 UTC
783639,mainnet,246,106272000,106560359,288360,267004,21356,0.074060202524622,2021-11-12 20:46:38 UTC
783640,mainnet,246,106272000,106560533,288534,267164,21370,0.07406406177434895,2021-11-12 20:48:10 UTC
783642,mainnet,246,106272000,106560720,288721,267334,21387,0.07407497203182312,2021-11-12 20:49:49 UTC
783643,mainnet,246,106272000,106560877,288878,267475,21403,0.07409010031916588,2021-11-12 20:51:18 UTC
783645,mainnet,246,106272000,106561095,289096,267683,21413,0.07406882142955973,2021-11-12 20:53:11 UTC
783646,mainnet,246,106272000,106561271,289272,267858,21414,0.07402721314195636,2021-11-12 20:54:46 UTC
783648,mainnet,246,106272000,106561442,289443,268016,21427,0.07402839246414665,2021-11-12 20:56:18 UTC
783649,mainnet,246,106272000,106561615,289616,268185,21431,0.07399798353682117,2021-11-12 20:57:49 UTC
783651,mainnet,246,106272000,106561792,289793,268355,21438,0.07397694216216402,2021-11-12 20:59:22 UTC
783653,mainnet,246,106272000,106562029,290030,268573,21457,0.07398200186187635,2021-11-12 21:01:30 UTC
783654,mainnet,246,106272000,106562202,290203,268729,21474,0.07399647832723989,2021-11-12 21:03:01 UTC
783656,mainnet,246,106272000,106562416,290417,268933,21484,0.07397638567990165,2021-11-12 21:04:32 UTC
783657,mainnet,246,106272000,106562552,290553,269051,21502,0.07400371016647565,2021-11-12 21:06:01 UTC
783659,mainnet,246,106272000,106562710,290711,269193,21518,0.07401852699072274,2021-11-12 21:07:29 UTC
783660,mainnet,246,106272000,106562879,290880,269355,21525,0.07399958745874588,2021-11-12 21:09:10 UTC
783662,mainnet,246,106272000,106563025,291026,269491,21535,0.0739968250259427,2021-11-12 21:10:37 UTC
783663,mainnet,246,106272000,106563228,291229,269670,21559,0.07402765521290805,2021-11-12 21:12:18 UTC
783665,mainnet,246,106272000,106563410,291411,269843,21568,0.07401230564391872,2021-11-12 21:13:44 UTC
783666,mainnet,246,106272000,106563601,291602,270025,21577,0.07399469139443487,2021-11-12 21:15:23 UTC
783667,mainnet,246,106272000,106563767,291768,270180,21588,0.07399029365797483,2021-11-12 21:16:53 UTC
783669,mainnet,246,106272000,106563940,291941,270346,21595,0.0739704255311861,2021-11-12 21:18:20 UTC
783670,mainnet,246,106272000,106564084,292085,270482,21603,0.07396134686820617,2021-11-12 21:19:46 UTC
783672,mainnet,246,106272000,106564250,292251,270643,21608,0.07393644504210421,2021-11-12 21:21:13 UTC
783673,mainnet,246,106272000,106564426,292427,270784,21643,0.07401163367267728,2021-11-12 21:22:43 UTC
783675,mainnet,246,106272000,106564616,292617,270963,21654,0.07400116876326393,2021-11-12 21:24:22 UTC
783676,mainnet,246,106272000,106564766,292767,271097,21670,0.07401790502344868,2021-11-12 21:25:47 UTC
783678,mainnet,246,106272000,106564923,292924,271244,21680,0.0740123718097527,2021-11-12 21:27:11 UTC
783679,mainnet,246,106272000,106565110,293111,271421,21690,0.07399926990116372,2021-11-12 21:28:49 UTC
783680,mainnet,246,106272000,106565286,293287,271583,21704,0.07400259813766039,2021-11-12 21:30:19 UTC
783681,mainnet,246,106272000,106565460,293461,271741,21720,0.07401324196400885,2021-11-12 21:31:46 UTC
783683,mainnet,246,106272000,106565620,293621,271895,21726,0.07399334516264164,2021-11-12 21:33:15 UTC
783684,mainnet,246,106272000,106565794,293795,272050,21745,0.07401419357034666,2021-11-12 21:34:41 UTC
783686,mainnet,246,106272000,106565970,293971,272207,21764,0.07403451360848519,2021-11-12 21:36:20 UTC
783687,mainnet,246,106272000,106566153,294154,272379,21775,0.07402585040488996,2021-11-12 21:37:48 UTC
783689,mainnet,246,106272000,106566344,294345,272564,21781,0.07399819939187008,2021-11-12 21:39:27 UTC
783691,mainnet,246,106272000,106566526,294527,272742,21785,0.07396605404597881,2021-11-12 21:40:57 UTC
783692,mainnet,246,106272000,106566690,294691,272898,21793,0.07395203789732296,2021-11-12 21:42:30 UTC
783694,mainnet,246,106272000,106566898,294899,273092,21807,0.07394735146609517,2021-11-12 21:44:17 UTC
783695,mainnet,246,106272000,106567078,295079,273262,21817,0.07393613235777538,2021-11-12 21:45:49 UTC
783697,mainnet,246,106272000,106567255,295256,273430,21826,0.07392229116427777,2021-11-12 21:47:20 UTC
783698,mainnet,246,106272000,106567430,295431,273591,21840,0.0739258913248779,2021-11-12 21:48:52 UTC
783700,mainnet,246,106272000,106567587,295588,273733,21855,0.07393737228845555,2021-11-12 21:50:24 UTC
783701,mainnet,246,106272000,106567756,295757,273894,21863,0.07392217259439338,2021-11-12 21:51:59 UTC
783703,mainnet,246,106272000,106567911,295912,274032,21880,0.07394090134904972,2021-11-12 21:53:30 UTC
783704,mainnet,246,106272000,106568083,296084,274189,21895,0.07394860917847638,2021-11-12 21:55:02 UTC
783706,mainnet,246,106272000,106568259,296260,274359,21901,0.07392493080402349,2021-11-12 21:56:35 UTC
783707,mainnet,246,106272000,106568443,296444,274538,21906,0.07389591288742561,2021-11-12 21:58:07 UTC
783708,mainnet,246,106272000,106568639,296640,274715,21925,0.0739111380798274,2021-11-12 21:59:51 UTC
783710,mainnet,246,106272000,106568847,296848,274908,21940,0.07390987980380531,2021-11-12 22:01:42 UTC
783711,mainnet,246,106272000,106569038,297039,275089,21950,0.0738960203878952,2021-11-12 22:03:24 UTC
783713,mainnet,246,106272000,106569224,297225,275259,21966,0.0739036083774918,2021-11-12 22:04:54 UTC
783714,mainnet,246,106272000,106569433,297434,275458,21976,0.07388529892345864,2021-11-12 22:06:37 UTC
783716,mainnet,246,106272000,106569613,297614,275629,21985,0.07387085284966433,2021-11-12 22:08:19 UTC
783717,mainnet,246,106272000,106569809,297810,275815,21995,0.07385581410966724,2021-11-12 22:09:51 UTC
783719,mainnet,246,106272000,106570028,298029,276019,22010,0.07385187347540005,2021-11-12 22:11:40 UTC
783720,mainnet,246,106272000,106570266,298267,276253,22014,0.07380635470903586,2021-11-12 22:13:41 UTC
783722,mainnet,246,106272000,106570473,298474,276448,22026,0.07379537246125291,2021-11-12 22:15:44 UTC
783724,mainnet,246,106272000,106570742,298743,276697,22046,0.07379587136769732,2021-11-12 22:18:03 UTC
783725,mainnet,246,106272000,106571012,299013,276945,22068,0.07380281124900924,2021-11-12 22:20:06 UTC
783727,mainnet,246,106272000,106571212,299213,277134,22079,0.07379024307098957,2021-11-12 22:21:48 UTC
783729,mainnet,246,106272000,106571429,299430,277344,22086,0.07376014427412082,2021-11-12 22:23:56 UTC
783730,mainnet,246,106272000,106571647,299648,277550,22098,0.07374652926099957,2021-11-12 22:25:25 UTC
783732,mainnet,246,106272000,106571826,299827,277717,22110,0.07374252485600029,2021-11-12 22:26:54 UTC
783733,mainnet,246,106272000,106572003,300004,277894,22110,0.07369901734643539,2021-11-12 22:28:25 UTC
783735,mainnet,246,106272000,106572180,300181,278063,22118,0.07368221173225488,2021-11-12 22:29:52 UTC
783736,mainnet,246,106272000,106572362,300363,278237,22126,0.0736641996517547,2021-11-12 22:31:19 UTC
783738,mainnet,246,106272000,106572556,300557,278421,22136,0.07364992330905619,2021-11-12 22:32:51 UTC
783739,mainnet,246,106272000,106572735,300736,278591,22145,0.07363601298148542,2021-11-12 22:34:22 UTC
783741,mainnet,246,106272000,106572934,300935,278771,22164,0.07365045607855517,2021-11-12 22:35:53 UTC
783742,mainnet,246,106272000,106573133,301134,278956,22178,0.07364827618269608,2021-11-12 22:37:33 UTC
783744,mainnet,246,106272000,106573318,301319,279135,22184,0.07362297100415174,2021-11-12 22:39:02 UTC
783745,mainnet,246,106272000,106573520,301521,279329,22192,0.07360018041861098,2021-11-12 22:40:35 UTC
783747,mainnet,246,106272000,106573777,301778,279584,22194,0.07354412846529568,2021-11-12 22:42:49 UTC
783748,mainnet,246,106272000,106573976,301977,279777,22200,0.07351553263990304,2021-11-12 22:44:32 UTC
783749,mainnet,246,106272000,106574157,302158,279956,22202,0.0734781140992461,2021-11-12 22:45:59 UTC
783751,mainnet,246,106272000,106574341,302342,280124,22218,0.073486316820025,2021-11-12 22:47:31 UTC
783753,mainnet,246,106272000,106574524,302525,280296,22229,0.0734782249400876,2021-11-12 22:49:26 UTC
783754,mainnet,246,106272000,106574744,302745,280495,22250,0.0734941947843895,2021-11-12 22:51:04 UTC
783756,mainnet,246,106272000,106574919,302920,280660,22260,0.07348474844843524,2021-11-12 22:52:31 UTC
783757,mainnet,246,106272000,106575118,303119,280846,22273,0.07347939258179131,2021-11-12 22:54:09 UTC
783759,mainnet,246,106272000,106575300,303301,281011,22290,0.07349135017688699,2021-11-12 22:55:39 UTC
783760,mainnet,246,106272000,106575461,303462,281161,22301,0.07348860812885963,2021-11-12 22:57:05 UTC
783762,mainnet,246,106272000,106575660,303661,281338,22323,0.07351289760621219,2021-11-12 22:58:40 UTC
783763,mainnet,246,106272000,106575825,303826,281491,22335,0.07351247095376959,2021-11-12 23:00:10 UTC
783765,mainnet,246,106272000,106575999,304000,281655,22345,0.07350328947368422,2021-11-12 23:01:43 UTC
783766,mainnet,246,106272000,106576174,304175,281826,22349,0.07347415139311252,2021-11-12 23:03:27 UTC
783768,mainnet,246,106272000,106576367,304368,282013,22355,0.07344727435210009,2021-11-12 23:05:00 UTC
783769,mainnet,246,106272000,106576540,304541,282180,22361,0.0734252530857914,2021-11-12 23:06:32 UTC
783771,mainnet,246,106272000,106576728,304729,282358,22371,0.07341277003501472,2021-11-12 23:08:12 UTC
783772,mainnet,246,106272000,106576892,304893,282511,22382,0.07340936000498535,2021-11-12 23:09:39 UTC
783774,mainnet,246,106272000,106577098,305099,282711,22388,0.07337946043743178,2021-11-12 23:11:17 UTC
783775,mainnet,246,106272000,106577300,305301,282912,22389,0.07333418495189993,2021-11-12 23:12:51 UTC
783777,mainnet,246,106272000,106577490,305491,283102,22389,0.07328857478616391,2021-11-12 23:14:35 UTC
783778,mainnet,246,106272000,106577692,305693,283297,22396,0.07326304495032598,2021-11-12 23:16:04 UTC
783780,mainnet,246,106272000,106577894,305895,283495,22400,0.0732277415453015,2021-11-12 23:17:44 UTC
783781,mainnet,246,106272000,106578092,306093,283685,22408,0.07320650913284525,2021-11-12 23:19:27 UTC
783783,mainnet,246,106272000,106578276,306277,283859,22418,0.07319517952702945,2021-11-12 23:21:20 UTC
783784,mainnet,246,106272000,106578493,306494,284059,22435,0.07319882281545478,2021-11-12 23:22:54 UTC
783786,mainnet,246,106272000,106578680,306681,284240,22441,0.07317375383541856,2021-11-12 23:24:26 UTC
783787,mainnet,246,106272000,106578864,306865,284419,22446,0.07314617176934482,2021-11-12 23:25:56 UTC
783789,mainnet,246,106272000,106579038,307039,284591,22448,0.07311123342637255,2021-11-12 23:27:38 UTC
783790,mainnet,246,106272000,106579232,307233,284766,22467,0.07312691019519388,2021-11-12 23:29:09 UTC
783792,mainnet,246,106272000,106579417,307418,284943,22475,0.0731089266080711,2021-11-12 23:30:48 UTC
783794,mainnet,246,106272000,106579594,307595,285116,22479,0.07307986150620134,2021-11-12 23:32:26 UTC
783795,mainnet,246,106272000,106579798,307799,285313,22486,0.07305416846708404,2021-11-12 23:33:56 UTC
783797,mainnet,246,106272000,106580085,308086,285587,22499,0.07302831027700057,2021-11-12 23:36:16 UTC
783799,mainnet,246,106272000,106580306,308307,285798,22509,0.07300839747394643,2021-11-12 23:38:17 UTC
783800,mainnet,246,106272000,106580473,308474,285947,22527,0.07302722433657294,2021-11-12 23:39:45 UTC
783802,mainnet,246,106272000,106580646,308647,286118,22529,0.07299277167767709,2021-11-12 23:41:18 UTC
783803,mainnet,246,106272000,106580836,308837,286295,22542,0.07298995910464096,2021-11-12 23:42:51 UTC
783805,mainnet,246,106272000,106581018,309019,286476,22543,0.07295020694520402,2021-11-12 23:44:24 UTC
783806,mainnet,246,106272000,106581267,309268,286708,22560,0.07294644127423465,2021-11-12 23:46:25 UTC
783808,mainnet,246,106272000,106581468,309469,286900,22569,0.07292814466069299,2021-11-12 23:48:05 UTC
783809,mainnet,246,106272000,106581644,309645,287071,22574,0.07290284034943241,2021-11-12 23:49:37 UTC
783811,mainnet,246,106272000,106581819,309820,287235,22585,0.0728971660964431,2021-11-12 23:51:11 UTC
783812,mainnet,246,106272000,106582064,310065,287480,22585,0.0728395658974731,2021-11-12 23:53:13 UTC
783814,mainnet,246,106272000,106582213,310214,287617,22597,0.07284326303777393,2021-11-12 23:54:39 UTC
783815,mainnet,246,106272000,106582397,310398,287780,22618,0.07286773754985534,2021-11-12 23:56:10 UTC
783817,mainnet,246,106272000,106582578,310579,287947,22632,0.07287034860695668,2021-11-12 23:57:38 UTC
783818,mainnet,246,106272000,106582774,310775,288136,22639,0.07284691497063792,2021-11-12 23:59:17 UTC
783820,mainnet,246,106272000,106582927,310928,288280,22648,0.07284001440848042,2021-11-13 00:00:48 UTC
783821,mainnet,246,106272000,106583104,311105,288434,22671,0.07287250285273461,2021-11-13 00:02:18 UTC
783823,mainnet,246,106272000,106583267,311268,288591,22677,0.07285361810401327,2021-11-13 00:03:58 UTC
783824,mainnet,246,106272000,106583425,311426,288731,22695,0.07287445492669206,2021-11-13 00:05:24 UTC
783826,mainnet,246,106272000,106583582,311583,288877,22706,0.07287303864459871,2021-11-13 00:06:52 UTC
783827,mainnet,246,106272000,106583759,311760,289046,22714,0.07285732614831922,2021-11-13 00:08:23 UTC
783829,mainnet,246,106272000,106583928,311929,289214,22715,0.07282105863834398,2021-11-13 00:09:52 UTC
783830,mainnet,246,106272000,106584101,312102,289382,22720,0.07279671389481644,2021-11-13 00:11:32 UTC
783832,mainnet,246,106272000,106584285,312286,289554,22732,0.07279224813152047,2021-11-13 00:12:57 UTC
783833,mainnet,246,106272000,106584456,312457,289721,22736,0.07276521249323907,2021-11-13 00:14:24 UTC
783835,mainnet,246,106272000,106584621,312622,289878,22744,0.07275239746403005,2021-11-13 00:15:54 UTC
783836,mainnet,246,106272000,106584808,312809,290050,22759,0.07275685801879102,2021-11-13 00:17:24 UTC
783838,mainnet,246,106272000,106584984,312985,290224,22761,0.07272233493617905,2021-11-13 00:18:53 UTC
783839,mainnet,246,106272000,106585183,313184,290413,22771,0.07270805660570144,2021-11-13 00:20:29 UTC
783841,mainnet,246,106272000,106585359,313360,290583,22777,0.07268636711769211,2021-11-13 00:22:04 UTC
783842,mainnet,246,106272000,106585547,313548,290754,22794,0.07269700332963375,2021-11-13 00:23:36 UTC
783844,mainnet,246,106272000,106585715,313716,290917,22799,0.07267401088882938,2021-11-13 00:25:12 UTC
783845,mainnet,246,106272000,106585901,313902,291100,22802,0.07264050563551681,2021-11-13 00:26:42 UTC
783847,mainnet,246,106272000,106586068,314069,291266,22803,0.07260506449219757,2021-11-13 00:28:11 UTC
783849,mainnet,246,106272000,106586272,314273,291455,22818,0.07260566450188212,2021-11-13 00:29:52 UTC
783850,mainnet,246,106272000,106586452,314453,291623,22830,0.07260226488537237,2021-11-13 00:31:26 UTC
783851,mainnet,246,106272000,106586630,314631,291791,22840,0.07259297399175542,2021-11-13 00:32:54 UTC
783853,mainnet,246,106272000,106586801,314802,291950,22852,0.07259166078995687,2021-11-13 00:34:24 UTC
783854,mainnet,246,106272000,106586979,314980,292118,22862,0.07258238618324973,2021-11-13 00:35:57 UTC
783856,mainnet,246,106272000,106587165,315166,292293,22873,0.07257445282803349,2021-11-13 00:37:26 UTC
783857,mainnet,246,106272000,106587343,315344,292470,22874,0.07253665837942057,2021-11-13 00:38:58 UTC
783859,mainnet,246,106272000,106587517,315518,292631,22887,0.07253785837891974,2021-11-13 00:40:31 UTC
783860,mainnet,246,106272000,106587681,315682,292785,22897,0.07253185167351955,2021-11-13 00:41:56 UTC
783862,mainnet,246,106272000,106587855,315856,292956,22900,0.07250139303986627,2021-11-13 00:43:33 UTC
783863,mainnet,246,106272000,106588044,316045,293124,22921,0.07252448227309402,2021-11-13 00:45:03 UTC
783865,mainnet,246,106272000,106588229,316230,293302,22928,0.07250418998829966,2021-11-13 00:46:33 UTC
783866,mainnet,246,106272000,106588394,316395,293462,22933,0.07248218208252342,2021-11-13 00:47:58 UTC
783868,mainnet,246,106272000,106588579,316580,293643,22937,0.07245246067344747,2021-11-13 00:49:28 UTC
783869,mainnet,246,106272000,106588750,316751,293807,22944,0.07243544613908086,2021-11-13 00:51:07 UTC
783871,mainnet,246,106272000,106588903,316904,293951,22953,0.07242887435942746,2021-11-13 00:52:49 UTC
783873,mainnet,246,106272000,106589095,317096,294125,22971,0.07244178419153821,2021-11-13 00:54:20 UTC
783874,mainnet,246,106272000,106589261,317262,294286,22976,0.07241964054945124,2021-11-13 00:55:47 UTC
783876,mainnet,246,106272000,106589476,317477,294490,22987,0.07240524510436977,2021-11-13 00:57:36 UTC
783877,mainnet,246,106272000,106589657,317658,294663,22995,0.07238917326180987,2021-11-13 00:59:05 UTC
783879,mainnet,246,106272000,106589857,317858,294858,23000,0.07235935543544601,2021-11-13 01:00:40 UTC
783880,mainnet,246,106272000,106590084,318085,295079,23006,0.07232657937343792,2021-11-13 01:02:32 UTC
783882,mainnet,246,106272000,106590276,318277,295263,23014,0.07230808383892019,2021-11-13 01:04:05 UTC
783883,mainnet,246,106272000,106590519,318520,295496,23024,0.07228431495667462,2021-11-13 01:06:10 UTC
783885,mainnet,246,106272000,106590712,318713,295682,23031,0.07226250576537512,2021-11-13 01:07:58 UTC
783886,mainnet,246,106272000,106590937,318938,295891,23047,0.07226169349528748,2021-11-13 01:09:57 UTC
783888,mainnet,246,106272000,106591139,319140,296084,23056,0.07224415616970609,2021-11-13 01:11:42 UTC
783889,mainnet,246,106272000,106591312,319313,296253,23060,0.0722175420355576,2021-11-13 01:13:10 UTC
783891,mainnet,246,106272000,106591473,319474,296405,23069,0.07220931906821838,2021-11-13 01:14:47 UTC
783892,mainnet,246,106272000,106591647,319648,296573,23075,0.07218878266092701,2021-11-13 01:16:19 UTC
783894,mainnet,246,106272000,106591862,319863,296772,23091,0.07219028146425188,2021-11-13 01:18:10 UTC
783895,mainnet,246,106272000,106592033,320034,296938,23096,0.07216733222095152,2021-11-13 01:19:40 UTC
783897,mainnet,246,106272000,106592220,320221,297123,23098,0.07213143422823612,2021-11-13 01:21:43 UTC
783898,mainnet,246,106272000,106592448,320449,297337,23112,0.07212380129131313,2021-11-13 01:23:17 UTC
783900,mainnet,246,106272000,106592641,320642,297527,23115,0.07208974494919568,2021-11-13 01:25:08 UTC
783901,mainnet,246,106272000,106592842,320843,297693,23150,0.07215367017513238,2021-11-13 01:26:45 UTC
783903,mainnet,246,106272000,106593028,321029,297869,23160,0.07214301511701435,2021-11-13 01:28:25 UTC
783904,mainnet,246,106272000,106593223,321224,298059,23165,0.0721147859437651,2021-11-13 01:30:03 UTC
783906,mainnet,246,106272000,106593438,321439,298261,23178,0.07210699386197693,2021-11-13 01:31:51 UTC
783908,mainnet,246,106272000,106593631,321632,298445,23187,0.07209170729280669,2021-11-13 01:33:20 UTC
783909,mainnet,246,106272000,106593815,321816,298624,23192,0.07206602530638626,2021-11-13 01:34:49 UTC
783910,mainnet,246,106272000,106593990,321991,298798,23193,0.07202996357041035,2021-11-13 01:36:21 UTC
783912,mainnet,246,106272000,106594164,322165,298970,23195,0.07199726848043704,2021-11-13 01:38:05 UTC
783914,mainnet,246,106272000,106594378,322379,299163,23216,0.07201461633667205,2021-11-13 01:39:43 UTC
783915,mainnet,246,106272000,106594557,322558,299333,23225,0.07200255457933147,2021-11-13 01:41:12 UTC
783917,mainnet,246,106272000,106594723,322724,299490,23234,0.07199340613031568,2021-11-13 01:42:44 UTC
783918,mainnet,246,106272000,106594906,322907,299669,23238,0.07196499301656514,2021-11-13 01:44:29 UTC
783920,mainnet,246,106272000,106595102,323103,299859,23244,0.07193990770744933,2021-11-13 01:46:00 UTC
783921,mainnet,246,106272000,106595271,323272,300013,23259,0.0719486995471306,2021-11-13 01:47:27 UTC
783923,mainnet,246,106272000,106595444,323445,300160,23285,0.07199060118412713,2021-11-13 01:48:56 UTC
783924,mainnet,246,106272000,106595621,323622,300336,23286,0.07195431707362293,2021-11-13 01:50:29 UTC
783926,mainnet,246,106272000,106595806,323807,300521,23286,0.07191320755882362,2021-11-13 01:51:59 UTC
783927,mainnet,246,106272000,106595969,323970,300679,23291,0.07189245917831898,2021-11-13 01:53:28 UTC
783929,mainnet,246,106272000,106596159,324160,300853,23307,0.07189967917077986,2021-11-13 01:54:53 UTC
783930,mainnet,246,106272000,106596364,324365,301053,23312,0.07186965301435112,2021-11-13 01:56:32 UTC
783932,mainnet,246,106272000,106596535,324536,301213,23323,0.07186567900017256,2021-11-13 01:58:03 UTC
783933,mainnet,246,106272000,106596802,324803,301454,23349,0.07188665129324544,2021-11-13 02:00:13 UTC
783935,mainnet,246,106272000,106596965,324966,301608,23358,0.07187828880559813,2021-11-13 02:01:43 UTC
783936,mainnet,246,106272000,106597140,325141,301774,23367,0.07186728219449408,2021-11-13 02:03:14 UTC
783938,mainnet,246,106272000,106597324,325325,301940,23385,0.07188196418965649,2021-11-13 02:04:38 UTC
783939,mainnet,246,106272000,106597498,325499,302108,23391,0.07186197192618103,2021-11-13 02:06:12 UTC
783941,mainnet,246,106272000,106597675,325676,302277,23399,0.07184748031786192,2021-11-13 02:07:41 UTC
783942,mainnet,246,106272000,106597852,325853,302447,23406,0.07182993558445065,2021-11-13 02:09:11 UTC
783944,mainnet,246,106272000,106598035,326036,302625,23411,0.07180495405415353,2021-11-13 02:10:47 UTC
783945,mainnet,246,106272000,106598208,326209,302792,23417,0.07178526650092426,2021-11-13 02:12:15 UTC
783946,mainnet,246,106272000,106598405,326406,302969,23437,0.07180321440169604,2021-11-13 02:13:49 UTC
783948,mainnet,246,106272000,106598581,326582,303132,23450,0.07180432479438548,2021-11-13 02:15:16 UTC
783949,mainnet,246,106272000,106598760,326761,303309,23452,0.07177111099549824,2021-11-13 02:16:56 UTC
783951,mainnet,246,106272000,106598956,326957,303500,23457,0.07174337909878058,2021-11-13 02:18:26 UTC
783952,mainnet,246,106272000,106599137,327138,303677,23461,0.0717159119393039,2021-11-13 02:20:07 UTC
783954,mainnet,246,106272000,106599326,327327,303862,23465,0.07168672306286986,2021-11-13 02:21:38 UTC
783955,mainnet,246,106272000,106599516,327517,304051,23466,0.07164818925429825,2021-11-13 02:23:09 UTC
783957,mainnet,246,106272000,106599700,327701,304231,23470,0.07162016594395501,2021-11-13 02:24:42 UTC
783958,mainnet,246,106272000,106599878,327879,304404,23475,0.07159653408727,2021-11-13 02:26:12 UTC
783960,mainnet,246,106272000,106600052,328053,304569,23484,0.07158599372662344,2021-11-13 02:27:40 UTC
783961,mainnet,246,106272000,106600222,328223,304727,23496,0.07158547694707562,2021-11-13 02:29:22 UTC
783963,mainnet,246,106272000,106600399,328400,304874,23526,0.07163824604141292,2021-11-13 02:30:51 UTC
783964,mainnet,246,106272000,106600616,328617,305083,23534,0.07161528466269243,2021-11-13 02:32:51 UTC
783966,mainnet,246,106272000,106600851,328852,305311,23541,0.07158539403743934,2021-11-13 02:34:40 UTC
783968,mainnet,246,106272000,106601033,329034,305487,23547,0.07156403289629643,2021-11-13 02:36:12 UTC
783969,mainnet,246,106272000,106601259,329260,305699,23561,0.07155743181680131,2021-11-13 02:38:33 UTC
783971,mainnet,246,106272000,106601507,329508,305934,23574,0.07154302778688226,2021-11-13 02:40:15 UTC
783972,mainnet,246,106272000,106601688,329689,306103,23586,0.07154014844292651,2021-11-13 02:41:44 UTC
783974,mainnet,246,106272000,106601892,329893,306298,23595,0.07152319085279166,2021-11-13 02:43:27 UTC
783975,mainnet,246,106272000,106602068,330069,306464,23605,0.07151534982079505,2021-11-13 02:44:56 UTC
783977,mainnet,246,106272000,106602288,330289,306682,23607,0.07147376994086997,2021-11-13 02:46:45 UTC
783979,mainnet,246,106272000,106602472,330473,306866,23607,0.07143397493895114,2021-11-13 02:48:33 UTC
783980,mainnet,246,106272000,106602668,330669,307052,23617,0.0714218750472527,2021-11-13 02:50:02 UTC
783982,mainnet,246,106272000,106602867,330868,307235,23633,0.0714272761342892,2021-11-13 02:51:45 UTC
783983,mainnet,246,106272000,106603044,331045,307407,23638,0.07140418976272107,2021-11-13 02:53:28 UTC
783985,mainnet,246,106272000,106603307,331308,307646,23662,0.0714199476016275,2021-11-13 02:55:29 UTC
783986,mainnet,246,106272000,106603482,331483,307811,23672,0.07141241028951711,2021-11-13 02:56:56 UTC
783988,mainnet,246,106272000,106603642,331643,307960,23683,0.0714111258190283,2021-11-13 02:58:28 UTC
783989,mainnet,246,106272000,106603764,331765,308077,23688,0.07139993670218378,2021-11-13 03:00:00 UTC
783991,mainnet,246,106272000,106604032,332033,308328,23705,0.07139350606716802,2021-11-13 03:01:44 UTC
783992,mainnet,246,106272000,106604216,332217,308505,23712,0.07137503499218883,2021-11-13 03:03:23 UTC
783994,mainnet,246,106272000,106604404,332405,308685,23720,0.07135873407439719,2021-11-13 03:04:53 UTC
783996,mainnet,246,106272000,106604648,332649,308924,23725,0.07132142288117506,2021-11-13 03:06:55 UTC
783997,mainnet,246,106272000,106604833,332834,309105,23729,0.07129379810956814,2021-11-13 03:08:28 UTC
783999,mainnet,246,106272000,106605004,333005,309268,23737,0.0712812119938139,2021-11-13 03:09:57 UTC
784000,mainnet,246,106272000,106605183,333184,309431,23753,0.07129093834037649,2021-11-13 03:11:29 UTC
784002,mainnet,246,106272000,106605372,333373,309613,23760,0.07127151868927598,2021-11-13 03:13:01 UTC
784003,mainnet,246,106272000,106605550,333551,309790,23761,0.0712364825768773,2021-11-13 03:14:29 UTC
784004,mainnet,246,106272000,106605731,333732,309959,23773,0.07123380436997351,2021-11-13 03:16:01 UTC
784006,mainnet,246,106272000,106605915,333916,310142,23774,0.0711975466883887,2021-11-13 03:17:34 UTC
784007,mainnet,246,106272000,106606109,334110,310325,23785,0.07118912932866421,2021-11-13 03:19:10 UTC
784009,mainnet,246,106272000,106606292,334293,310494,23799,0.07119203812224606,2021-11-13 03:20:38 UTC
784010,mainnet,246,106272000,106606483,334484,310671,23813,0.0711932409323017,2021-11-13 03:22:10 UTC
784012,mainnet,246,106272000,106606692,334693,310875,23818,0.07116372317317661,2021-11-13 03:23:54 UTC
784013,mainnet,246,106272000,106606882,334883,311056,23827,0.07115022261506257,2021-11-13 03:25:26 UTC
784015,mainnet,246,106272000,106607062,335063,311227,23836,0.07113886045310881,2021-11-13 03:26:58 UTC
784016,mainnet,246,106272000,106607249,335250,311394,23856,0.07115883668903804,2021-11-13 03:28:29 UTC
784018,mainnet,246,106272000,106607432,335433,311565,23868,0.07115578968080064,2021-11-13 03:30:08 UTC
784019,mainnet,246,106272000,106607642,335643,311754,23889,0.07117383648698171,2021-11-13 03:31:41 UTC
784021,mainnet,246,106272000,106607813,335814,311923,23891,0.07114354970310946,2021-11-13 03:33:08 UTC
784022,mainnet,246,106272000,106607994,335995,312093,23902,0.07113796336255004,2021-11-13 03:34:38 UTC
784024,mainnet,246,106272000,106608170,336171,312258,23913,0.07113344101662547,2021-11-13 03:36:07 UTC
784025,mainnet,246,106272000,106608362,336363,312440,23923,0.07112256698864025,2021-11-13 03:37:40 UTC
784027,mainnet,246,106272000,106608532,336533,312608,23925,0.0710925823024785,2021-11-13 03:39:15 UTC
784028,mainnet,246,106272000,106608721,336722,312778,23944,0.07110910484019459,2021-11-13 03:40:50 UTC
784030,mainnet,246,106272000,106608912,336913,312961,23952,0.07109253724255223,2021-11-13 03:42:29 UTC
784031,mainnet,246,106272000,106609156,337157,313191,23966,0.07108261136503172,2021-11-13 03:44:19 UTC
784033,mainnet,246,106272000,106609336,337337,313359,23978,0.07108025505651619,2021-11-13 03:45:50 UTC
784034,mainnet,246,106272000,106609511,337512,313522,23990,0.07107895422977553,2021-11-13 03:47:19 UTC
784036,mainnet,246,106272000,106609686,337687,313688,23999,0.07106877078478,2021-11-13 03:48:46 UTC
784037,mainnet,246,106272000,106609864,337865,313856,24009,0.0710609267014932,2021-11-13 03:50:19 UTC
784039,mainnet,246,106272000,106610051,338052,314034,24018,0.07104824109900253,2021-11-13 03:51:49 UTC
784040,mainnet,246,106272000,106610221,338222,314196,24026,0.07103618333520587,2021-11-13 03:53:14 UTC
784042,mainnet,246,106272000,106610401,338402,314376,24026,0.07099839835461966,2021-11-13 03:54:46 UTC
784043,mainnet,246,106272000,106610505,338506,314472,24034,0.07100021860764653,2021-11-13 03:56:12 UTC
784045,mainnet,246,106272000,106610754,338755,314708,24047,0.07098640610470694,2021-11-13 03:57:42 UTC
784046,mainnet,246,106272000,106610952,338953,314902,24051,0.07095674031502892,2021-11-13 03:59:19 UTC
784048,mainnet,246,106272000,106611108,339109,315054,24055,0.07093589376867025,2021-11-13 04:00:53 UTC
784049,mainnet,246,106272000,106611330,339331,315242,24089,0.07098968264025392,2021-11-13 04:02:33 UTC
784051,mainnet,246,106272000,106611490,339491,315395,24096,0.07097684474698887,2021-11-13 04:03:56 UTC
784052,mainnet,246,106272000,106611660,339661,315563,24098,0.07094720912910225,2021-11-13 04:05:22 UTC
784054,mainnet,246,106272000,106611869,339870,315770,24100,0.07090946538382323,2021-11-13 04:07:16 UTC
784056,mainnet,246,106272000,106612031,340032,315925,24107,0.07089626858648598,2021-11-13 04:08:43 UTC
784057,mainnet,246,106272000,106612212,340213,316098,24115,0.0708820650592423,2021-11-13 04:10:10 UTC
784059,mainnet,246,106272000,106612456,340457,316332,24125,0.07086063731983774,2021-11-13 04:12:10 UTC
784060,mainnet,246,106272000,106612700,340701,316558,24143,0.07086272127173093,2021-11-13 04:14:05 UTC
784062,mainnet,246,106272000,106612907,340908,316757,24151,0.07084316003144543,2021-11-13 04:15:56 UTC
784063,mainnet,246,106272000,106613089,341090,316915,24175,0.07087572195021842,2021-11-13 04:17:27 UTC
784065,mainnet,246,106272000,106613254,341255,317059,24196,0.07090299043237462,2021-11-13 04:19:26 UTC
784067,mainnet,246,106272000,106613478,341479,317262,24217,0.07091797738660356,2021-11-13 04:21:01 UTC
784068,mainnet,246,106272000,106613675,341676,317449,24227,0.07090635572881912,2021-11-13 04:22:41 UTC
784070,mainnet,246,106272000,106613846,341847,317611,24236,0.07089721425081981,2021-11-13 04:24:08 UTC
784071,mainnet,246,106272000,106614024,342025,317776,24249,0.07089832614574958,2021-11-13 04:25:34 UTC
784073,mainnet,246,106272000,106614225,342226,317971,24255,0.070874217622273,2021-11-13 04:27:16 UTC
784074,mainnet,246,106272000,106614399,342400,318143,24257,0.07084404205607477,2021-11-13 04:28:42 UTC
784076,mainnet,246,106272000,106614584,342585,318327,24258,0.07080870440912475,2021-11-13 04:30:15 UTC
784077,mainnet,246,106272000,106614773,342774,318515,24259,0.07077257901707831,2021-11-13 04:31:44 UTC
784079,mainnet,246,106272000,106614956,342957,318697,24260,0.07073773096918856,2021-11-13 04:33:13 UTC
784080,mainnet,246,106272000,106615134,343135,318872,24263,0.07070977894997596,2021-11-13 04:34:42 UTC
784082,mainnet,246,106272000,106615321,343322,319041,24281,0.07072369379183391,2021-11-13 04:36:22 UTC
784083,mainnet,246,106272000,106615500,343501,319216,24285,0.07069848413832856,2021-11-13 04:37:53 UTC
784085,mainnet,246,106272000,106615672,343673,319384,24289,0.07067474023272122,2021-11-13 04:39:22 UTC
784086,mainnet,246,106272000,106615854,343855,319559,24296,0.07065769001468643,2021-11-13 04:40:52 UTC
784088,mainnet,246,106272000,106616036,344037,319734,24303,0.0706406578362211,2021-11-13 04:42:23 UTC
784089,mainnet,246,106272000,106616226,344227,319915,24312,0.07062781246096327,2021-11-13 04:43:58 UTC
784091,mainnet,246,106272000,106616415,344416,320100,24316,0.07060066895846882,2021-11-13 04:45:36 UTC
784092,mainnet,246,106272000,106616588,344589,320265,24324,0.07058844014173407,2021-11-13 04:47:04 UTC
784094,mainnet,246,106272000,106616770,344771,320440,24331,0.070571480779996,2021-11-13 04:48:34 UTC
784095,mainnet,246,106272000,106616956,344957,320625,24332,0.0705363277162081,2021-11-13 04:50:04 UTC
784097,mainnet,246,106272000,106617121,345122,320785,24337,0.07051709250641802,2021-11-13 04:51:32 UTC
784098,mainnet,246,106272000,106617324,345325,320972,24353,0.07052197205531022,2021-11-13 04:53:00 UTC
784100,mainnet,246,106272000,106617520,345521,321157,24364,0.07051380379195475,2021-11-13 04:54:50 UTC
784101,mainnet,246,106272000,106617738,345739,321369,24370,0.07048669661218433,2021-11-13 04:56:30 UTC
784103,mainnet,246,106272000,106617932,345933,321562,24371,0.07045005824827351,2021-11-13 04:58:11 UTC
784104,mainnet,246,106272000,106618145,346146,321746,24400,0.07049048667325349,2021-11-13 04:59:44 UTC
784106,mainnet,246,106272000,106618321,346322,321913,24409,0.07048065095489169,2021-11-13 05:01:16 UTC
784107,mainnet,246,106272000,106618496,346497,322082,24415,0.07046237052557454,2021-11-13 05:02:42 UTC
784109,mainnet,246,106272000,106618680,346681,322260,24421,0.07044227979035482,2021-11-13 05:04:12 UTC
784110,mainnet,246,106272000,106618852,346853,322414,24439,0.07045924354121198,2021-11-13 05:05:41 UTC
784112,mainnet,246,106272000,106619017,347018,322574,24444,0.07044015007867027,2021-11-13 05:07:10 UTC
784113,mainnet,246,106272000,106619184,347185,322738,24447,0.07041490847818886,2021-11-13 05:08:36 UTC
784115,mainnet,246,106272000,106619361,347362,322901,24461,0.07041933199371261,2021-11-13 05:10:04 UTC
784116,mainnet,246,106272000,106619554,347555,323091,24464,0.07038885931723037,2021-11-13 05:11:40 UTC
784118,mainnet,246,106272000,106619747,347748,323280,24468,0.07036129611097691,2021-11-13 05:13:26 UTC
784119,mainnet,246,106272000,106619948,347949,323460,24489,0.07038100411267169,2021-11-13 05:14:54 UTC
784121,mainnet,246,106272000,106620159,348160,323666,24494,0.07035271139705883,2021-11-13 05:16:40 UTC
784122,mainnet,246,106272000,106620334,348335,323839,24496,0.07032310850187319,2021-11-13 05:18:12 UTC
784124,mainnet,246,106272000,106620495,348496,323996,24500,0.07030209815894586,2021-11-13 05:19:40 UTC
784125,mainnet,246,106272000,106620699,348700,324177,24523,0.07032692859191282,2021-11-13 05:21:27 UTC
784127,mainnet,246,106272000,106620902,348903,324378,24525,0.07029174297727449,2021-11-13 05:23:10 UTC
784128,mainnet,246,106272000,106621080,349081,324551,24530,0.07027022381624895,2021-11-13 05:24:41 UTC
784130,mainnet,246,106272000,106621277,349278,324734,24544,0.0702706726447128,2021-11-13 05:26:25 UTC
784132,mainnet,246,106272000,106621470,349471,324918,24553,0.07025761794254745,2021-11-13 05:28:02 UTC
784133,mainnet,246,106272000,106621635,349636,325082,24554,0.07022732212930019,2021-11-13 05:29:29 UTC
784135,mainnet,246,106272000,106621800,349801,325233,24568,0.07023421888445144,2021-11-13 05:30:58 UTC
784136,mainnet,246,106272000,106621978,349979,325406,24573,0.07021278419562317,2021-11-13 05:32:23 UTC
784138,mainnet,246,106272000,106622162,350163,325586,24577,0.07018731276576909,2021-11-13 05:34:01 UTC
784139,mainnet,246,106272000,106622351,350352,325755,24597,0.07020653514180025,2021-11-13 05:35:31 UTC
784141,mainnet,246,106272000,106622534,350535,325917,24618,0.07022979160426206,2021-11-13 05:37:03 UTC
784142,mainnet,246,106272000,106622696,350697,326074,24623,0.0702116071708626,2021-11-13 05:38:32 UTC
784144,mainnet,246,106272000,106622876,350877,326245,24632,0.07020123861068124,2021-11-13 05:39:58 UTC
784145,mainnet,246,106272000,106623080,351081,326442,24639,0.07018038572295282,2021-11-13 05:41:39 UTC
784147,mainnet,246,106272000,106623254,351255,326610,24645,0.0701627023102874,2021-11-13 05:43:07 UTC
784148,mainnet,246,106272000,106623446,351447,326797,24650,0.07013859842309082,2021-11-13 05:45:00 UTC
784150,mainnet,246,106272000,106623659,351660,326996,24664,0.0701359267474265,2021-11-13 05:46:31 UTC
784151,mainnet,246,106272000,106623816,351817,327144,24673,0.07013020973972264,2021-11-13 05:47:57 UTC
784153,mainnet,246,106272000,106623997,351998,327307,24691,0.07014528491639158,2021-11-13 05:49:32 UTC
784154,mainnet,246,106272000,106624159,352160,327465,24695,0.07012437528396183,2021-11-13 05:51:00 UTC
784156,mainnet,246,106272000,106624335,352336,327633,24703,0.07011205213205576,2021-11-13 05:52:32 UTC
784157,mainnet,246,106272000,106624507,352508,327799,24709,0.07009486309530563,2021-11-13 05:53:59 UTC
784159,mainnet,246,106272000,106624696,352697,327986,24711,0.0700629718993924,2021-11-13 05:55:49 UTC
784160,mainnet,246,106272000,106624885,352886,328169,24717,0.0700424499696786,2021-11-13 05:57:17 UTC
784162,mainnet,246,106272000,106625056,353057,328324,24733,0.0700538439968617,2021-11-13 05:58:45 UTC
784163,mainnet,246,106272000,106625234,353235,328490,24745,0.07005251461491642,2021-11-13 06:00:15 UTC
784165,mainnet,246,106272000,106625432,353433,328679,24754,0.07003873435700685,2021-11-13 06:02:00 UTC
784166,mainnet,246,106272000,106625606,353607,328837,24770,0.07004951825048712,2021-11-13 06:03:26 UTC
784168,mainnet,246,106272000,106625790,353791,329012,24779,0.07003852557018127,2021-11-13 06:04:58 UTC
784169,mainnet,246,106272000,106625965,353966,329187,24779,0.07000389867953419,2021-11-13 06:06:40 UTC
784171,mainnet,246,106272000,106626161,354162,329371,24791,0.06999903998735042,2021-11-13 06:08:11 UTC
784172,mainnet,246,106272000,106626328,354329,329535,24794,0.06997451521044001,2021-11-13 06:09:42 UTC
784174,mainnet,246,106272000,106626486,354487,329689,24798,0.06995461046526388,2021-11-13 06:11:13 UTC
784175,mainnet,246,106272000,106626673,354674,329870,24804,0.06993464420848441,2021-11-13 06:12:44 UTC
784177,mainnet,246,106272000,106626880,354881,330072,24809,0.06990794097176237,2021-11-13 06:14:26 UTC
784178,mainnet,246,106272000,106627065,355066,330246,24820,0.06990249700055765,2021-11-13 06:15:56 UTC
784180,mainnet,246,106272000,106627253,355254,330425,24829,0.0698908386675449,2021-11-13 06:17:28 UTC
784181,mainnet,246,106272000,106627455,355456,330613,24843,0.06989050684191574,2021-11-13 06:19:04 UTC
784183,mainnet,246,106272000,106627628,355629,330781,24848,0.0698705673609295,2021-11-13 06:20:34 UTC
784184,mainnet,246,106272000,106627800,355801,330945,24856,0.06985927526904084,2021-11-13 06:22:01 UTC
784186,mainnet,246,106272000,106628008,356009,331140,24869,0.06985497557646014,2021-11-13 06:23:41 UTC
784187,mainnet,246,106272000,106628175,356176,331303,24873,0.0698334531242981,2021-11-13 06:25:09 UTC
784189,mainnet,246,106272000,106628351,356352,331471,24881,0.06982141253591954,2021-11-13 06:26:51 UTC
784190,mainnet,246,106272000,106628541,356542,331653,24889,0.0698066426956712,2021-11-13 06:28:17 UTC
784192,mainnet,246,106272000,106628729,356730,331823,24907,0.06982031228099683,2021-11-13 06:29:44 UTC
784193,mainnet,246,106272000,106628908,356909,331984,24925,0.06983572843497922,2021-11-13 06:31:26 UTC
784195,mainnet,246,106272000,106629121,357122,332190,24932,0.06981367711874373,2021-11-13 06:33:05 UTC
784196,mainnet,246,106272000,106629311,357312,332371,24941,0.06980174189503852,2021-11-13 06:34:37 UTC
784198,mainnet,246,106272000,106629475,357476,332529,24947,0.0697865031498618,2021-11-13 06:36:03 UTC
784199,mainnet,246,106272000,106629659,357660,332701,24959,0.06978415254711179,2021-11-13 06:37:33 UTC
784201,mainnet,246,106272000,106629826,357827,332862,24965,0.06976835174539651,2021-11-13 06:39:00 UTC
784202,mainnet,246,106272000,106630028,358029,333051,24978,0.06976529834175443,2021-11-13 06:40:51 UTC
784204,mainnet,246,106272000,106630241,358242,333255,24987,0.06974894066022409,2021-11-13 06:42:27 UTC
784205,mainnet,246,106272000,106630383,358384,333393,24991,0.06973246573507746,2021-11-13 06:44:04 UTC
784207,mainnet,246,106272000,106630606,358607,333600,25007,0.06973371964295176,2021-11-13 06:45:36 UTC
784209,mainnet,246,106272000,106630804,358805,333778,25027,0.06975097894399465,2021-11-13 06:47:13 UTC
784210,mainnet,246,106272000,106630982,358983,333942,25041,0.0697553923166278,2021-11-13 06:48:43 UTC
784212,mainnet,246,106272000,106631174,359175,334113,25062,0.06977657130925037,2021-11-13 06:50:19 UTC
784213,mainnet,246,106272000,106631354,359355,334289,25066,0.06975275145747242,2021-11-13 06:51:52 UTC
784215,mainnet,246,106272000,106631540,359541,334463,25078,0.06975004241519048,2021-11-13 06:53:31 UTC
784216,mainnet,246,106272000,106631722,359723,334642,25081,0.06972309249061083,2021-11-13 06:55:01 UTC
784218,mainnet,246,106272000,106631920,359921,334831,25090,0.06970974186001928,2021-11-13 06:56:47 UTC
784219,mainnet,246,106272000,106632103,360104,335005,25099,0.06969930908848555,2021-11-13 06:58:19 UTC
784221,mainnet,246,106272000,106632270,360271,335157,25114,0.06970863599901185,2021-11-13 06:59:48 UTC
784222,mainnet,246,106272000,106632451,360452,335330,25122,0.06969582635135885,2021-11-13 07:01:23 UTC
784224,mainnet,246,106272000,106632638,360639,335510,25129,0.0696790973799284,2021-11-13 07:03:02 UTC
784225,mainnet,246,106272000,106632808,360809,335673,25136,0.06966566798500037,2021-11-13 07:04:33 UTC
784227,mainnet,246,106272000,106633045,361046,335897,25149,0.06965594411792403,2021-11-13 07:06:32 UTC
784229,mainnet,246,106272000,106633252,361253,336089,25164,0.06965755301686076,2021-11-13 07:08:49 UTC
784230,mainnet,246,106272000,106633440,361441,336248,25193,0.06970155571725399,2021-11-13 07:10:19 UTC
784232,mainnet,246,106272000,106633630,361631,336410,25221,0.0697423616891251,2021-11-13 07:11:46 UTC
784233,mainnet,246,106272000,106633876,361877,336650,25227,0.06971153181882242,2021-11-13 07:13:47 UTC
784235,mainnet,246,106272000,106634100,362101,336861,25240,0.06970430901875443,2021-11-13 07:15:44 UTC
784237,mainnet,246,106272000,106634278,362279,337025,25254,0.06970870516922041,2021-11-13 07:17:31 UTC
784238,mainnet,246,106272000,106634460,362461,337206,25255,0.06967646174347034,2021-11-13 07:19:00 UTC
784239,mainnet,246,106272000,106634631,362632,337377,25255,0.0696436056387743,2021-11-13 07:20:32 UTC
784241,mainnet,246,106272000,106634844,362845,337582,25263,0.06962477090768786,2021-11-13 07:22:16 UTC
784242,mainnet,246,106272000,106635012,363013,337745,25268,0.06960632263858318,2021-11-13 07:23:47 UTC
784244,mainnet,246,106272000,106635167,363168,337886,25282,0.06961516433165918,2021-11-13 07:25:16 UTC
784245,mainnet,246,106272000,106635379,363380,338085,25295,0.06961032527932193,2021-11-13 07:26:57 UTC
784247,mainnet,246,106272000,106635612,363613,338309,25304,0.06959047118777381,2021-11-13 07:28:58 UTC
784249,mainnet,246,106272000,106635788,363789,338476,25313,0.06958154314726393,2021-11-13 07:30:27 UTC
784250,mainnet,246,106272000,106635978,363979,338655,25324,0.06957544253926738,2021-11-13 07:31:58 UTC
784252,mainnet,246,106272000,106636167,364168,338830,25338,0.0695777772896026,2021-11-13 07:33:31 UTC
784253,mainnet,246,106272000,106636352,364353,339002,25351,0.06957812890246547,2021-11-13 07:35:02 UTC
784255,mainnet,246,106272000,106636529,364530,339174,25356,0.06955806106493292,2021-11-13 07:36:35 UTC
784256,mainnet,246,106272000,106636706,364707,339337,25370,0.06956269004982081,2021-11-13 07:38:02 UTC
784258,mainnet,246,106272000,106636872,364873,339487,25386,0.06957489318201128,2021-11-13 07:39:30 UTC
784259,mainnet,246,106272000,106637114,365115,339722,25393,0.06954795064568697,2021-11-13 07:41:31 UTC
784261,mainnet,246,106272000,106637282,365283,339890,25393,0.06951596433450229,2021-11-13 07:42:57 UTC
784262,mainnet,246,106272000,106637485,365486,340092,25394,0.06948008952463296,2021-11-13 07:44:37 UTC
784264,mainnet,246,106272000,106637675,365676,340263,25413,0.06949594723197584,2021-11-13 07:46:06 UTC
784265,mainnet,246,106272000,106637858,365859,340438,25421,0.06948305221410433,2021-11-13 07:47:34 UTC
784267,mainnet,246,106272000,106638085,366086,340649,25437,0.06948367323525073,2021-11-13 07:49:34 UTC
784268,mainnet,246,106272000,106638264,366265,340816,25449,0.06948247853330239,2021-11-13 07:51:04 UTC
784270,mainnet,246,106272000,106638440,366441,340991,25450,0.06945183535685144,2021-11-13 07:52:33 UTC
784271,mainnet,246,106272000,106638644,366645,341181,25464,0.06945137667225791,2021-11-13 07:54:12 UTC
784273,mainnet,246,106272000,106638831,366832,341352,25480,0.06945958913071924,2021-11-13 07:55:40 UTC
784274,mainnet,246,106272000,106639015,367016,341527,25489,0.06944928831440592,2021-11-13 07:57:08 UTC
784276,mainnet,246,106272000,106639188,367189,341699,25490,0.06941929088289682,2021-11-13 07:58:46 UTC
784278,mainnet,246,106272000,106639387,367388,341883,25505,0.06942251788300108,2021-11-13 08:00:32 UTC
784279,mainnet,246,106272000,106639576,367577,342060,25517,0.06941946857393144,2021-11-13 08:02:18 UTC
784281,mainnet,246,106272000,106639736,367737,342210,25527,0.06941645795772522,2021-11-13 08:03:45 UTC
784282,mainnet,246,106272000,106639914,367915,342361,25554,0.06945626027750976,2021-11-13 08:05:15 UTC
784284,mainnet,246,106272000,106640127,368128,342553,25575,0.06947311804589708,2021-11-13 08:07:07 UTC
784285,mainnet,246,106272000,106640318,368319,342740,25579,0.06944795136824329,2021-11-13 08:08:50 UTC
784287,mainnet,246,106272000,106640476,368477,342891,25586,0.06943716975550712,2021-11-13 08:10:20 UTC
784288,mainnet,246,106272000,106640658,368659,343058,25601,0.06944357794059008,2021-11-13 08:11:50 UTC
784290,mainnet,246,106272000,106640836,368837,343235,25602,0.06941277583322715,2021-11-13 08:13:29 UTC
784291,mainnet,246,106272000,106640986,368987,343372,25615,0.06941978985709524,2021-11-13 08:15:02 UTC
784293,mainnet,246,106272000,106641182,369183,343552,25631,0.06942627369082542,2021-11-13 08:16:31 UTC
784294,mainnet,246,106272000,106641362,369363,343731,25632,0.06939514786267167,2021-11-13 08:17:59 UTC
784296,mainnet,246,106272000,106641527,369528,343887,25641,0.06938851724361889,2021-11-13 08:19:28 UTC
784297,mainnet,246,106272000,106641706,369707,344057,25650,0.06937926520190313,2021-11-13 08:21:09 UTC
784299,mainnet,246,106272000,106641932,369933,344274,25659,0.06936120865129632,2021-11-13 08:22:47 UTC
784300,mainnet,246,106272000,106642140,370141,344481,25660,0.06932493293096414,2021-11-13 08:24:29 UTC
784302,mainnet,246,106272000,106642322,370323,344655,25668,0.06931246506428172,2021-11-13 08:25:58 UTC
784303,mainnet,246,106272000,106642511,370512,344836,25676,0.0692987001770523,2021-11-13 08:27:29 UTC
784305,mainnet,246,106272000,106642698,370699,345016,25683,0.06928262552637045,2021-11-13 08:29:05 UTC
784306,mainnet,246,106272000,106642864,370865,345181,25684,0.06925431086783601,2021-11-13 08:30:34 UTC
784308,mainnet,246,106272000,106643088,371089,345405,25684,0.06921250697272083,2021-11-13 08:32:30 UTC
784310,mainnet,246,106272000,106643338,371339,345639,25700,0.0692089977082935,2021-11-13 08:34:31 UTC
784312,mainnet,246,106272000,106643579,371580,345871,25709,0.06918833091124388,2021-11-13 08:36:38 UTC
784313,mainnet,246,106272000,106643760,371761,346046,25715,0.06917078445560454,2021-11-13 08:38:20 UTC
784315,mainnet,246,106272000,106643928,371929,346205,25724,0.06916373824036308,2021-11-13 08:39:48 UTC
784316,mainnet,246,106272000,106644104,372105,346369,25736,0.06916327380712434,2021-11-13 08:41:18 UTC
784318,mainnet,246,106272000,106644271,372272,346535,25737,0.06913493359693987,2021-11-13 08:42:45 UTC
784319,mainnet,246,106272000,106644433,372434,346697,25737,0.06910486153251315,2021-11-13 08:44:15 UTC
784321,mainnet,246,106272000,106644631,372632,346890,25742,0.0690815603598188,2021-11-13 08:45:55 UTC
784322,mainnet,246,106272000,106644816,372817,347075,25742,0.06904728056928734,2021-11-13 08:47:26 UTC
784324,mainnet,246,106272000,106645076,373077,347321,25756,0.06903668679655943,2021-11-13 08:49:44 UTC
784325,mainnet,246,106272000,106645240,373241,347471,25770,0.06904386174080554,2021-11-13 08:51:29 UTC
784327,mainnet,246,106272000,106645523,373524,347734,25790,0.06904509482657072,2021-11-13 08:53:27 UTC
784329,mainnet,246,106272000,106645718,373719,347924,25795,0.06902244734680335,2021-11-13 08:55:09 UTC
784330,mainnet,246,106272000,106645884,373885,348082,25803,0.06901319924575738,2021-11-13 08:56:36 UTC
784332,mainnet,246,106272000,106646077,374078,348269,25809,0.06899363234405659,2021-11-13 08:58:08 UTC
784333,mainnet,246,106272000,106646260,374261,348451,25810,0.06896256890245044,2021-11-13 08:59:39 UTC
784335,mainnet,246,106272000,106646542,374543,348711,25832,0.06896938402266228,2021-11-13 09:02:06 UTC
784336,mainnet,246,106272000,106646723,374724,348886,25838,0.06895208206573371,2021-11-13 09:03:39 UTC
784338,mainnet,246,106272000,106646904,374905,349063,25842,0.06892946213040636,2021-11-13 09:05:18 UTC
784339,mainnet,246,106272000,106647098,375099,349248,25851,0.06891780569929538,2021-11-13 09:06:58 UTC
784341,mainnet,246,106272000,106647304,375305,349453,25852,0.06888264211774424,2021-11-13 09:08:38 UTC
784342,mainnet,246,106272000,106647490,375491,349635,25856,0.06885917372187349,2021-11-13 09:10:18 UTC
784344,mainnet,246,106272000,106647672,375673,349807,25866,0.06885243283387414,2021-11-13 09:11:48 UTC
784345,mainnet,246,106272000,106647830,375831,349957,25874,0.06884477331566582,2021-11-13 09:13:16 UTC
784347,mainnet,246,106272000,106648014,376015,350121,25894,0.06886427403162108,2021-11-13 09:14:44 UTC
784348,mainnet,246,106272000,106648186,376187,350280,25907,0.06886734522989896,2021-11-13 09:16:13 UTC
784350,mainnet,246,106272000,106648404,376405,350485,25920,0.06886199705104874,2021-11-13 09:17:55 UTC
784352,mainnet,246,106272000,106648597,376598,350677,25921,0.06882936181286146,2021-11-13 09:19:36 UTC
784353,mainnet,246,106272000,106648803,376804,350862,25942,0.06884746446428382,2021-11-13 09:21:16 UTC
784355,mainnet,246,106272000,106648993,376994,351040,25954,0.06884459699623867,2021-11-13 09:22:50 UTC
784356,mainnet,246,106272000,106649178,377179,351220,25959,0.06882408617658989,2021-11-13 09:24:21 UTC
784358,mainnet,246,106272000,106649358,377359,351396,25963,0.06880185711749288,2021-11-13 09:25:52 UTC
784359,mainnet,246,106272000,106649536,377537,351567,25970,0.06878795985559032,2021-11-13 09:27:24 UTC
784361,mainnet,246,106272000,106649731,377732,351750,25982,0.06878421738163566,2021-11-13 09:28:52 UTC
784362,mainnet,246,106272000,106649927,377928,351938,25990,0.06876971274951843,2021-11-13 09:30:24 UTC
784364,mainnet,246,106272000,106650088,378089,352099,25990,0.06874042884082848,2021-11-13 09:31:53 UTC
784365,mainnet,246,106272000,106650275,378276,352273,26003,0.06874081358584737,2021-11-13 09:33:27 UTC
784367,mainnet,246,106272000,106650464,378465,352453,26012,0.06873026567846433,2021-11-13 09:34:58 UTC
784368,mainnet,246,106272000,106650651,378652,352626,26026,0.06873329600794396,2021-11-13 09:36:30 UTC
784370,mainnet,246,106272000,106650816,378817,352788,26029,0.06871127747698758,2021-11-13 09:37:59 UTC
784371,mainnet,246,106272000,106650974,378975,352940,26035,0.0686984629592981,2021-11-13 09:39:27 UTC
784372,mainnet,246,106272000,106651132,379133,353086,26047,0.06870148470325717,2021-11-13 09:40:58 UTC
784374,mainnet,246,106272000,106651340,379341,353278,26063,0.06870599276113049,2021-11-13 09:42:30 UTC
784375,mainnet,246,106272000,106651524,379525,353452,26073,0.06869903168434227,2021-11-13 09:44:00 UTC
784377,mainnet,246,106272000,106651692,379693,353620,26073,0.06866863492347765,2021-11-13 09:45:29 UTC
784378,mainnet,246,106272000,106651868,379869,353788,26081,0.06865787942685504,2021-11-13 09:46:58 UTC
784380,mainnet,246,106272000,106652072,380073,353979,26094,0.06865523202121698,2021-11-13 09:48:40 UTC
784382,mainnet,246,106272000,106652267,380268,354168,26100,0.06863580422228534,2021-11-13 09:50:19 UTC
784383,mainnet,246,106272000,106652449,380450,354339,26111,0.06863188329609672,2021-11-13 09:51:50 UTC
784385,mainnet,246,106272000,106652632,380633,354510,26123,0.06863041302251775,2021-11-13 09:53:20 UTC
784386,mainnet,246,106272000,106652811,380812,354683,26129,0.06861390922554962,2021-11-13 09:54:51 UTC
784388,mainnet,246,106272000,106653009,381010,354876,26134,0.06859137555444739,2021-11-13 09:56:31 UTC
784389,mainnet,246,106272000,106653192,381193,355057,26136,0.06856369345712014,2021-11-13 09:58:00 UTC
784391,mainnet,246,106272000,106653374,381375,355227,26148,0.06856243854473942,2021-11-13 09:59:28 UTC
784392,mainnet,246,106272000,106653551,381552,355396,26156,0.06855159978194322,2021-11-13 10:01:02 UTC
784394,mainnet,246,106272000,106653750,381751,355586,26165,0.06853944063014897,2021-11-13 10:02:40 UTC
784395,mainnet,246,106272000,106653921,381922,355756,26166,0.06851137143186305,2021-11-13 10:04:10 UTC
784397,mainnet,246,106272000,106654180,382181,356000,26181,0.06850419042286246,2021-11-13 10:06:17 UTC
784398,mainnet,246,106272000,106654368,382369,356182,26187,0.06848620050265582,2021-11-13 10:07:48 UTC
784400,mainnet,246,106272000,106654555,382556,356365,26191,0.06846317924695992,2021-11-13 10:09:26 UTC
784401,mainnet,246,106272000,106654726,382727,356527,26200,0.0684561057881989,2021-11-13 10:10:54 UTC
784402,mainnet,246,106272000,106654932,382933,356720,26213,0.06845322811040051,2021-11-13 10:12:34 UTC
784404,mainnet,246,106272000,106655128,383129,356899,26230,0.06846258048855608,2021-11-13 10:14:13 UTC
784405,mainnet,246,106272000,106655300,383301,357061,26240,0.06845794819215185,2021-11-13 10:15:41 UTC
784407,mainnet,246,106272000,106655468,383469,357219,26250,0.06845403409402064,2021-11-13 10:17:11 UTC
784408,mainnet,246,106272000,106655706,383707,357438,26269,0.06846109140568193,2021-11-13 10:19:12 UTC
784410,mainnet,246,106272000,106655875,383876,357594,26282,0.06846481676374663,2021-11-13 10:20:43 UTC
784411,mainnet,246,106272000,106656111,384112,357829,26283,0.06842535510476111,2021-11-13 10:22:43 UTC
784413,mainnet,246,106272000,106656282,384283,357989,26294,0.06842353161602256,2021-11-13 10:24:11 UTC
784414,mainnet,246,106272000,106656471,384472,358170,26302,0.06841070351026862,2021-11-13 10:25:43 UTC
784416,mainnet,246,106272000,106656656,384657,358349,26308,0.06839339983413795,2021-11-13 10:27:13 UTC
784417,mainnet,246,106272000,106656796,384797,358485,26312,0.06837891147800008,2021-11-13 10:28:40 UTC
784419,mainnet,246,106272000,106656981,384982,358653,26329,0.06839021045139773,2021-11-13 10:30:08 UTC
784420,mainnet,246,106272000,106657153,385154,358821,26333,0.06837005457557237,2021-11-13 10:31:37 UTC
784422,mainnet,246,106272000,106657324,385325,358978,26347,0.06837604619477065,2021-11-13 10:33:04 UTC
784423,mainnet,246,106272000,106657507,385508,359155,26353,0.06835915207985307,2021-11-13 10:34:34 UTC
784425,mainnet,246,106272000,106657658,385659,359298,26361,0.06835313061538821,2021-11-13 10:36:01 UTC
784426,mainnet,246,106272000,106657855,385856,359481,26375,0.06835451567424117,2021-11-13 10:37:33 UTC
784428,mainnet,246,106272000,106658060,386061,359674,26387,0.06834930231232889,2021-11-13 10:39:24 UTC
784429,mainnet,246,106272000,106658254,386255,359858,26397,0.06834086290145111,2021-11-13 10:41:02 UTC
784431,mainnet,246,106272000,106658468,386469,360063,26406,0.06832630819030763,2021-11-13 10:42:45 UTC
784432,mainnet,246,106272000,106658649,386650,360240,26410,0.0683046683046683,2021-11-13 10:44:14 UTC
784434,mainnet,246,106272000,106658838,386839,360429,26410,0.06827129632741269,2021-11-13 10:45:54 UTC
784435,mainnet,246,106272000,106659020,387021,360598,26423,0.06827278106355986,2021-11-13 10:47:27 UTC
784437,mainnet,246,106272000,106659199,387200,360773,26427,0.06825154958677686,2021-11-13 10:49:03 UTC
784438,mainnet,246,106272000,106659386,387387,360947,26440,0.06825216127541708,2021-11-13 10:50:38 UTC
784440,mainnet,246,106272000,106659580,387581,361136,26445,0.06823089883147007,2021-11-13 10:52:12 UTC
784441,mainnet,246,106272000,106659769,387770,361319,26451,0.0682131160223844,2021-11-13 10:53:49 UTC
784443,mainnet,246,106272000,106659968,387969,361493,26476,0.06824256577200756,2021-11-13 10:55:22 UTC
784444,mainnet,246,106272000,106660151,388152,361667,26485,0.06823357859807498,2021-11-13 10:56:52 UTC
784446,mainnet,246,106272000,106660340,388341,361852,26489,0.06821067051895113,2021-11-13 10:58:23 UTC
784447,mainnet,246,106272000,106660515,388516,362024,26492,0.06818766794675123,2021-11-13 10:59:55 UTC
784449,mainnet,246,106272000,106660701,388702,362204,26498,0.06817047506830426,2021-11-13 11:01:34 UTC
784450,mainnet,246,106272000,106660894,388895,362391,26504,0.06815207189601306,2021-11-13 11:03:14 UTC
784452,mainnet,246,106272000,106661071,389072,362563,26509,0.06813391865772916,2021-11-13 11:04:40 UTC
784453,mainnet,246,106272000,106661252,389253,362740,26513,0.06811251294145453,2021-11-13 11:06:10 UTC
784455,mainnet,246,106272000,106661437,389438,362923,26515,0.0680852921389284,2021-11-13 11:07:49 UTC
784456,mainnet,246,106272000,106661620,389621,363101,26520,0.06806614633194823,2021-11-13 11:09:17 UTC
784458,mainnet,246,106272000,106661796,389797,363268,26529,0.06805850224604089,2021-11-13 11:10:45 UTC
784459,mainnet,246,106272000,106661978,389979,363441,26538,0.06804981806712669,2021-11-13 11:12:15 UTC
784461,mainnet,246,106272000,106662156,390157,363615,26542,0.0680290242133295,2021-11-13 11:13:55 UTC
784462,mainnet,246,106272000,106662344,390345,363801,26544,0.06800138339161511,2021-11-13 11:15:32 UTC
784464,mainnet,246,106272000,106662515,390516,363968,26548,0.06798184965532782,2021-11-13 11:16:59 UTC
784465,mainnet,246,106272000,106662712,390713,364159,26554,0.06796292931128475,2021-11-13 11:18:38 UTC
784467,mainnet,246,106272000,106662908,390909,364341,26568,0.0679646669685272,2021-11-13 11:20:17 UTC
784468,mainnet,246,106272000,106663094,391095,364527,26568,0.0679323438039351,2021-11-13 11:21:51 UTC
784470,mainnet,246,106272000,106663288,391289,364714,26575,0.06791655272701251,2021-11-13 11:23:25 UTC
784471,mainnet,246,106272000,106663436,391437,364861,26576,0.06789342857215848,2021-11-13 11:24:55 UTC
784473,mainnet,246,106272000,106663627,391628,365036,26592,0.06790117151991175,2021-11-13 11:26:27 UTC
784474,mainnet,246,106272000,106663821,391822,365223,26599,0.0678854173578819,2021-11-13 11:28:07 UTC
784476,mainnet,246,106272000,106663873,391874,365274,26600,0.06787896109463756,2021-11-13 11:29:49 UTC
784478,mainnet,246,106272000,106664208,392209,365565,26644,0.06793316828527647,2021-11-13 11:31:40 UTC
784479,mainnet,246,106272000,106664394,392395,365740,26655,0.06792900011468037,2021-11-13 11:33:10 UTC
784481,mainnet,246,106272000,106664574,392575,365915,26660,0.06791059033305738,2021-11-13 11:34:38 UTC
784482,mainnet,246,106272000,106664746,392747,366083,26664,0.06789103417721841,2021-11-13 11:36:11 UTC
784484,mainnet,246,106272000,106664929,392930,366262,26668,0.06786959509327362,2021-11-13 11:37:45 UTC
784485,mainnet,246,106272000,106665144,393145,366469,26676,0.06785282783705758,2021-11-13 11:39:29 UTC
784487,mainnet,246,106272000,106665354,393355,366674,26681,0.06782931448691386,2021-11-13 11:41:18 UTC
784488,mainnet,246,106272000,106665554,393555,366860,26695,0.06783041760363863,2021-11-13 11:42:59 UTC
784490,mainnet,246,106272000,106665737,393738,367037,26701,0.0678141302084127,2021-11-13 11:44:31 UTC
784491,mainnet,246,106272000,106665907,393908,367207,26701,0.06778486347065812,2021-11-13 11:46:00 UTC
784493,mainnet,246,106272000,106666104,394105,367396,26709,0.06777127922761701,2021-11-13 11:47:40 UTC
784494,mainnet,246,106272000,106666276,394277,367564,26713,0.06775185973313179,2021-11-13 11:49:12 UTC
784496,mainnet,246,106272000,106666455,394456,367735,26721,0.06774139574502606,2021-11-13 11:50:43 UTC
784497,mainnet,246,106272000,106666658,394659,367929,26730,0.06772935622904837,2021-11-13 11:52:14 UTC
784499,mainnet,246,106272000,106666854,394855,368116,26739,0.06771852958681035,2021-11-13 11:53:42 UTC
784500,mainnet,246,106272000,106667078,395079,368338,26741,0.06768519713778763,2021-11-13 11:55:41 UTC
784502,mainnet,246,106272000,106667291,395292,368525,26767,0.06771449966101009,2021-11-13 11:57:13 UTC
784504,mainnet,246,106272000,106667524,395525,368749,26776,0.06769736426268883,2021-11-13 11:59:04 UTC
784505,mainnet,246,106272000,106667712,395713,368928,26785,0.0676879455565018,2021-11-13 12:00:41 UTC
784506,mainnet,246,106272000,106667878,395879,369088,26791,0.06767471879033746,2021-11-13 12:02:11 UTC
784508,mainnet,246,106272000,106668083,396084,369281,26803,0.06766998919421133,2021-11-13 12:03:50 UTC
784510,mainnet,246,106272000,106668272,396273,369459,26814,0.0676654730450977,2021-11-13 12:05:21 UTC
784511,mainnet,246,106272000,106668440,396441,369619,26822,0.06765697796141167,2021-11-13 12:06:48 UTC
784513,mainnet,246,106272000,106668638,396639,369810,26829,0.0676408522611241,2021-11-13 12:08:31 UTC
784514,mainnet,246,106272000,106668812,396813,369972,26841,0.06764143311837062,2021-11-13 12:10:11 UTC
784516,mainnet,246,106272000,106668992,396993,370145,26848,0.06762839647046673,2021-11-13 12:11:42 UTC
784517,mainnet,246,106272000,106669188,397189,370334,26855,0.06761264788299777,2021-11-13 12:13:21 UTC
784519,mainnet,246,106272000,106669341,397342,370481,26861,0.0676017133854463,2021-11-13 12:14:51 UTC
784520,mainnet,246,106272000,106669538,397539,370659,26880,0.06761600748605798,2021-11-13 12:16:26 UTC
784522,mainnet,246,106272000,106669719,397720,370832,26888,0.06760535049783767,2021-11-13 12:17:58 UTC
784523,mainnet,246,106272000,106669890,397891,370995,26896,0.0675964020297016,2021-11-13 12:19:28 UTC
784525,mainnet,246,106272000,106670066,398067,371162,26905,0.06758912444387502,2021-11-13 12:20:58 UTC
784526,mainnet,246,106272000,106670263,398264,371349,26915,0.06758080067492919,2021-11-13 12:22:40 UTC
784528,mainnet,246,106272000,106670444,398445,371514,26931,0.06759025712457177,2021-11-13 12:24:11 UTC
784529,mainnet,246,106272000,106670602,398603,371667,26936,0.06757600921217352,2021-11-13 12:25:44 UTC
784531,mainnet,246,106272000,106670792,398793,371824,26969,0.06762656315431816,2021-11-13 12:27:16 UTC
784532,mainnet,246,106272000,106670975,398976,371989,26987,0.06764066008982997,2021-11-13 12:28:46 UTC
784534,mainnet,246,106272000,106671151,399152,372159,26993,0.06762586683769592,2021-11-13 12:30:17 UTC
784535,mainnet,246,106272000,106671378,399379,372369,27010,0.06762999556811951,2021-11-13 12:32:11 UTC
784537,mainnet,246,106272000,106671554,399555,372540,27015,0.06761271915005443,2021-11-13 12:33:40 UTC
784538,mainnet,246,106272000,106671732,399733,372709,27024,0.06760512642188661,2021-11-13 12:35:11 UTC
784540,mainnet,246,106272000,106671897,399898,372858,27040,0.06761724239681119,2021-11-13 12:36:43 UTC
784541,mainnet,246,106272000,106672072,400073,373010,27063,0.06764515475925643,2021-11-13 12:38:16 UTC
784543,mainnet,246,106272000,106672232,400233,373167,27066,0.06762560808329149,2021-11-13 12:39:50 UTC
784544,mainnet,246,106272000,106672429,400430,373338,27092,0.06765726843643084,2021-11-13 12:41:28 UTC
784546,mainnet,246,106272000,106672594,400595,373498,27097,0.06764188269948451,2021-11-13 12:43:01 UTC
784547,mainnet,246,106272000,106672767,400768,373654,27114,0.06765510220376876,2021-11-13 12:44:31 UTC
784549,mainnet,246,106272000,106672964,400965,373835,27130,0.0676617659895502,2021-11-13 12:46:11 UTC
784550,mainnet,246,106272000,106673130,401131,373996,27135,0.06764623028387236,2021-11-13 12:47:39 UTC
784552,mainnet,246,106272000,106673330,401331,374183,27148,0.06764491155679477,2021-11-13 12:49:24 UTC
784553,mainnet,246,106272000,106673496,401497,374339,27158,0.06764185037497167,2021-11-13 12:50:55 UTC
784555,mainnet,246,106272000,106673680,401681,374514,27167,0.06763327117787499,2021-11-13 12:52:35 UTC
784556,mainnet,246,106272000,106673854,401855,374671,27184,0.06764629032860112,2021-11-13 12:54:04 UTC
784558,mainnet,246,106272000,106674024,402025,374834,27191,0.06763509731981841,2021-11-13 12:55:34 UTC
784559,mainnet,246,106272000,106674178,402179,374985,27194,0.06761665825416047,2021-11-13 12:57:03 UTC
784561,mainnet,246,106272000,106674375,402376,375162,27214,0.06763325844483767,2021-11-13 12:58:45 UTC
784562,mainnet,246,106272000,106674578,402579,375358,27221,0.06761654234324195,2021-11-13 13:00:30 UTC
784564,mainnet,246,106272000,106674798,402799,375560,27239,0.06762429896797162,2021-11-13 13:02:29 UTC
784565,mainnet,246,106272000,106674977,402978,375731,27247,0.0676141129292418,2021-11-13 13:04:05 UTC
784567,mainnet,246,106272000,106675137,403138,375886,27252,0.06759968050642708,2021-11-13 13:05:49 UTC
784568,mainnet,246,106272000,106675359,403360,376092,27268,0.06760214200714003,2021-11-13 13:07:32 UTC
784570,mainnet,246,106272000,106675537,403538,376253,27285,0.06761445018808637,2021-11-13 13:09:15 UTC
784571,mainnet,246,106272000,106675718,403719,376411,27308,0.06764110680943924,2021-11-13 13:10:51 UTC
784573,mainnet,246,106272000,106675968,403969,376650,27319,0.06762647628902217,2021-11-13 13:12:59 UTC
784575,mainnet,246,106272000,106676186,404187,376861,27326,0.06760732037398531,2021-11-13 13:15:12 UTC
784576,mainnet,246,106272000,106676388,404389,377031,27358,0.0676526809581863,2021-11-13 13:16:57 UTC
784578,mainnet,246,106272000,106676567,404568,377201,27367,0.06764499416661723,2021-11-13 13:18:34 UTC
784579,mainnet,246,106272000,106676752,404753,377372,27381,0.06764866474121255,2021-11-13 13:20:32 UTC
784581,mainnet,246,106272000,106676967,404968,377578,27390,0.06763497362754588,2021-11-13 13:22:17 UTC
784582,mainnet,246,106272000,106677158,405159,377761,27398,0.06762283449213766,2021-11-13 13:23:49 UTC
784584,mainnet,246,106272000,106677360,405361,377957,27404,0.06760393821803282,2021-11-13 13:25:25 UTC
784585,mainnet,246,106272000,106677472,405473,378060,27413,0.0676074609160166,2021-11-13 13:27:10 UTC
784587,mainnet,246,106272000,106677775,405776,378333,27443,0.0676309096644454,2021-11-13 13:29:01 UTC
784588,mainnet,246,106272000,106677936,405937,378476,27461,0.06764842820437654,2021-11-13 13:30:32 UTC
784590,mainnet,246,106272000,106678134,406135,378656,27479,0.06765976830364288,2021-11-13 13:32:12 UTC
784591,mainnet,246,106272000,106678320,406321,378838,27483,0.06763864038531112,2021-11-13 13:33:54 UTC
784593,mainnet,246,106272000,106678495,406496,379003,27493,0.06763412186097773,2021-11-13 13:35:24 UTC
784594,mainnet,246,106272000,106678668,406669,379161,27508,0.06764223483963616,2021-11-13 13:36:57 UTC
784596,mainnet,246,106272000,106678832,406833,379308,27525,0.06765675350819624,2021-11-13 13:38:30 UTC
784598,mainnet,246,106272000,106679037,407038,379495,27543,0.0676669008790334,2021-11-13 13:40:21 UTC
784599,mainnet,246,106272000,106679272,407273,379715,27558,0.06766468683168292,2021-11-13 13:42:01 UTC
784601,mainnet,246,106272000,106679427,407428,379859,27569,0.0676659434304957,2021-11-13 13:43:33 UTC
784602,mainnet,246,106272000,106679586,407587,380004,27583,0.06767389538920525,2021-11-13 13:45:01 UTC
784604,mainnet,246,106272000,106679737,407738,380142,27596,0.06768071653856153,2021-11-13 13:46:28 UTC
784605,mainnet,246,106272000,106679876,407877,380271,27606,0.06768216888915041,2021-11-13 13:47:59 UTC
784607,mainnet,246,106272000,106680091,408092,380465,27627,0.06769797006557345,2021-11-13 13:49:26 UTC
784608,mainnet,246,106272000,106680245,408246,380600,27646,0.0677189733640991,2021-11-13 13:51:07 UTC
784610,mainnet,246,106272000,106680420,408421,380755,27666,0.06773892625501628,2021-11-13 13:52:35 UTC
784611,mainnet,246,106272000,106680590,408591,380916,27675,0.06773276944426089,2021-11-13 13:54:03 UTC
784613,mainnet,246,106272000,106680792,408793,381112,27681,0.06771397748982981,2021-11-13 13:55:42 UTC
784614,mainnet,246,106272000,106680961,408962,381273,27689,0.06770555699551548,2021-11-13 13:57:12 UTC
784616,mainnet,246,106272000,106681130,409131,381430,27701,0.06770692027736837,2021-11-13 13:58:39 UTC
784617,mainnet,246,106272000,106681294,409295,381584,27711,0.0677042231153569,2021-11-13 14:00:17 UTC
784619,mainnet,246,106272000,106681424,409425,381707,27718,0.06769982292239116,2021-11-13 14:01:48 UTC
784620,mainnet,246,106272000,106681590,409591,381857,27734,0.0677114487378873,2021-11-13 14:03:18 UTC
784622,mainnet,246,106272000,106681728,409729,381980,27749,0.06772525254497484,2021-11-13 14:04:48 UTC
784623,mainnet,246,106272000,106681893,409894,382140,27754,0.06771018848775537,2021-11-13 14:06:28 UTC
784625,mainnet,246,106272000,106682050,410051,382280,27771,0.06772572192239502,2021-11-13 14:07:58 UTC
784626,mainnet,246,106272000,106682198,410199,382418,27781,0.06772566486022638,2021-11-13 14:09:29 UTC
784628,mainnet,246,106272000,106682384,410385,382594,27791,0.0677193367203967,2021-11-13 14:11:17 UTC
784629,mainnet,246,106272000,106682551,410552,382756,27796,0.06770396929012647,2021-11-13 14:12:43 UTC
784631,mainnet,246,106272000,106682737,410738,382938,27800,0.06768304856137002,2021-11-13 14:14:13 UTC
784632,mainnet,246,106272000,106682920,410921,383108,27813,0.06768454277099491,2021-11-13 14:15:46 UTC
784634,mainnet,246,106272000,106683090,411091,383277,27814,0.06765898548010052,2021-11-13 14:17:13 UTC
784635,mainnet,246,106272000,106683258,411259,383434,27825,0.06765809380463406,2021-11-13 14:18:41 UTC
784637,mainnet,246,106272000,106683445,411446,383600,27846,0.06767838306849501,2021-11-13 14:20:20 UTC
784638,mainnet,246,106272000,106683616,411617,383759,27858,0.06767942043210072,2021-11-13 14:21:51 UTC
784640,mainnet,246,106272000,106683824,411825,383962,27863,0.06765737874097007,2021-11-13 14:23:43 UTC
784641,mainnet,246,106272000,106683974,411975,384101,27874,0.06765944535469386,2021-11-13 14:25:10 UTC
784643,mainnet,246,106272000,106684129,412130,384242,27888,0.06766796884478199,2021-11-13 14:26:42 UTC
784644,mainnet,246,106272000,106684275,412276,384376,27900,0.06767311218698153,2021-11-13 14:28:13 UTC
784646,mainnet,246,106272000,106684424,412425,384492,27933,0.0677286779414439,2021-11-13 14:29:42 UTC
784647,mainnet,246,106272000,106684602,412603,384651,27952,0.06774550839426761,2021-11-13 14:31:13 UTC
784648,mainnet,246,106272000,106684759,412760,384797,27963,0.06774639015408469,2021-11-13 14:32:46 UTC
784650,mainnet,246,106272000,106684924,412925,384955,27970,0.06773627172004601,2021-11-13 14:34:15 UTC
784651,mainnet,246,106272000,106685104,413105,385130,27975,0.0677188608223091,2021-11-13 14:35:47 UTC
784653,mainnet,246,106272000,106685276,413277,385297,27980,0.06770277562022566,2021-11-13 14:37:25 UTC
784654,mainnet,246,106272000,106685468,413469,385476,27993,0.06770277820102595,2021-11-13 14:39:05 UTC
784656,mainnet,246,106272000,106685664,413665,385662,28003,0.06769487387136934,2021-11-13 14:40:59 UTC
784658,mainnet,246,106272000,106685804,413805,385793,28012,0.0676937204722031,2021-11-13 14:42:29 UTC
784659,mainnet,246,106272000,106685990,413991,385977,28014,0.06766813771313869,2021-11-13 14:44:19 UTC
784661,mainnet,246,106272000,106686167,414168,386129,28039,0.0676995808464198,2021-11-13 14:45:50 UTC
784662,mainnet,246,106272000,106686353,414354,386297,28057,0.06771263219372807,2021-11-13 14:47:33 UTC
784664,mainnet,246,106272000,106686564,414565,386484,28081,0.06773606069012097,2021-11-13 14:49:23 UTC
784665,mainnet,246,106272000,106686888,414889,386795,28094,0.06771449713055781,2021-11-13 14:51:11 UTC
784667,mainnet,246,106272000,106686894,414895,386801,28094,0.06771351787801733,2021-11-13 14:52:45 UTC
784668,mainnet,246,106272000,106687188,415189,387053,28136,0.06776672792390935,2021-11-13 14:54:32 UTC
784670,mainnet,246,106272000,106687365,415366,387224,28142,0.06775229556583832,2021-11-13 14:56:10 UTC
784671,mainnet,246,106272000,106687535,415536,387382,28154,0.06775345577759809,2021-11-13 14:57:45 UTC
784673,mainnet,246,106272000,106687717,415718,387549,28169,0.06775987568495952,2021-11-13 14:59:27 UTC
784674,mainnet,246,106272000,106687890,415891,387717,28174,0.06774371169368897,2021-11-13 15:01:01 UTC
784676,mainnet,246,106272000,106688036,416037,387859,28178,0.06772955290034299,2021-11-13 15:02:31 UTC
784678,mainnet,246,106272000,106688223,416224,388035,28189,0.06772555162604751,2021-11-13 15:04:21 UTC
784679,mainnet,246,106272000,106688386,416387,388194,28193,0.06770864604322421,2021-11-13 15:05:53 UTC
784681,mainnet,246,106272000,106688721,416722,388508,28214,0.06770460882794765,2021-11-13 15:07:39 UTC
784682,mainnet,246,106272000,106688872,416873,388656,28217,0.06768728125832088,2021-11-13 15:09:10 UTC
784684,mainnet,246,106272000,106688876,416877,388660,28217,0.06768663178827328,2021-11-13 15:10:47 UTC
784685,mainnet,246,106272000,106689219,417220,388966,28254,0.06771966828052346,2021-11-13 15:12:24 UTC
784687,mainnet,246,106272000,106689267,417268,389013,28255,0.06771427475866829,2021-11-13 15:14:15 UTC
784688,mainnet,246,106272000,106689620,417621,389355,28266,0.0676833779910493,2021-11-13 15:15:53 UTC
784690,mainnet,246,106272000,106689809,417810,389538,28272,0.06766712141882673,2021-11-13 15:17:32 UTC
784691,mainnet,246,106272000,106689871,417872,389599,28273,0.0676594746716698,2021-11-13 15:19:10 UTC
784693,mainnet,246,106272000,106690173,418174,389878,28296,0.06766561287884948,2021-11-13 15:20:50 UTC
784694,mainnet,246,106419465,106690371,270907,251634,19273,0.07114249539509869,2021-11-13 15:22:28 UTC
784696,mainnet,246,106419946,106690558,270613,251250,19363,0.07155236444664521,2021-11-13 15:24:16 UTC
784697,mainnet,246,106272000,106690596,418597,390267,28330,0.06767845923406045,2021-11-13 15:25:49 UTC
784699,mainnet,246,106420488,106690920,270433,251153,19280,0.07129307443987974,2021-11-13 15:27:37 UTC
784701,mainnet,246,106272000,106690994,418995,390623,28372,0.06771441186649005,2021-11-13 15:29:13 UTC
784702,mainnet,246,106272000,106691232,419233,390851,28382,0.06769982324864693,2021-11-13 15:31:28 UTC
784704,mainnet,246,106421013,106691515,270503,247820,22683,0.08385489255202346,2021-11-13 15:33:08 UTC
784705,mainnet,246,106272000,106691688,419689,391280,28409,0.06769059946770109,2021-11-13 15:34:49 UTC
784707,mainnet,246,106272000,106691875,419876,391450,28426,0.06770094027760577,2021-11-13 15:36:26 UTC
784708,mainnet,246,106272000,106691932,419933,391502,28431,0.06770365748821836,2021-11-13 15:38:03 UTC
784710,mainnet,246,106272000,106692082,420083,391650,28433,0.06768424335190902,2021-11-13 15:39:37 UTC
784711,mainnet,246,106272000,106692232,420233,391797,28436,0.0676672227074028,2021-11-13 15:41:11 UTC
784713,mainnet,246,106272000,106692538,420539,392073,28466,0.06768932251229968,2021-11-13 15:42:44 UTC
784714,mainnet,246,106272000,106692731,420732,392251,28481,0.06769392392306742,2021-11-13 15:44:22 UTC
784716,mainnet,246,106272000,106692777,420778,392292,28486,0.06769840628549972,2021-11-13 15:46:02 UTC
784717,mainnet,246,106272000,106692948,420949,392447,28502,0.06770891485666909,2021-11-13 15:47:34 UTC
784719,mainnet,246,106272000,106693119,421120,392609,28511,0.06770279255319149,2021-11-13 15:49:09 UTC
784720,mainnet,246,106272000,106693275,421276,392760,28516,0.06768959067214843,2021-11-13 15:50:41 UTC
784722,mainnet,246,106272000,106693456,421457,392921,28536,0.06770797495355398,2021-11-13 15:52:12 UTC
784723,mainnet,246,106272000,106693615,421616,393068,28548,0.0677109028120375,2021-11-13 15:53:40 UTC
784724,mainnet,246,106272000,106693780,421781,393231,28550,0.0676891562208824,2021-11-13 15:55:11 UTC
784726,mainnet,246,106272000,106693957,421958,393406,28552,0.0676655022537788,2021-11-13 15:56:55 UTC
784727,mainnet,246,106272000,106694114,422115,393545,28570,0.06768297738767871,2021-11-13 15:58:25 UTC
784729,mainnet,246,106272000,106694298,422299,393713,28586,0.06769137506837572,2021-11-13 15:59:57 UTC
784731,mainnet,246,106272000,106694479,422480,393875,28605,0.06770734709335353,2021-11-13 16:01:55 UTC
784732,mainnet,246,106272000,106694622,422623,393999,28624,0.06772939475608285,2021-11-13 16:03:26 UTC
784734,mainnet,246,106272000,106694794,422795,394153,28642,0.06774441514209013,2021-11-13 16:04:53 UTC
784735,mainnet,246,106272000,106694964,422965,394292,28673,0.0677904791176575,2021-11-13 16:06:26 UTC
784737,mainnet,246,106272000,106695144,423145,394439,28706,0.06783962944144442,2021-11-13 16:07:54 UTC
784738,mainnet,246,106272000,106695351,423352,394634,28718,0.06783480413462084,2021-11-13 16:10:05 UTC
784740,mainnet,246,106272000,106695520,423521,394801,28720,0.06781245794187302,2021-11-13 16:11:37 UTC
784741,mainnet,246,106272000,106695691,423692,394946,28746,0.06784645449996696,2021-11-13 16:13:05 UTC
784742,mainnet,246,106272000,106695872,423873,395116,28757,0.06784343423619811,2021-11-13 16:14:50 UTC
784744,mainnet,246,106272000,106696062,424063,395284,28779,0.06786491629781424,2021-11-13 16:16:29 UTC
784745,mainnet,246,106272000,106696240,424241,395457,28784,0.06784822777619325,2021-11-13 16:17:53 UTC
784747,mainnet,246,106272000,106696370,424371,395583,28788,0.06783686915458408,2021-11-13 16:19:22 UTC
784748,mainnet,246,106272000,106696559,424560,395762,28798,0.06783022423214623,2021-11-13 16:20:54 UTC
784750,mainnet,246,106272000,106696682,424683,395883,28800,0.06781528810901308,2021-11-13 16:22:36 UTC
784751,mainnet,246,106272000,106696874,424875,396036,28839,0.06787643424536628,2021-11-13 16:24:04 UTC
784753,mainnet,246,106272000,106697088,425089,396238,28851,0.0678704930026418,2021-11-13 16:26:03 UTC
784754,mainnet,246,106272000,106697242,425243,396390,28853,0.06785061717653201,2021-11-13 16:27:34 UTC
784756,mainnet,246,106272000,106697434,425435,396571,28864,0.06784585189276858,2021-11-13 16:29:17 UTC
784757,mainnet,246,106272000,106697628,425629,396761,28868,0.06782432588005047,2021-11-13 16:30:59 UTC
784759,mainnet,246,106272000,106697825,425826,396950,28876,0.06781173530972745,2021-11-13 16:32:47 UTC
784760,mainnet,246,106272000,106698003,426004,397105,28899,0.06783739119820471,2021-11-13 16:34:18 UTC
784762,mainnet,246,106272000,106698175,426176,397254,28922,0.06786398107823997,2021-11-13 16:35:48 UTC
784763,mainnet,246,106272000,106698335,426336,397404,28932,0.06786196802521954,2021-11-13 16:37:20 UTC
784764,mainnet,246,106272000,106698503,426504,397562,28942,0.06785868362313131,2021-11-13 16:38:53 UTC
784766,mainnet,246,106272000,106698672,426673,397723,28950,0.06785055534331912,2021-11-13 16:40:28 UTC
784767,mainnet,246,106272000,106698848,426849,397873,28976,0.06788349041464312,2021-11-13 16:42:01 UTC
784769,mainnet,246,106272000,106699013,427014,398029,28985,0.06787833654165906,2021-11-13 16:43:44 UTC
784770,mainnet,246,106272000,106699196,427197,398203,28994,0.06787032680472943,2021-11-13 16:45:19 UTC
784772,mainnet,246,106272000,106699368,427369,398368,29001,0.06785939083087449,2021-11-13 16:46:53 UTC
784773,mainnet,246,106272000,106699544,427545,398525,29020,0.06787589610450362,2021-11-13 16:48:27 UTC
784775,mainnet,246,106272000,106699698,427699,398676,29023,0.06785847055990311,2021-11-13 16:49:58 UTC
784776,mainnet,246,106272000,106699866,427867,398839,29028,0.06784351211942029,2021-11-13 16:51:36 UTC
784778,mainnet,246,106272000,106700022,428023,398993,29030,0.06782345808519635,2021-11-13 16:53:10 UTC
784779,mainnet,246,106272000,106700228,428229,399198,29031,0.06779316674022544,2021-11-13 16:54:55 UTC
784781,mainnet,246,106272000,106700397,428398,399363,29035,0.06777575992418265,2021-11-13 16:56:27 UTC
784782,mainnet,246,106272000,106700561,428562,399522,29040,0.06776149075279655,2021-11-13 16:58:01 UTC
784784,mainnet,246,106272000,106700791,428792,399741,29051,0.06775079758950726,2021-11-13 16:59:33 UTC
784785,mainnet,246,106272000,106700909,428910,399857,29053,0.06773682124455013,2021-11-13 17:01:30 UTC
784787,mainnet,246,106272000,106701177,429178,400104,29074,0.06774345376510446,2021-11-13 17:03:17 UTC
784788,mainnet,246,106272000,106701249,429250,400170,29080,0.0677460687245195,2021-11-13 17:04:51 UTC
784790,mainnet,246,106272000,106701524,429525,400415,29110,0.06777253943309469,2021-11-13 17:06:20 UTC
784791,mainnet,246,106272000,106701620,429621,400506,29115,0.06776903363662391,2021-11-13 17:08:07 UTC
784793,mainnet,246,106272000,106701896,429897,400764,29133,0.06776739544588588,2021-11-13 17:09:48 UTC
784794,mainnet,246,106272000,106702127,430128,400977,29151,0.067772849012387,2021-11-13 17:11:23 UTC
784796,mainnet,246,106272000,106702259,430260,401099,29161,0.06777529865662622,2021-11-13 17:12:59 UTC
784797,mainnet,246,106272000,106702492,430493,401318,29175,0.06777113681290985,2021-11-13 17:14:36 UTC
784799,mainnet,246,106272000,106702608,430609,401424,29185,0.06777610314693841,2021-11-13 17:16:11 UTC
784800,mainnet,246,106272000,106702835,430836,401621,29215,0.06781002516038585,2021-11-13 17:18:14 UTC
784802,mainnet,246,106272000,106703064,431065,401831,29234,0.06781807848004362,2021-11-13 17:19:56 UTC
784804,mainnet,246,106272000,106703278,431279,402024,29255,0.06783311962789748,2021-11-13 17:22:04 UTC
784805,mainnet,246,106272000,106703471,431472,402211,29261,0.06781668335372863,2021-11-13 17:23:41 UTC
784807,mainnet,246,106272000,106703624,431625,402359,29266,0.06780422820735592,2021-11-13 17:25:20 UTC
784808,mainnet,246,106272000,106703814,431815,402521,29294,0.06783923671016523,2021-11-13 17:26:53 UTC
784809,mainnet,246,106272000,106703820,431821,402527,29294,0.06783829410797529,2021-11-13 17:28:31 UTC
784811,mainnet,246,106272000,106703965,431966,402652,29314,0.06786182245824902,2021-11-13 17:30:04 UTC
784812,mainnet,246,106272000,106703965,431966,402652,29314,0.06786182245824902,2021-11-13 17:31:36 UTC
784817,mainnet,247,106704000,106704971,972,767,205,0.2109053497942387,2021-11-13 17:40:46 UTC
784819,mainnet,247,106704000,106705283,1284,1058,226,0.17601246105919002,2021-11-13 17:42:22 UTC
784820,mainnet,247,106704000,106705353,1354,1123,231,0.1706056129985229,2021-11-13 17:44:02 UTC
784822,mainnet,247,106704000,106705584,1585,1332,253,0.15962145110410095,2021-11-13 17:46:11 UTC
784823,mainnet,247,106704000,106705761,1762,1500,262,0.14869466515323496,2021-11-13 17:47:29 UTC
784825,mainnet,247,106704000,106705916,1917,1648,269,0.14032342201356285,2021-11-13 17:48:49 UTC
784826,mainnet,247,106704000,106706070,2071,1797,274,0.13230323515210043,2021-11-13 17:50:10 UTC
784828,mainnet,247,106704000,106706290,2291,1990,301,0.1313836752509821,2021-11-13 17:51:53 UTC
784829,mainnet,247,106704000,106706493,2494,2188,306,0.1226944667201283,2021-11-13 17:53:39 UTC
784831,mainnet,247,106704000,106706667,2668,2337,331,0.12406296851574213,2021-11-13 17:54:57 UTC
784832,mainnet,247,106704000,106706842,2843,2503,340,0.11959198030249736,2021-11-13 17:56:30 UTC
784834,mainnet,247,106704000,106707030,3031,2681,350,0.11547344110854503,2021-11-13 17:57:49 UTC
784835,mainnet,247,106704000,106707195,3196,2837,359,0.1123279098873592,2021-11-13 17:59:11 UTC
784837,mainnet,247,106704000,106707464,3465,3088,377,0.1088023088023088,2021-11-13 18:01:19 UTC
784838,mainnet,247,106704000,106707637,3638,3244,394,0.10830126443100604,2021-11-13 18:02:42 UTC
784840,mainnet,247,106704000,106707784,3785,3381,404,0.10673712021136063,2021-11-13 18:04:02 UTC
784841,mainnet,247,106704000,106707948,3949,3541,408,0.10331729551785263,2021-11-13 18:05:26 UTC
784842,mainnet,247,106704000,106708104,4105,3691,414,0.10085261875761267,2021-11-13 18:06:48 UTC
784844,mainnet,247,106704000,106708265,4266,3851,415,0.0972808251289264,2021-11-13 18:08:07 UTC
784845,mainnet,247,106704000,106708430,4431,4003,428,0.09659219137892124,2021-11-13 18:09:31 UTC
784846,mainnet,247,106704000,106708596,4597,4151,446,0.09701979551881662,2021-11-13 18:10:57 UTC
784848,mainnet,247,106704000,106708755,4756,4301,455,0.0956686291000841,2021-11-13 18:12:21 UTC
784849,mainnet,247,106704000,106708952,4953,4494,459,0.09267110841913992,2021-11-13 18:13:53 UTC
784851,mainnet,247,106704000,106709121,5122,4656,466,0.09098008590394377,2021-11-13 18:15:25 UTC
784852,mainnet,247,106704000,106709286,5287,4814,473,0.08946472479667109,2021-11-13 18:16:49 UTC
784854,mainnet,247,106704000,106709527,5528,5039,489,0.08845875542691752,2021-11-13 18:18:53 UTC
784855,mainnet,247,106704000,106709685,5686,5190,496,0.08723179739711573,2021-11-13 18:20:16 UTC
784857,mainnet,247,106704000,106709864,5865,5365,500,0.08525149190110827,2021-11-13 18:21:41 UTC
784858,mainnet,247,106704000,106710048,6049,5542,507,0.08381550669532153,2021-11-13 18:23:19 UTC
784860,mainnet,247,106704000,106710198,6199,5687,512,0.08259396676883368,2021-11-13 18:24:45 UTC
784861,mainnet,247,106704000,106710380,6381,5861,520,0.08149192916470772,2021-11-13 18:26:10 UTC
784863,mainnet,247,106704000,106710539,6540,6014,526,0.08042813455657492,2021-11-13 18:27:34 UTC
784864,mainnet,247,106704000,106710702,6703,6150,553,0.08250037296732807,2021-11-13 18:28:55 UTC
784866,mainnet,247,106704000,106710868,6869,6308,561,0.08167127675061872,2021-11-13 18:30:18 UTC
784867,mainnet,247,106704000,106711036,7037,6469,568,0.08071621429586472,2021-11-13 18:31:40 UTC
784869,mainnet,247,106704000,106711203,7204,6630,574,0.07967795669072737,2021-11-13 18:33:12 UTC
784870,mainnet,247,106704000,106711374,7375,6787,588,0.07972881355932203,2021-11-13 18:34:36 UTC
784871,mainnet,247,106704000,106711561,7562,6960,602,0.07960856916159746,2021-11-13 18:36:07 UTC
784873,mainnet,247,106704000,106711697,7698,7092,606,0.07872174590802807,2021-11-13 18:37:37 UTC
784874,mainnet,247,106704000,106711864,7865,7239,626,0.07959313413858868,2021-11-13 18:39:00 UTC
784876,mainnet,247,106704000,106711995,7996,7352,644,0.08054027013506754,2021-11-13 18:40:33 UTC
784877,mainnet,247,106704000,106712157,8158,7499,659,0.08077960284383427,2021-11-13 18:42:01 UTC
784879,mainnet,247,106704000,106712315,8316,7644,672,0.08080808080808081,2021-11-13 18:43:27 UTC
784880,mainnet,247,106704000,106712491,8492,7807,685,0.08066415449835139,2021-11-13 18:45:00 UTC
784882,mainnet,247,106704000,106712654,8655,7956,699,0.0807625649913345,2021-11-13 18:46:33 UTC
784883,mainnet,247,106704000,106712817,8818,8111,707,0.08017691086414153,2021-11-13 18:47:54 UTC
784885,mainnet,247,106704000,106712982,8983,8264,719,0.08004007569854169,2021-11-13 18:49:20 UTC
784886,mainnet,247,106704000,106713127,9128,8399,729,0.07986415425065732,2021-11-13 18:50:44 UTC
784888,mainnet,247,106704000,106713270,9271,8535,736,0.0793873368568655,2021-11-13 18:52:26 UTC
784889,mainnet,247,106704000,106713465,9466,8711,755,0.07975913796746249,2021-11-13 18:53:52 UTC
784891,mainnet,247,106704000,106713644,9645,8881,764,0.07921202695697252,2021-11-13 18:55:25 UTC
784892,mainnet,247,106704000,106713797,9798,9021,777,0.07930189834660134,2021-11-13 18:57:09 UTC
784894,mainnet,247,106704000,106713984,9985,9176,809,0.08102153229844768,2021-11-13 18:58:33 UTC
784895,mainnet,247,106704000,106714154,10155,9342,813,0.08005908419497784,2021-11-13 18:59:56 UTC
784897,mainnet,247,106704000,106714320,10321,9508,813,0.07877143687627168,2021-11-13 19:01:25 UTC
784898,mainnet,247,106704000,106714567,10568,9731,837,0.07920136260408782,2021-11-13 19:03:33 UTC
784899,mainnet,247,106704000,106714716,10717,9874,843,0.07866007278156201,2021-11-13 19:05:07 UTC
784901,mainnet,247,106704000,106714910,10911,10052,859,0.07872788928604162,2021-11-13 19:06:41 UTC
784902,mainnet,247,106704000,106715122,11123,10246,877,0.0788456351703677,2021-11-13 19:08:26 UTC
784904,mainnet,247,106704000,106715269,11270,10392,878,0.07790594498669033,2021-11-13 19:09:52 UTC
784905,mainnet,247,106704000,106715443,11444,10549,895,0.07820692065711289,2021-11-13 19:11:27 UTC
784907,mainnet,247,106704000,106715687,11688,10768,920,0.07871321013004791,2021-11-13 19:13:25 UTC
784908,mainnet,247,106704000,106715859,11860,10938,922,0.07774030354131535,2021-11-13 19:14:55 UTC
784910,mainnet,247,106704000,106716085,12086,11159,927,0.07670031441337084,2021-11-13 19:16:59 UTC
784911,mainnet,247,106704000,106716265,12266,11337,929,0.07573781183759987,2021-11-13 19:18:36 UTC
784913,mainnet,247,106704000,106716451,12452,11504,948,0.07613234821715387,2021-11-13 19:20:02 UTC
784915,mainnet,247,106704000,106716632,12633,11682,951,0.07527903110900024,2021-11-13 19:21:58 UTC
784916,mainnet,247,106704000,106716843,12844,11874,970,0.07552164434755528,2021-11-13 19:23:33 UTC
784917,mainnet,247,106704000,106717007,13008,12028,980,0.07533825338253383,2021-11-13 19:24:59 UTC
784919,mainnet,247,106704000,106717205,13206,12210,996,0.07542026351658337,2021-11-13 19:26:46 UTC
784920,mainnet,247,106704000,106717419,13420,12404,1016,0.07570789865871833,2021-11-13 19:28:23 UTC
784922,mainnet,247,106704000,106717627,13628,12596,1032,0.07572644555327267,2021-11-13 19:30:12 UTC
784924,mainnet,247,106704000,106717812,13813,12777,1036,0.07500180988923479,2021-11-13 19:31:48 UTC
784925,mainnet,247,106704000,106717987,13988,12947,1041,0.07442093222762368,2021-11-13 19:33:19 UTC
784927,mainnet,247,106704000,106718145,14146,13095,1051,0.07429662095291956,2021-11-13 19:34:44 UTC
784928,mainnet,247,106704000,106718318,14319,13262,1057,0.07381800405056219,2021-11-13 19:36:16 UTC
784929,mainnet,247,106704000,106718484,14485,13423,1062,0.07331722471522265,2021-11-13 19:37:44 UTC
784931,mainnet,247,106704000,106718646,14647,13573,1074,0.07332559568512323,2021-11-13 19:39:13 UTC
784932,mainnet,247,106704000,106718781,14782,13696,1086,0.07346773102421865,2021-11-13 19:40:42 UTC
784934,mainnet,247,106704000,106719041,15042,13937,1105,0.07346097593405132,2021-11-13 19:42:13 UTC
784935,mainnet,247,106704000,106719216,15217,14088,1129,0.07419333640007886,2021-11-13 19:43:42 UTC
784937,mainnet,247,106704000,106719381,15382,14239,1143,0.07430763229749057,2021-11-13 19:45:15 UTC
784938,mainnet,247,106704000,106719538,15539,14396,1143,0.07355685694060107,2021-11-13 19:46:41 UTC
784940,mainnet,247,106704000,106719714,15715,14569,1146,0.072923958001909,2021-11-13 19:48:12 UTC
784941,mainnet,247,106704000,106719890,15891,14731,1160,0.07299729406582342,2021-11-13 19:49:50 UTC
784943,mainnet,247,106704000,106720065,16066,14897,1169,0.07276235528445164,2021-11-13 19:51:21 UTC
784944,mainnet,247,106704000,106720263,16264,15095,1169,0.07187653713723562,2021-11-13 19:52:54 UTC
784946,mainnet,247,106704000,106720464,16465,15282,1183,0.071849377467355,2021-11-13 19:54:34 UTC
784947,mainnet,247,106704000,106720644,16645,15453,1192,0.07161309702613397,2021-11-13 19:56:04 UTC
784949,mainnet,247,106704000,106720836,16837,15639,1198,0.07115281819801628,2021-11-13 19:57:46 UTC
784950,mainnet,247,106704000,106721012,17013,15815,1198,0.07041674013989302,2021-11-13 19:59:19 UTC
784951,mainnet,247,106704000,106721195,17196,15982,1214,0.07059781344498721,2021-11-13 20:00:54 UTC
784952,mainnet,247,106704000,106721364,17365,16122,1243,0.07158076590843651,2021-11-13 20:02:24 UTC
784954,mainnet,247,106704000,106721531,17532,16284,1248,0.07118412046543464,2021-11-13 20:03:53 UTC
784955,mainnet,247,106704000,106721732,17733,16475,1258,0.07094118310494558,2021-11-13 20:05:22 UTC
784957,mainnet,247,106704000,106721892,17893,16624,1269,0.07092158944838764,2021-11-13 20:06:52 UTC
784958,mainnet,247,106704000,106722081,18082,16809,1273,0.0704015042583785,2021-11-13 20:08:31 UTC
784960,mainnet,247,106704000,106722290,18291,17009,1282,0.07008911486523427,2021-11-13 20:10:16 UTC
784961,mainnet,247,106704000,106722465,18466,17174,1292,0.06996642478067801,2021-11-13 20:11:48 UTC
784963,mainnet,247,106704000,106722640,18641,17346,1295,0.06947052196770559,2021-11-13 20:13:18 UTC
784964,mainnet,247,106704000,106722809,18810,17498,1312,0.06975013290802765,2021-11-13 20:14:47 UTC
784966,mainnet,247,106704000,106722995,18996,17671,1325,0.06975152663718677,2021-11-13 20:16:21 UTC
784967,mainnet,247,106704000,106723172,19173,17835,1338,0.06978563605069629,2021-11-13 20:17:51 UTC
784968,mainnet,247,106704000,106723339,19340,18001,1339,0.06923474663908998,2021-11-13 20:19:25 UTC
784970,mainnet,247,106704000,106723512,19513,18160,1353,0.06933838979142111,2021-11-13 20:20:52 UTC
784971,mainnet,247,106704000,106723662,19663,18302,1361,0.06921629456339318,2021-11-13 20:22:24 UTC
784973,mainnet,247,106704000,106723847,19848,18471,1377,0.06937726723095526,2021-11-13 20:23:52 UTC
784974,mainnet,247,106704000,106724017,20018,18639,1379,0.06888800079928065,2021-11-13 20:25:22 UTC
784976,mainnet,247,106704000,106724174,20175,18795,1380,0.06840148698884758,2021-11-13 20:27:02 UTC
784977,mainnet,247,106704000,106724383,20384,19002,1382,0.067798273155416,2021-11-13 20:28:35 UTC
784979,mainnet,247,106704000,106724551,20552,19163,1389,0.06758466329311016,2021-11-13 20:30:06 UTC
784980,mainnet,247,106704000,106724737,20738,19330,1408,0.06789468608351817,2021-11-13 20:31:40 UTC
784982,mainnet,247,106704000,106724921,20922,19501,1421,0.0679189370041105,2021-11-13 20:33:18 UTC
784983,mainnet,247,106704000,106725128,21129,19698,1431,0.06772682095697856,2021-11-13 20:34:50 UTC
784985,mainnet,247,106704000,106725300,21301,19851,1450,0.06807192150603258,2021-11-13 20:36:30 UTC
784986,mainnet,247,106704000,106725464,21465,20007,1458,0.06792452830188679,2021-11-13 20:37:53 UTC
784988,mainnet,247,106704000,106725638,21639,20173,1466,0.0677480475068164,2021-11-13 20:39:20 UTC
784989,mainnet,247,106704000,106725876,21877,20385,1492,0.06819947890478585,2021-11-13 20:41:10 UTC
784991,mainnet,247,106704000,106726038,22039,20538,1501,0.06810653840918372,2021-11-13 20:42:41 UTC
784992,mainnet,247,106704000,106726234,22235,20722,1513,0.06804587362266697,2021-11-13 20:44:10 UTC
784994,mainnet,247,106704000,106726445,22446,20919,1527,0.06802993851911254,2021-11-13 20:46:05 UTC
784995,mainnet,247,106704000,106726654,22655,21117,1538,0.0678878834694328,2021-11-13 20:47:54 UTC
784997,mainnet,247,106704000,106726812,22813,21257,1556,0.06820672423618113,2021-11-13 20:49:20 UTC
784998,mainnet,247,106704000,106727015,23016,21457,1559,0.06773548835592631,2021-11-13 20:51:11 UTC
785000,mainnet,247,106704000,106727166,23167,21600,1567,0.0676393145422368,2021-11-13 20:53:07 UTC
785001,mainnet,247,106704000,106727379,23380,21802,1578,0.06749358426005132,2021-11-13 20:54:33 UTC
785003,mainnet,247,106704000,106727544,23545,21952,1593,0.06765767678912721,2021-11-13 20:56:01 UTC
785004,mainnet,247,106704000,106727682,23683,22085,1598,0.06747455981083478,2021-11-13 20:57:26 UTC
785006,mainnet,247,106704000,106727847,23848,22242,1606,0.06734317343173432,2021-11-13 20:58:54 UTC
785007,mainnet,247,106704000,106728027,24028,22417,1611,0.06704677875811553,2021-11-13 21:00:30 UTC
785009,mainnet,247,106704000,106728179,24180,22564,1616,0.06683209263854425,2021-11-13 21:01:58 UTC
785010,mainnet,247,106704000,106728343,24344,22724,1620,0.06654617154124219,2021-11-13 21:03:26 UTC
785012,mainnet,247,106704000,106728523,24524,22892,1632,0.06654705594519654,2021-11-13 21:04:53 UTC
785013,mainnet,247,106704000,106728712,24713,23075,1638,0.06628090478695424,2021-11-13 21:06:54 UTC
785015,mainnet,247,106704000,106728891,24892,23226,1666,0.06692913385826772,2021-11-13 21:08:22 UTC
785016,mainnet,247,106704000,106729054,25055,23366,1689,0.06741169427260028,2021-11-13 21:09:57 UTC
785018,mainnet,247,106704000,106729251,25252,23555,1697,0.06720259781403454,2021-11-13 21:11:26 UTC
785019,mainnet,247,106704000,106729409,25410,23703,1707,0.06717827626918536,2021-11-13 21:12:56 UTC
785021,mainnet,247,106704000,106729607,25608,23887,1721,0.06720556076226179,2021-11-13 21:14:27 UTC
785022,mainnet,247,106704000,106729792,25793,24067,1726,0.06691738068468189,2021-11-13 21:15:56 UTC
785024,mainnet,247,106704000,106729962,25963,24231,1732,0.06671031853021607,2021-11-13 21:17:36 UTC
785025,mainnet,247,106704000,106730180,26181,24440,1741,0.06649860585921087,2021-11-13 21:19:19 UTC
785027,mainnet,247,106704000,106730369,26370,24621,1749,0.06632536973833902,2021-11-13 21:20:49 UTC
785028,mainnet,247,106704000,106730544,26545,24791,1754,0.06607647391222453,2021-11-13 21:22:18 UTC
785030,mainnet,247,106704000,106730710,26711,24952,1759,0.06585301935532177,2021-11-13 21:23:49 UTC
785031,mainnet,247,106704000,106730858,26859,25094,1765,0.06571354108492498,2021-11-13 21:25:31 UTC
785033,mainnet,247,106704000,106731052,27053,25277,1776,0.0656489113961483,2021-11-13 21:27:11 UTC
785034,mainnet,247,106704000,106731221,27222,25433,1789,0.06571890382778635,2021-11-13 21:28:40 UTC
785036,mainnet,247,106704000,106731388,27389,25592,1797,0.0656102814998722,2021-11-13 21:30:06 UTC
785037,mainnet,247,106704000,106731559,27560,25745,1815,0.06585631349782294,2021-11-13 21:31:39 UTC
785039,mainnet,247,106704000,106731715,27716,25892,1824,0.06581036224563429,2021-11-13 21:33:11 UTC
785040,mainnet,247,106704000,106731946,27947,26093,1854,0.06633985758757649,2021-11-13 21:34:50 UTC
785042,mainnet,247,106704000,106732120,28121,26256,1865,0.06632054336616763,2021-11-13 21:36:19 UTC
785043,mainnet,247,106704000,106732287,28288,26415,1873,0.06621182126696833,2021-11-13 21:37:46 UTC
785044,mainnet,247,106704000,106732460,28461,26582,1879,0.06602016794912337,2021-11-13 21:39:14 UTC
785046,mainnet,247,106704000,106732660,28661,26776,1885,0.0657688147657095,2021-11-13 21:41:02 UTC
785048,mainnet,247,106704000,106732857,28858,26953,1905,0.06601289070621665,2021-11-13 21:42:40 UTC
785049,mainnet,247,106704000,106733036,29037,27129,1908,0.06570926748631056,2021-11-13 21:44:09 UTC
785050,mainnet,247,106704000,106733204,29205,27290,1915,0.06557096387604862,2021-11-13 21:45:39 UTC
785052,mainnet,247,106704000,106733376,29377,27454,1923,0.06545937297886101,2021-11-13 21:47:09 UTC
785053,mainnet,247,106704000,106733536,29537,27598,1939,0.06564647729965806,2021-11-13 21:48:38 UTC
785055,mainnet,247,106704000,106733728,29729,27775,1954,0.06572706784621077,2021-11-13 21:50:28 UTC
785056,mainnet,247,106704000,106733897,29898,27926,1972,0.06595758913639709,2021-11-13 21:51:55 UTC
785058,mainnet,247,106704000,106734088,30089,28098,1991,0.06617036126159062,2021-11-13 21:53:26 UTC
785059,mainnet,247,106704000,106734260,30261,28253,2008,0.06635603582168467,2021-11-13 21:54:55 UTC
785061,mainnet,247,106704000,106734412,30413,28395,2018,0.0663532042218788,2021-11-13 21:56:23 UTC
785062,mainnet,247,106704000,106734586,30587,28554,2033,0.06646614574819368,2021-11-13 21:57:52 UTC
785064,mainnet,247,106704000,106734773,30774,28731,2043,0.06638720998245272,2021-11-13 21:59:21 UTC
785065,mainnet,247,106704000,106734931,30932,28882,2050,0.06627440837967154,2021-11-13 22:00:57 UTC
785067,mainnet,247,106704000,106735140,31141,29073,2068,0.066407629812787,2021-11-13 22:02:58 UTC
785068,mainnet,247,106704000,106735346,31347,29274,2073,0.06613073021341755,2021-11-13 22:04:26 UTC
785070,mainnet,247,106704000,106735584,31585,29500,2085,0.06601234763337027,2021-11-13 22:06:24 UTC
785071,mainnet,247,106704000,106735789,31790,29700,2090,0.0657439446366782,2021-11-13 22:08:10 UTC
785073,mainnet,247,106704000,106735972,31973,29876,2097,0.0655865886842023,2021-11-13 22:09:52 UTC
785074,mainnet,247,106704000,106736158,32159,30060,2099,0.06526944245778786,2021-11-13 22:11:28 UTC
785076,mainnet,247,106704000,106736340,32341,30237,2104,0.06505673912371293,2021-11-13 22:13:09 UTC
785078,mainnet,247,106704000,106736558,32559,30445,2114,0.06492828403820756,2021-11-13 22:14:52 UTC
785079,mainnet,247,106704000,106736749,32750,30626,2124,0.06485496183206108,2021-11-13 22:16:24 UTC
785080,mainnet,247,106704000,106736920,32921,30795,2126,0.06457884025394126,2021-11-13 22:17:52 UTC
785082,mainnet,247,106704000,106737134,33135,31003,2132,0.06434283989738947,2021-11-13 22:19:40 UTC
785084,mainnet,247,106704000,106737300,33301,31165,2136,0.06414221795141287,2021-11-13 22:21:09 UTC
785085,mainnet,247,106704000,106737472,33473,31335,2138,0.06387237474979834,2021-11-13 22:22:37 UTC
785087,mainnet,247,106704000,106737641,33642,31497,2145,0.06375958623149634,2021-11-13 22:24:04 UTC
785088,mainnet,247,106704000,106737810,33811,31656,2155,0.06373665375173761,2021-11-13 22:25:43 UTC
785090,mainnet,247,106704000,106738020,34021,31849,2172,0.06384292054907263,2021-11-13 22:27:23 UTC
785091,mainnet,247,106704000,106738180,34181,32005,2176,0.06366109827096925,2021-11-13 22:28:50 UTC
785093,mainnet,247,106704000,106738372,34373,32185,2188,0.06365461263200768,2021-11-13 22:30:29 UTC
785094,mainnet,247,106704000,106738590,34591,32393,2198,0.06354253996704345,2021-11-13 22:32:06 UTC
785096,mainnet,247,106704000,106738773,34774,32572,2202,0.06332317248519008,2021-11-13 22:33:36 UTC
785097,mainnet,247,106704000,106738959,34960,32749,2211,0.06324370709382152,2021-11-13 22:35:05 UTC
785099,mainnet,247,106704000,106739132,35133,32918,2215,0.06304613895767512,2021-11-13 22:36:38 UTC
785100,mainnet,247,106704000,106739311,35312,33089,2223,0.06295310376076121,2021-11-13 22:38:10 UTC
785102,mainnet,247,106704000,106739531,35532,33299,2233,0.06284475965327029,2021-11-13 22:39:41 UTC
785103,mainnet,247,106704000,106739704,35705,33467,2238,0.06268029687718807,2021-11-13 22:41:10 UTC
785105,mainnet,247,106704000,106739903,35904,33665,2239,0.062360739750445635,2021-11-13 22:42:51 UTC
785106,mainnet,247,106704000,106740097,36098,33857,2241,0.06208100171754668,2021-11-13 22:44:25 UTC
785107,mainnet,247,106704000,106740266,36267,34026,2241,0.061791711473240134,2021-11-13 22:45:51 UTC
785109,mainnet,247,106704000,106740456,36457,34204,2253,0.061798831500123434,2021-11-13 22:47:29 UTC
785110,mainnet,247,106704000,106740646,36647,34370,2277,0.06213332605670314,2021-11-13 22:48:58 UTC
785112,mainnet,247,106704000,106740818,36819,34540,2279,0.06189738993454466,2021-11-13 22:50:28 UTC
785113,mainnet,247,106704000,106741018,37019,34719,2300,0.062130257435371025,2021-11-13 22:52:10 UTC
785115,mainnet,247,106704000,106741202,37203,34898,2305,0.06195736902937935,2021-11-13 22:53:41 UTC
785117,mainnet,247,106704000,106741378,37379,35053,2326,0.06222745391797534,2021-11-13 22:55:19 UTC
785118,mainnet,247,106704000,106741590,37591,35261,2330,0.06198292144396265,2021-11-13 22:56:56 UTC
785120,mainnet,247,106704000,106741765,37766,35431,2335,0.06182809934862045,2021-11-13 22:58:31 UTC
785121,mainnet,247,106704000,106741928,37929,35593,2336,0.06158875794247146,2021-11-13 23:00:02 UTC
785122,mainnet,247,106704000,106742116,38117,35773,2344,0.06149487105490988,2021-11-13 23:01:34 UTC
785124,mainnet,247,106704000,106742292,38293,35941,2352,0.06142114746820568,2021-11-13 23:03:03 UTC
785125,mainnet,247,106704000,106742598,38599,36233,2366,0.06129692479079769,2021-11-13 23:04:34 UTC
785127,mainnet,247,106704000,106742647,38648,36281,2367,0.061245083833574826,2021-11-13 23:06:02 UTC
785128,mainnet,247,106704000,106742869,38870,36482,2388,0.06143555441214304,2021-11-13 23:07:42 UTC
785130,mainnet,247,106704000,106743088,39089,36682,2407,0.061577425874286884,2021-11-13 23:09:19 UTC
785131,mainnet,247,106704000,106743257,39258,36845,2413,0.06146517907178155,2021-11-13 23:10:47 UTC
785133,mainnet,247,106704000,106743432,39433,37007,2426,0.06152207541906525,2021-11-13 23:12:16 UTC
785134,mainnet,247,106704000,106743616,39617,37186,2431,0.06136254638160386,2021-11-13 23:13:46 UTC
785136,mainnet,247,106704000,106743808,39809,37368,2441,0.06131779245899169,2021-11-13 23:15:16 UTC
785137,mainnet,247,106704000,106743984,39985,37531,2454,0.061373014880580216,2021-11-13 23:16:42 UTC
785139,mainnet,247,106704000,106744150,40151,37677,2474,0.061617394336380166,2021-11-13 23:18:09 UTC
785140,mainnet,247,106704000,106744317,40318,37836,2482,0.061560593283397,2021-11-13 23:19:36 UTC
785142,mainnet,247,106704000,106744491,40492,38009,2483,0.06132075471698113,2021-11-13 23:21:04 UTC
785143,mainnet,247,106704000,106744663,40664,38168,2496,0.061381074168797956,2021-11-13 23:22:33 UTC
785144,mainnet,247,106704000,106744863,40864,38360,2504,0.06127642913077525,2021-11-13 23:24:13 UTC
785146,mainnet,247,106704000,106745021,41022,38517,2505,0.06106479450051192,2021-11-13 23:25:40 UTC
785147,mainnet,247,106704000,106745201,41202,38691,2511,0.06094364351245085,2021-11-13 23:27:09 UTC
785149,mainnet,247,106704000,106745376,41377,38861,2516,0.06080672837566764,2021-11-13 23:28:39 UTC
785150,mainnet,247,106704000,106745554,41555,39019,2536,0.06102755384430273,2021-11-13 23:30:07 UTC
785151,mainnet,247,106704000,106745727,41728,39188,2540,0.06087039877300614,2021-11-13 23:31:36 UTC
785153,mainnet,247,106704000,106745900,41901,39327,2574,0.06143051478485,2021-11-13 23:33:04 UTC
785154,mainnet,247,106704000,106746060,42061,39485,2576,0.06124438315779463,2021-11-13 23:34:32 UTC
785156,mainnet,247,106704000,106746269,42270,39670,2600,0.06150934468890466,2021-11-13 23:36:01 UTC
785157,mainnet,247,106704000,106746455,42456,39846,2610,0.06147540983606557,2021-11-13 23:37:34 UTC
785159,mainnet,247,106704000,106746692,42693,40065,2628,0.06155575855526667,2021-11-13 23:39:24 UTC
785160,mainnet,247,106704000,106746858,42859,40225,2634,0.061457336848736555,2021-11-13 23:40:53 UTC
785162,mainnet,247,106704000,106747065,43066,40415,2651,0.06155668044396972,2021-11-13 23:42:33 UTC
785164,mainnet,247,106704000,106747359,43360,40698,2662,0.0613929889298893,2021-11-13 23:44:45 UTC
785165,mainnet,247,106704000,106747533,43534,40857,2677,0.06149216704185235,2021-11-13 23:46:47 UTC
785167,mainnet,247,106704000,106747763,43764,41064,2700,0.06169454346037839,2021-11-13 23:48:36 UTC
785168,mainnet,247,106704000,106747954,43955,41250,2705,0.061540211580025025,2021-11-13 23:50:15 UTC
785170,mainnet,247,106704000,106748148,44149,41422,2727,0.06176810346780222,2021-11-13 23:51:55 UTC
785171,mainnet,247,106704000,106748324,44325,41593,2732,0.061635645798082346,2021-11-13 23:53:27 UTC
785172,mainnet,247,106704000,106748492,44493,41749,2744,0.06167262265974423,2021-11-13 23:54:52 UTC
785174,mainnet,247,106704000,106748667,44668,41902,2766,0.061923524670905346,2021-11-13 23:56:32 UTC
785175,mainnet,247,106704000,106748874,44875,42092,2783,0.062016713091922006,2021-11-13 23:58:11 UTC
785177,mainnet,247,106704000,106749012,45013,42214,2799,0.062182036300624265,2021-11-13 23:59:41 UTC
785179,mainnet,247,106704000,106749210,45211,42391,2820,0.06237420096879078,2021-11-14 00:01:24 UTC
785180,mainnet,247,106704000,106749348,45349,42521,2828,0.062360801781737196,2021-11-14 00:02:50 UTC
785181,mainnet,247,106704000,106749519,45520,42680,2840,0.06239015817223199,2021-11-14 00:04:16 UTC
785183,mainnet,247,106704000,106749724,45725,42872,2853,0.06239475123018043,2021-11-14 00:05:59 UTC
785184,mainnet,247,106704000,106749895,45896,43030,2866,0.06244552902213701,2021-11-14 00:07:33 UTC
785185,mainnet,247,106704000,106750069,46070,43184,2886,0.06264380290861732,2021-11-14 00:09:06 UTC
785187,mainnet,247,106704000,106750249,46250,43350,2900,0.0627027027027027,2021-11-14 00:10:40 UTC
785188,mainnet,247,106704000,106750407,46408,43498,2910,0.06270470608515773,2021-11-14 00:12:14 UTC
785190,mainnet,247,106704000,106750612,46613,43694,2919,0.06262201531761526,2021-11-14 00:13:53 UTC
785191,mainnet,247,106704000,106750800,46801,43878,2923,0.062455930428836993,2021-11-14 00:15:25 UTC
785193,mainnet,247,106704000,106750967,46968,44035,2933,0.06244677227048203,2021-11-14 00:16:57 UTC
785194,mainnet,247,106704000,106751146,47147,44197,2950,0.06257025897724139,2021-11-14 00:18:34 UTC
785196,mainnet,247,106704000,106751328,47329,44365,2964,0.06262545162585308,2021-11-14 00:20:04 UTC
785197,mainnet,247,106704000,106751507,47508,44539,2969,0.062494737728382585,2021-11-14 00:21:40 UTC
785198,mainnet,247,106704000,106751675,47676,44705,2971,0.06231646950247504,2021-11-14 00:23:22 UTC
785200,mainnet,247,106704000,106751846,47847,44871,2976,0.06219825694400903,2021-11-14 00:24:56 UTC
785201,mainnet,247,106704000,106752019,48020,45022,2998,0.0624323198667222,2021-11-14 00:26:31 UTC
785203,mainnet,247,106704000,106752184,48185,45183,3002,0.062301546124312546,2021-11-14 00:28:01 UTC
785204,mainnet,247,106704000,106752361,48362,45351,3011,0.062259625325668914,2021-11-14 00:29:38 UTC
785206,mainnet,247,106704000,106752545,48546,45520,3026,0.062332632966670784,2021-11-14 00:31:12 UTC
785207,mainnet,247,106704000,106752741,48742,45702,3040,0.062369209306142544,2021-11-14 00:32:55 UTC
785209,mainnet,247,106704000,106752933,48934,45886,3048,0.06228797972779662,2021-11-14 00:34:26 UTC
785210,mainnet,247,106704000,106753121,49122,46069,3053,0.0621513782012133,2021-11-14 00:35:57 UTC
785211,mainnet,247,106704000,106753333,49334,46277,3057,0.06196537884623181,2021-11-14 00:37:43 UTC
785213,mainnet,247,106704000,106753518,49519,46458,3061,0.061814657000343304,2021-11-14 00:39:15 UTC
785214,mainnet,247,106704000,106753702,49703,46635,3068,0.06172665633865159,2021-11-14 00:40:59 UTC
785216,mainnet,247,106704000,106753899,49900,46830,3070,0.06152304609218437,2021-11-14 00:42:33 UTC
785217,mainnet,247,106704000,106754097,50098,47020,3078,0.06143957842628448,2021-11-14 00:44:10 UTC
785219,mainnet,247,106704000,106754288,50289,47192,3097,0.061584044224383065,2021-11-14 00:45:41 UTC
785220,mainnet,247,106704000,106754474,50475,47372,3103,0.06147597820703318,2021-11-14 00:47:15 UTC
785222,mainnet,247,106704000,106754674,50675,47557,3118,0.06152935372471633,2021-11-14 00:48:50 UTC
785223,mainnet,247,106704000,106754854,50855,47729,3126,0.06146888211581949,2021-11-14 00:50:24 UTC
785224,mainnet,247,106704000,106755072,51073,47938,3135,0.06138272668533276,2021-11-14 00:52:08 UTC
785225,mainnet,247,106704000,106755247,51248,48113,3135,0.06117311895098345,2021-11-14 00:53:40 UTC
785227,mainnet,247,106704000,106755442,51443,48294,3149,0.06121338180121688,2021-11-14 00:55:13 UTC
785228,mainnet,247,106704000,106755636,51637,48475,3162,0.06123516083428549,2021-11-14 00:56:45 UTC
785230,mainnet,247,106704000,106755830,51831,48665,3166,0.0610831355752349,2021-11-14 00:58:21 UTC
785231,mainnet,247,106704000,106756014,52015,48848,3167,0.06088628280303759,2021-11-14 00:59:55 UTC
785233,mainnet,247,106704000,106756225,52226,49051,3175,0.060793474514609584,2021-11-14 01:01:47 UTC
785234,mainnet,247,106704000,106756442,52443,49255,3188,0.06078980988883168,2021-11-14 01:03:34 UTC
785236,mainnet,247,106704000,106756662,52663,49466,3197,0.060706758065434935,2021-11-14 01:05:39 UTC
785237,mainnet,247,106704000,106756879,52880,49669,3211,0.06072239031770046,2021-11-14 01:07:27 UTC
785238,mainnet,247,106704000,106757091,53092,49875,3217,0.06059293302192421,2021-11-14 01:09:05 UTC
785240,mainnet,247,106704000,106757313,53314,50084,3230,0.06058446186742694,2021-11-14 01:10:58 UTC
785241,mainnet,247,106704000,106757516,53517,50279,3238,0.06050413887176038,2021-11-14 01:12:38 UTC
785243,mainnet,247,106704000,106757723,53724,50480,3244,0.06038269674633311,2021-11-14 01:14:30 UTC
785244,mainnet,247,106704000,106757897,53898,50653,3245,0.06020631563323314,2021-11-14 01:16:01 UTC
785246,mainnet,247,106704000,106758064,54065,50811,3254,0.06018681217053547,2021-11-14 01:17:31 UTC
785247,mainnet,247,106704000,106758244,54245,50981,3264,0.06017144437275325,2021-11-14 01:19:05 UTC
785249,mainnet,247,106704000,106758434,54435,51159,3276,0.060181868283273626,2021-11-14 01:20:37 UTC
785250,mainnet,247,106704000,106758660,54661,51369,3292,0.06022575510876128,2021-11-14 01:22:31 UTC
785251,mainnet,247,106704000,106758872,54873,51571,3302,0.06017531390665719,2021-11-14 01:24:13 UTC
785253,mainnet,247,106704000,106759050,55051,51740,3311,0.0601442298959147,2021-11-14 01:25:46 UTC
785254,mainnet,247,106704000,106759238,55239,51912,3327,0.06022918590126541,2021-11-14 01:27:23 UTC
785256,mainnet,247,106704000,106759473,55474,52133,3341,0.0602264123733641,2021-11-14 01:29:14 UTC
785257,mainnet,247,106704000,106759716,55717,52363,3354,0.06019706732236122,2021-11-14 01:31:25 UTC
785259,mainnet,247,106704000,106759892,55893,52527,3366,0.060222210294670175,2021-11-14 01:32:52 UTC
785260,mainnet,247,106704000,106760061,56062,52689,3373,0.06016553101922871,2021-11-14 01:34:20 UTC
785262,mainnet,247,106704000,106760267,56268,52893,3375,0.05998080614203455,2021-11-14 01:36:08 UTC
785263,mainnet,247,106704000,106760447,56448,53069,3379,0.05986040249433107,2021-11-14 01:37:36 UTC
785265,mainnet,247,106704000,106760611,56612,53219,3393,0.059934289549918744,2021-11-14 01:39:05 UTC
785266,mainnet,247,106704000,106760781,56782,53381,3401,0.059895741608256135,2021-11-14 01:40:32 UTC
785268,mainnet,247,106704000,106760943,56944,53528,3416,0.059988760887889854,2021-11-14 01:42:00 UTC
785269,mainnet,247,106704000,106761120,57121,53690,3431,0.06006547504420441,2021-11-14 01:43:31 UTC
785271,mainnet,247,106704000,106761316,57317,53870,3447,0.06013922570964984,2021-11-14 01:45:12 UTC
785272,mainnet,247,106704000,106761473,57474,54022,3452,0.06006194105160594,2021-11-14 01:46:38 UTC
785274,mainnet,247,106704000,106761672,57673,54213,3460,0.05999341112825759,2021-11-14 01:48:19 UTC
785275,mainnet,247,106704000,106761848,57849,54382,3467,0.059931891648948125,2021-11-14 01:49:46 UTC
785277,mainnet,247,106704000,106762050,58051,54579,3472,0.05980947787290486,2021-11-14 01:51:24 UTC
785278,mainnet,247,106704000,106762240,58241,54764,3477,0.059700211191428716,2021-11-14 01:53:05 UTC
785280,mainnet,247,106704000,106762432,58433,54942,3491,0.05974363801276676,2021-11-14 01:54:31 UTC
785281,mainnet,247,106704000,106762644,58645,55148,3497,0.05962997698013471,2021-11-14 01:56:17 UTC
785283,mainnet,247,106704000,106762808,58809,55306,3503,0.059565712731044565,2021-11-14 01:57:42 UTC
785284,mainnet,247,106704000,106762980,58981,55472,3509,0.05949373527068039,2021-11-14 01:59:10 UTC
785286,mainnet,247,106704000,106763183,59184,55652,3532,0.05967829143011625,2021-11-14 02:00:56 UTC
785287,mainnet,247,106704000,106763330,59331,55789,3542,0.05969897692605889,2021-11-14 02:02:24 UTC
785289,mainnet,247,106704000,106763482,59483,55922,3561,0.059865844022661936,2021-11-14 02:04:01 UTC
785291,mainnet,247,106704000,106763670,59671,56097,3574,0.059895091417941713,2021-11-14 02:05:39 UTC
785292,mainnet,247,106704000,106763856,59857,56276,3581,0.059825918438946156,2021-11-14 02:07:16 UTC
785294,mainnet,247,106704000,106764017,60018,56431,3587,0.05976540371221967,2021-11-14 02:08:45 UTC
785295,mainnet,247,106704000,106764188,60189,56589,3600,0.05981159348053631,2021-11-14 02:10:15 UTC
785297,mainnet,247,106704000,106764383,60384,56779,3605,0.059701245363010066,2021-11-14 02:11:52 UTC
785298,mainnet,247,106704000,106764559,60560,56932,3628,0.05990752972258917,2021-11-14 02:13:21 UTC
785300,mainnet,247,106704000,106764730,60731,57103,3628,0.059738848364097416,2021-11-14 02:14:50 UTC
785301,mainnet,247,106704000,106764927,60928,57291,3637,0.05969340861344538,2021-11-14 02:16:43 UTC
785303,mainnet,247,106704000,106765146,61147,57498,3649,0.05967586308404337,2021-11-14 02:18:23 UTC
785304,mainnet,247,106704000,106765336,61337,57676,3661,0.059686649167712796,2021-11-14 02:19:50 UTC
785306,mainnet,247,106704000,106765510,61511,57845,3666,0.05959909609663312,2021-11-14 02:21:17 UTC
785307,mainnet,247,106704000,106765695,61696,58017,3679,0.05963109439834025,2021-11-14 02:22:44 UTC
785308,mainnet,247,106704000,106765877,61878,58197,3681,0.05948802482303888,2021-11-14 02:24:13 UTC
785310,mainnet,247,106704000,106766056,62057,58374,3683,0.05934866332565222,2021-11-14 02:25:41 UTC
785311,mainnet,247,106704000,106766260,62261,58569,3692,0.05929875845232168,2021-11-14 02:27:17 UTC
785313,mainnet,247,106704000,106766420,62421,58715,3706,0.05937104500088111,2021-11-14 02:28:43 UTC
785315,mainnet,247,106704000,106766590,62591,58876,3715,0.05935358118579349,2021-11-14 02:30:22 UTC
785316,mainnet,247,106704000,106766764,62765,59036,3729,0.05941209272683821,2021-11-14 02:31:55 UTC
785317,mainnet,247,106704000,106766945,62946,59209,3737,0.05936834747243669,2021-11-14 02:33:27 UTC
785319,mainnet,247,106704000,106767108,63109,59363,3746,0.05935761935698553,2021-11-14 02:34:51 UTC
785321,mainnet,247,106704000,106767235,63236,59490,3746,0.0592384085014865,2021-11-14 02:36:39 UTC
785322,mainnet,247,106704000,106767532,63533,59765,3768,0.05930776132088836,2021-11-14 02:38:28 UTC
785324,mainnet,247,106704000,106767693,63694,59920,3774,0.05925204885860521,2021-11-14 02:39:55 UTC
785325,mainnet,247,106704000,106767876,63877,60095,3782,0.05920753948995726,2021-11-14 02:41:23 UTC
785327,mainnet,247,106704000,106768054,64055,60265,3790,0.05916790258371712,2021-11-14 02:42:49 UTC
785328,mainnet,247,106704000,106768237,64238,60431,3807,0.059263987048164636,2021-11-14 02:44:28 UTC
785330,mainnet,247,106704000,106768481,64482,60666,3816,0.05917930585279613,2021-11-14 02:46:21 UTC
785331,mainnet,247,106704000,106768645,64646,60828,3818,0.05906011199455496,2021-11-14 02:47:46 UTC
785333,mainnet,247,106704000,106768816,64817,60994,3823,0.05898144005430674,2021-11-14 02:49:14 UTC
785334,mainnet,247,106704000,106769016,65017,61181,3836,0.058999953858221696,2021-11-14 02:50:52 UTC
785336,mainnet,247,106704000,106769251,65252,61406,3846,0.05894072212345982,2021-11-14 02:52:48 UTC
785337,mainnet,247,106704000,106769439,65440,61586,3854,0.05889364303178484,2021-11-14 02:54:27 UTC
785339,mainnet,247,106704000,106769664,65665,61784,3881,0.05910302291936344,2021-11-14 02:56:04 UTC
785340,mainnet,247,106704000,106769853,65854,61961,3893,0.059115619400491995,2021-11-14 02:57:30 UTC
785342,mainnet,247,106704000,106770027,66028,62134,3894,0.05897498031138305,2021-11-14 02:58:57 UTC
785343,mainnet,247,106704000,106770223,66224,62322,3902,0.058921237013771444,2021-11-14 03:00:32 UTC
785345,mainnet,247,106704000,106770424,66425,62519,3906,0.05880316146029357,2021-11-14 03:02:13 UTC
785346,mainnet,247,106704000,106770599,66600,62689,3911,0.058723723723723725,2021-11-14 03:03:41 UTC
785348,mainnet,247,106704000,106770783,66784,62863,3921,0.05871166746526114,2021-11-14 03:05:06 UTC
785349,mainnet,247,106704000,106770956,66957,63036,3921,0.058559971324880146,2021-11-14 03:06:33 UTC
785350,mainnet,247,106704000,106771116,67117,63187,3930,0.05855446459168318,2021-11-14 03:08:12 UTC
785351,mainnet,247,106704000,106771329,67330,63385,3945,0.05859200950542106,2021-11-14 03:09:41 UTC
785353,mainnet,247,106704000,106771536,67537,63581,3956,0.05857529946547818,2021-11-14 03:11:23 UTC
785354,mainnet,247,106704000,106771715,67716,63754,3962,0.058509067280997105,2021-11-14 03:12:54 UTC
785356,mainnet,247,106704000,106771906,67907,63940,3967,0.05841813067872237,2021-11-14 03:14:27 UTC
785357,mainnet,247,106704000,106772083,68084,64109,3975,0.05838376123612009,2021-11-14 03:15:56 UTC
785359,mainnet,247,106704000,106772268,68269,64282,3987,0.058401324173490164,2021-11-14 03:17:25 UTC
785360,mainnet,247,106704000,106772477,68478,64478,4000,0.05841292093811151,2021-11-14 03:19:15 UTC
785362,mainnet,247,106704000,106772672,68673,64664,4009,0.05837811075677486,2021-11-14 03:20:46 UTC
785363,mainnet,247,106704000,106772848,68849,64831,4018,0.058359598541736266,2021-11-14 03:22:12 UTC
785364,mainnet,247,106704000,106773042,69043,65021,4022,0.05825355213417725,2021-11-14 03:23:54 UTC
785366,mainnet,247,106704000,106773242,69243,65204,4039,0.05833080600205075,2021-11-14 03:25:33 UTC
785367,mainnet,247,106704000,106773422,69423,65369,4054,0.05839563257133803,2021-11-14 03:27:00 UTC
785369,mainnet,247,106704000,106773597,69598,65539,4059,0.05832064139774131,2021-11-14 03:28:27 UTC
785370,mainnet,247,106704000,106773766,69767,65706,4061,0.058208035317557014,2021-11-14 03:29:58 UTC
785372,mainnet,247,106704000,106773946,69947,65876,4071,0.05820120948718315,2021-11-14 03:31:30 UTC
785373,mainnet,247,106704000,106774133,70134,66048,4086,0.05825990247240996,2021-11-14 03:32:59 UTC
785375,mainnet,247,106704000,106774308,70309,66217,4092,0.05820023041146937,2021-11-14 03:34:31 UTC
785376,mainnet,247,106704000,106774504,70505,66408,4097,0.058109353946528615,2021-11-14 03:36:14 UTC
785378,mainnet,247,106704000,106774700,70701,66591,4110,0.05813213391606908,2021-11-14 03:37:55 UTC
785379,mainnet,247,106704000,106774889,70890,66769,4121,0.05813231767527155,2021-11-14 03:39:27 UTC
785381,mainnet,247,106704000,106775066,71067,66944,4123,0.05801567534861469,2021-11-14 03:40:56 UTC
785382,mainnet,247,106704000,106775251,71252,67124,4128,0.05793521585359007,2021-11-14 03:42:26 UTC
785384,mainnet,247,106704000,106775451,71452,67319,4133,0.05784302748698427,2021-11-14 03:44:06 UTC
785385,mainnet,247,106704000,106775634,71635,67484,4151,0.057946534515250926,2021-11-14 03:45:38 UTC
785387,mainnet,247,106704000,106775796,71797,67642,4155,0.05787149880914244,2021-11-14 03:47:14 UTC
785388,mainnet,247,106704000,106775992,71993,67821,4172,0.05795007847985221,2021-11-14 03:48:51 UTC
785390,mainnet,247,106704000,106776148,72149,67973,4176,0.057880220100070684,2021-11-14 03:50:17 UTC
785391,mainnet,247,106704000,106776340,72341,68145,4196,0.058003068799159535,2021-11-14 03:51:44 UTC
785392,mainnet,247,106704000,106776529,72530,68329,4201,0.05792086033365504,2021-11-14 03:53:14 UTC
785393,mainnet,247,106704000,106776718,72719,68513,4206,0.057839079195258464,2021-11-14 03:54:43 UTC
785395,mainnet,247,106704000,106776905,72906,68683,4223,0.05792390201080844,2021-11-14 03:56:23 UTC
785396,mainnet,247,106704000,106777104,73105,68869,4236,0.05794405307434512,2021-11-14 03:57:51 UTC
785398,mainnet,247,106704000,106777323,73324,69069,4255,0.05803011292346299,2021-11-14 03:59:39 UTC
785399,mainnet,247,106704000,106777505,73506,69239,4267,0.058049683019073275,2021-11-14 04:01:11 UTC
785401,mainnet,247,106704000,106777693,73694,69424,4270,0.05794230195131218,2021-11-14 04:02:51 UTC
785402,mainnet,247,106704000,106777866,73867,69588,4279,0.05792843895108776,2021-11-14 04:04:18 UTC
785404,mainnet,247,106704000,106778050,74051,69758,4293,0.057973558763554846,2021-11-14 04:05:45 UTC
785405,mainnet,247,106704000,106778221,74222,69927,4295,0.05786693972137641,2021-11-14 04:07:15 UTC
785407,mainnet,247,106704000,106778394,74395,70095,4300,0.05779958330532966,2021-11-14 04:09:16 UTC
785409,mainnet,247,106704000,106778614,74615,70308,4307,0.057722977953494604,2021-11-14 04:10:40 UTC
785410,mainnet,247,106704000,106778814,74815,70503,4312,0.05763550090222549,2021-11-14 04:12:18 UTC
785412,mainnet,247,106704000,106779031,75032,70711,4321,0.05758876212815865,2021-11-14 04:13:58 UTC
785413,mainnet,247,106704000,106779225,75226,70893,4333,0.05759976603833781,2021-11-14 04:15:26 UTC
785415,mainnet,247,106704000,106779404,75405,71071,4334,0.057476294675419405,2021-11-14 04:16:55 UTC
785416,mainnet,247,106704000,106779605,75606,71263,4343,0.057442531016056925,2021-11-14 04:18:23 UTC
785418,mainnet,247,106704000,106779795,75796,71447,4349,0.05737769803155839,2021-11-14 04:19:51 UTC
785419,mainnet,247,106704000,106779962,75963,71613,4350,0.057264720982583624,2021-11-14 04:21:30 UTC
785421,mainnet,247,106704000,106780158,76159,71803,4356,0.057196129150855445,2021-11-14 04:23:01 UTC
785422,mainnet,247,106704000,106780374,76375,72015,4360,0.057086743044189855,2021-11-14 04:24:50 UTC
785424,mainnet,247,106704000,106780610,76611,72229,4382,0.0571980524989884,2021-11-14 04:26:28 UTC
785425,mainnet,247,106704000,106780808,76809,72424,4385,0.057089663971669986,2021-11-14 04:28:06 UTC
785427,mainnet,247,106704000,106781004,77005,72616,4389,0.056996298941627166,2021-11-14 04:29:48 UTC
785428,mainnet,247,106704000,106781230,77231,72831,4400,0.05697194131890044,2021-11-14 04:31:47 UTC
785430,mainnet,247,106704000,106781536,77537,73127,4410,0.056876072068818756,2021-11-14 04:34:04 UTC
785432,mainnet,247,106704000,106781733,77734,73318,4416,0.056809118275143435,2021-11-14 04:35:43 UTC
785433,mainnet,247,106704000,106781934,77935,73515,4420,0.0567139282735613,2021-11-14 04:37:23 UTC
785435,mainnet,247,106704000,106782111,78112,73687,4425,0.0566494264645637,2021-11-14 04:38:50 UTC
785436,mainnet,247,106704000,106782292,78293,73865,4428,0.056556780299643644,2021-11-14 04:40:19 UTC
785438,mainnet,247,106704000,106782466,78467,74026,4441,0.056597040794219226,2021-11-14 04:41:48 UTC
785439,mainnet,247,106704000,106782634,78635,74186,4449,0.05657785973167165,2021-11-14 04:43:17 UTC
785441,mainnet,247,106704000,106782828,78829,74375,4454,0.05650204873840845,2021-11-14 04:44:49 UTC
785442,mainnet,247,106704000,106783050,79051,74593,4458,0.05639397351077153,2021-11-14 04:46:38 UTC
785444,mainnet,247,106704000,106783228,79229,74766,4463,0.056330384076537635,2021-11-14 04:48:05 UTC
785445,mainnet,247,106704000,106783412,79413,74946,4467,0.05625023610743833,2021-11-14 04:49:36 UTC
785447,mainnet,247,106704000,106783613,79614,75137,4477,0.05623382822116713,2021-11-14 04:51:05 UTC
785448,mainnet,247,106704000,106783800,79801,75307,4494,0.05631508377088006,2021-11-14 04:52:36 UTC
785449,mainnet,247,106704000,106783987,79988,75477,4511,0.05639595939390909,2021-11-14 04:54:06 UTC
785451,mainnet,247,106704000,106784154,80155,75640,4515,0.056328363795146906,2021-11-14 04:55:34 UTC
785452,mainnet,247,106704000,106784323,80324,75805,4519,0.05625964842388327,2021-11-14 04:57:03 UTC
785454,mainnet,247,106704000,106784516,80517,75989,4528,0.0562365711588857,2021-11-14 04:58:31 UTC
785455,mainnet,247,106704000,106784706,80707,76170,4537,0.056215693805989564,2021-11-14 05:00:00 UTC
785457,mainnet,247,106704000,106784880,80881,76332,4549,0.056243122612232785,2021-11-14 05:01:35 UTC
785458,mainnet,247,106704000,106785055,81056,76503,4553,0.05617104224240031,2021-11-14 05:03:05 UTC
785460,mainnet,247,106704000,106785240,81241,76680,4561,0.056141603377604904,2021-11-14 05:04:34 UTC
785461,mainnet,247,106704000,106785432,81433,76860,4573,0.05615659499220218,2021-11-14 05:06:02 UTC
785462,mainnet,247,106704000,106785595,81596,77021,4575,0.05606892494730134,2021-11-14 05:07:31 UTC
785464,mainnet,247,106704000,106785778,81779,77187,4592,0.05615133469472603,2021-11-14 05:09:00 UTC
785465,mainnet,247,106704000,106785951,81952,77354,4598,0.056106013276064036,2021-11-14 05:10:27 UTC
785467,mainnet,247,106704000,106786125,82126,77520,4606,0.0560845530039208,2021-11-14 05:11:54 UTC
785468,mainnet,247,106704000,106786321,82322,77707,4615,0.056060348388037216,2021-11-14 05:13:33 UTC
785470,mainnet,247,106704000,106786535,82536,77911,4625,0.056036153920713386,2021-11-14 05:15:16 UTC
785471,mainnet,247,106704000,106786723,82724,78087,4637,0.05605386586722112,2021-11-14 05:16:43 UTC
785473,mainnet,247,106704000,106786951,82952,78310,4642,0.05596007329539975,2021-11-14 05:18:25 UTC
785474,mainnet,247,106704000,106787116,83117,78474,4643,0.05586101519544738,2021-11-14 05:19:52 UTC
785476,mainnet,247,106704000,106787278,83279,78631,4648,0.055812389678070104,2021-11-14 05:21:20 UTC
785478,mainnet,247,106704000,106787449,83450,78793,4657,0.05580587177950869,2021-11-14 05:22:51 UTC
785479,mainnet,247,106704000,106787638,83639,78968,4671,0.055847152644101436,2021-11-14 05:24:23 UTC
785480,mainnet,247,106704000,106787813,83814,79138,4676,0.05579020211420527,2021-11-14 05:25:53 UTC
785482,mainnet,247,106704000,106788023,84024,79346,4678,0.05567456917071313,2021-11-14 05:27:42 UTC
785484,mainnet,247,106704000,106788203,84204,79525,4679,0.055567431475939386,2021-11-14 05:29:22 UTC
785485,mainnet,247,106704000,106788426,84427,79738,4689,0.055539104788752416,2021-11-14 05:31:05 UTC
785487,mainnet,247,106704000,106788610,84611,79921,4690,0.055430145016605405,2021-11-14 05:32:33 UTC
785488,mainnet,247,106704000,106788810,84811,80112,4699,0.055405548808527195,2021-11-14 05:34:12 UTC
785490,mainnet,247,106704000,106788994,84995,80281,4714,0.05546208600505912,2021-11-14 05:35:40 UTC
785491,mainnet,247,106704000,106789178,85179,80460,4719,0.055400979114570495,2021-11-14 05:37:18 UTC
785492,mainnet,247,106704000,106789370,85371,80634,4737,0.0554872263414977,2021-11-14 05:38:49 UTC
785494,mainnet,247,106704000,106789559,85560,80809,4751,0.05552828424497429,2021-11-14 05:40:26 UTC
785495,mainnet,247,106704000,106789738,85739,80970,4769,0.05562229557144357,2021-11-14 05:41:53 UTC
785497,mainnet,247,106704000,106789918,85919,81145,4774,0.05556396140550984,2021-11-14 05:43:23 UTC
785498,mainnet,247,106704000,106790100,86101,81320,4781,0.055527810362248985,2021-11-14 05:44:52 UTC
785500,mainnet,247,106704000,106790264,86265,81463,4802,0.055665681330783055,2021-11-14 05:46:20 UTC
785501,mainnet,247,106704000,106790476,86477,81667,4810,0.05562172600807151,2021-11-14 05:48:19 UTC
785503,mainnet,247,106704000,106790680,86681,81858,4823,0.0556407978680449,2021-11-14 05:49:49 UTC
785504,mainnet,247,106704000,106790868,86869,82038,4831,0.05561247395503574,2021-11-14 05:51:17 UTC
785506,mainnet,247,106704000,106791061,87062,82226,4836,0.05554662194757759,2021-11-14 05:52:53 UTC
785507,mainnet,247,106704000,106791253,87254,82406,4848,0.055561922662571345,2021-11-14 05:54:41 UTC
785509,mainnet,247,106704000,106791474,87475,82618,4857,0.055524435553015145,2021-11-14 05:56:23 UTC
785510,mainnet,247,106704000,106791689,87690,82832,4858,0.05539970350096932,2021-11-14 05:58:05 UTC
785512,mainnet,247,106704000,106791861,87862,82996,4866,0.055382304067742597,2021-11-14 05:59:32 UTC
785513,mainnet,247,106704000,106792052,88053,83178,4875,0.05536438281489557,2021-11-14 06:01:06 UTC
785515,mainnet,247,106704000,106792232,88233,83354,4879,0.05529677104938062,2021-11-14 06:02:36 UTC
785516,mainnet,247,106704000,106792404,88405,83518,4887,0.055279678751201856,2021-11-14 06:04:02 UTC
785518,mainnet,247,106704000,106792584,88585,83686,4899,0.05530281650392278,2021-11-14 06:05:28 UTC
785519,mainnet,247,106704000,106792780,88781,83871,4910,0.05530462598979512,2021-11-14 06:07:15 UTC
785520,mainnet,247,106704000,106792994,88995,84068,4927,0.05536266082364178,2021-11-14 06:08:45 UTC
785521,mainnet,247,106704000,106793188,89189,84248,4941,0.05539920842256332,2021-11-14 06:10:25 UTC
785523,mainnet,247,106704000,106793366,89367,84419,4948,0.05536719370684928,2021-11-14 06:11:55 UTC
785524,mainnet,247,106704000,106793543,89544,84588,4956,0.055347091932457786,2021-11-14 06:13:32 UTC
785526,mainnet,247,106704000,106793747,89748,84779,4969,0.05536613629273076,2021-11-14 06:15:02 UTC
785527,mainnet,247,106704000,106793915,89916,84941,4975,0.05532941856844166,2021-11-14 06:16:32 UTC
785529,mainnet,247,106704000,106794091,90092,85101,4991,0.05539892554277849,2021-11-14 06:18:03 UTC
785530,mainnet,247,106704000,106794264,90265,85265,5000,0.055392455547554426,2021-11-14 06:19:29 UTC
785532,mainnet,247,106704000,106794456,90457,85456,5001,0.05528593696452458,2021-11-14 06:21:11 UTC
785533,mainnet,247,106704000,106794648,90649,85646,5003,0.055190901168242344,2021-11-14 06:22:51 UTC
785535,mainnet,247,106704000,106794831,90832,85820,5012,0.05517879161528977,2021-11-14 06:24:24 UTC
785536,mainnet,247,106704000,106795015,91016,85992,5024,0.05519908587501099,2021-11-14 06:25:54 UTC
785538,mainnet,247,106704000,106795218,91219,86185,5034,0.05518587136451836,2021-11-14 06:27:30 UTC
785539,mainnet,247,106704000,106795391,91392,86341,5051,0.05526741946778711,2021-11-14 06:28:59 UTC
785541,mainnet,247,106704000,106795558,91559,86502,5057,0.05523214539258839,2021-11-14 06:30:27 UTC
785542,mainnet,247,106704000,106795754,91755,86694,5061,0.055157757070459376,2021-11-14 06:32:05 UTC
785544,mainnet,247,106704000,106795938,91939,86872,5067,0.055112629025767086,2021-11-14 06:33:33 UTC
785545,mainnet,247,106704000,106796099,92100,87033,5067,0.05501628664495114,2021-11-14 06:35:02 UTC
785547,mainnet,247,106704000,106796273,92274,87202,5072,0.05496672952294254,2021-11-14 06:36:30 UTC
785548,mainnet,247,106704000,106796452,92453,87375,5078,0.05492520523941895,2021-11-14 06:37:57 UTC
785550,mainnet,247,106704000,106796647,92648,87554,5094,0.05498229859252223,2021-11-14 06:39:26 UTC
785551,mainnet,247,106704000,106796810,92811,87709,5102,0.054971932206311754,2021-11-14 06:40:56 UTC
785553,mainnet,247,106704000,106796984,92985,87877,5108,0.054933591439479484,2021-11-14 06:42:23 UTC
785554,mainnet,247,106704000,106797176,93177,88068,5109,0.05483112785344023,2021-11-14 06:44:00 UTC
785556,mainnet,247,106704000,106797350,93351,88237,5114,0.05478248760056132,2021-11-14 06:45:26 UTC
785557,mainnet,247,106704000,106797530,93531,88409,5122,0.05476259208176968,2021-11-14 06:46:53 UTC
785559,mainnet,247,106704000,106797715,93716,88583,5133,0.05477186392931837,2021-11-14 06:48:22 UTC
785560,mainnet,247,106704000,106797894,93895,88745,5150,0.054848500985142976,2021-11-14 06:49:49 UTC
785562,mainnet,247,106704000,106798096,94097,88946,5151,0.05474138389109111,2021-11-14 06:51:27 UTC
785563,mainnet,247,106704000,106798283,94284,89131,5153,0.054654024012557804,2021-11-14 06:53:04 UTC
785564,mainnet,247,106704000,106798470,94471,89299,5172,0.05474695938436134,2021-11-14 06:54:34 UTC
785565,mainnet,247,106704000,106798664,94665,89480,5185,0.05477209105794116,2021-11-14 06:56:02 UTC
785567,mainnet,247,106704000,106798849,94850,89661,5189,0.0547074327886136,2021-11-14 06:57:31 UTC
785568,mainnet,247,106704000,106799028,95029,89836,5193,0.05464647633880184,2021-11-14 06:58:59 UTC
785570,mainnet,247,106704000,106799210,95211,90009,5202,0.05463654409679554,2021-11-14 07:00:33 UTC
785571,mainnet,247,106704000,106799378,95379,90175,5204,0.054561276591283195,2021-11-14 07:02:05 UTC
785573,mainnet,247,106704000,106799569,95570,90365,5205,0.054462697499215236,2021-11-14 07:03:40 UTC
785574,mainnet,247,106704000,106799745,95746,90534,5212,0.05443569444154325,2021-11-14 07:05:09 UTC
785576,mainnet,247,106704000,106799915,95916,90704,5212,0.05433921347846032,2021-11-14 07:06:36 UTC
785577,mainnet,247,106704000,106800088,96089,90873,5216,0.054283008460906036,2021-11-14 07:08:05 UTC
785579,mainnet,247,106704000,106800276,96277,91051,5226,0.05428087705267094,2021-11-14 07:09:44 UTC
785580,mainnet,247,106704000,106800448,96449,91210,5239,0.05431886281869174,2021-11-14 07:11:13 UTC
785582,mainnet,247,106704000,106800618,96619,91376,5243,0.05426468913981722,2021-11-14 07:12:42 UTC
785583,mainnet,247,106704000,106800797,96798,91546,5252,0.054257319366102605,2021-11-14 07:14:11 UTC
785585,mainnet,247,106704000,106809883,105884,100147,5737,0.05418193494767859,2021-11-14 08:30:45 UTC
785586,mainnet,247,106704000,106810059,106060,100316,5744,0.05415802376013577,2021-11-14 08:32:18 UTC
785588,mainnet,247,106704000,106810316,106317,100570,5747,0.054055325112634854,2021-11-14 08:34:32 UTC
785589,mainnet,247,106704000,106810556,106557,100805,5752,0.05398049870022617,2021-11-14 08:36:24 UTC
785591,mainnet,247,106704000,106810715,106716,100964,5752,0.05390007121706211,2021-11-14 08:37:54 UTC
785592,mainnet,247,106704000,106810915,106916,101154,5762,0.05389277563694863,2021-11-14 08:39:36 UTC
785594,mainnet,247,106704000,106811128,107129,101362,5767,0.0538322956435699,2021-11-14 08:41:13 UTC
785595,mainnet,247,106704000,106811308,107309,101538,5771,0.05377927294075986,2021-11-14 08:42:42 UTC
785597,mainnet,247,106704000,106811487,107488,101713,5775,0.053726927657040784,2021-11-14 08:44:11 UTC
785598,mainnet,247,106704000,106811680,107681,101904,5777,0.05364920459505391,2021-11-14 08:45:43 UTC
785600,mainnet,247,106704000,106811868,107869,102074,5795,0.05372257089617963,2021-11-14 08:47:13 UTC
785601,mainnet,247,106704000,106812055,108056,102257,5799,0.053666617309543196,2021-11-14 08:48:47 UTC
785603,mainnet,247,106704000,106812236,108237,102426,5811,0.05368774079104188,2021-11-14 08:50:18 UTC
785604,mainnet,247,106704000,106812427,108428,102605,5823,0.05370384033644446,2021-11-14 08:51:50 UTC
785606,mainnet,247,106704000,106812636,108637,102801,5836,0.053720187413128125,2021-11-14 08:53:34 UTC
785607,mainnet,247,106704000,106812825,108826,102986,5840,0.05366364655505118,2021-11-14 08:55:06 UTC
785609,mainnet,247,106704000,106813027,109028,103178,5850,0.05365594159298529,2021-11-14 08:56:42 UTC
785610,mainnet,247,106704000,106813222,109223,103373,5850,0.053560147587962244,2021-11-14 08:58:22 UTC
785612,mainnet,247,106704000,106813451,109452,103592,5860,0.05353945108358002,2021-11-14 09:00:13 UTC
785613,mainnet,247,106704000,106813661,109662,103789,5873,0.053555470445550875,2021-11-14 09:01:58 UTC
785615,mainnet,247,106704000,106813849,109850,103970,5880,0.05352753755120619,2021-11-14 09:03:32 UTC
785616,mainnet,247,106704000,106814054,110055,104164,5891,0.053527781563763574,2021-11-14 09:05:17 UTC
786156,mainnet,247,106704000,107012375,308376,292045,16331,0.05295807715256699,2021-11-15 13:32:16 UTC
786157,mainnet,247,106704000,107012515,308516,292182,16334,0.052943769528970945,2021-11-15 13:33:36 UTC
786159,mainnet,247,106704000,107012651,308652,292313,16339,0.05293664061791273,2021-11-15 13:35:16 UTC
786160,mainnet,247,106704000,107012825,308826,292482,16344,0.05292300518738707,2021-11-15 13:36:14 UTC
786162,mainnet,247,106704000,107012968,308969,292608,16361,0.05295353255504597,2021-11-15 13:37:31 UTC
786163,mainnet,247,106704000,107013118,309119,292754,16365,0.05294077685292719,2021-11-15 13:38:48 UTC
786165,mainnet,247,106704000,107013232,309233,292865,16368,0.05293096144331297,2021-11-15 13:39:50 UTC
786166,mainnet,247,106704000,107013380,309381,293008,16373,0.05292180192060922,2021-11-15 13:41:16 UTC
786167,mainnet,247,106704000,107013512,309513,293129,16384,0.05293477172202783,2021-11-15 13:42:17 UTC
786169,mainnet,247,106704000,107013627,309628,293235,16393,0.05294417817510044,2021-11-15 13:43:17 UTC
786170,mainnet,247,106704000,107013749,309750,293352,16398,0.05293946731234867,2021-11-15 13:44:20 UTC
786172,mainnet,247,106704000,107013897,309898,293496,16402,0.05292709213999445,2021-11-15 13:45:40 UTC
786173,mainnet,247,106704000,107014008,310009,293606,16403,0.05291136708934257,2021-11-15 13:46:42 UTC
786174,mainnet,247,106704000,107014080,310081,293677,16404,0.05290230617161323,2021-11-15 13:47:42 UTC
786175,mainnet,247,106704000,107014252,310253,293836,16417,0.05291487914701872,2021-11-15 13:48:41 UTC
786177,mainnet,247,106704000,107014339,310340,293917,16423,0.0529193787458916,2021-11-15 13:49:39 UTC
786178,mainnet,247,106704000,107014512,310513,294077,16436,0.05293176131112063,2021-11-15 13:51:08 UTC
786180,mainnet,247,106704000,107014621,310622,294178,16444,0.0529389418650321,2021-11-15 13:52:08 UTC
786181,mainnet,247,106704000,107014763,310764,294303,16461,0.05296945592153531,2021-11-15 13:53:21 UTC
786182,mainnet,247,106704000,107014869,310870,294399,16471,0.052983562260752085,2021-11-15 13:54:21 UTC
786184,mainnet,247,106704000,107015025,311026,294547,16479,0.05298270884106152,2021-11-15 13:55:42 UTC
786185,mainnet,247,106704000,107015116,311117,294636,16481,0.0529736401418116,2021-11-15 13:56:43 UTC
786187,mainnet,247,106704000,107015252,311253,294761,16492,0.052985834674685865,2021-11-15 13:57:53 UTC
786188,mainnet,247,106704000,107015372,311373,294878,16495,0.05297504921749799,2021-11-15 13:58:52 UTC
786189,mainnet,247,106704000,107015483,311484,294983,16501,0.05297543373014344,2021-11-15 13:59:53 UTC
786191,mainnet,247,106704000,107015588,311589,295087,16502,0.052960791298794246,2021-11-15 14:00:57 UTC
786192,mainnet,247,106704000,107015725,311726,295216,16510,0.05296317920224813,2021-11-15 14:02:08 UTC
786194,mainnet,247,106704000,107015874,311875,295350,16525,0.05298597194388777,2021-11-15 14:03:37 UTC
786195,mainnet,247,106704000,107016013,312014,295468,16546,0.0530296717454986,2021-11-15 14:04:51 UTC
786196,mainnet,247,106704000,107016124,312125,295567,16558,0.05304925911093312,2021-11-15 14:05:51 UTC
786198,mainnet,247,106704000,107016240,312241,295668,16573,0.05307759070717811,2021-11-15 14:06:53 UTC
786199,mainnet,247,106704000,107016364,312365,295783,16582,0.05308533286379716,2021-11-15 14:08:03 UTC
786200,mainnet,247,106704000,107016471,312472,295885,16587,0.053083156250800075,2021-11-15 14:09:03 UTC
786202,mainnet,247,106704000,107016565,312566,295978,16588,0.05307039153330816,2021-11-15 14:10:02 UTC
786203,mainnet,247,106704000,107016695,312696,296097,16599,0.053083506025021106,2021-11-15 14:11:12 UTC
786205,mainnet,247,106704000,107016844,312845,296244,16601,0.05306461666320382,2021-11-15 14:12:35 UTC
786206,mainnet,247,106704000,107016965,312966,296348,16618,0.05309841963663785,2021-11-15 14:13:45 UTC
786207,mainnet,247,106704000,107017101,313102,296457,16645,0.05316158951396031,2021-11-15 14:14:55 UTC
786209,mainnet,247,106704000,107017216,313217,296553,16664,0.05320273165249651,2021-11-15 14:15:57 UTC
786210,mainnet,247,106704000,107017329,313330,296656,16674,0.05321545973893339,2021-11-15 14:16:57 UTC
786211,mainnet,247,106704000,107017430,313431,296752,16679,0.05321426406449904,2021-11-15 14:17:58 UTC
786213,mainnet,247,106704000,107017544,313545,296858,16687,0.053220430879140156,2021-11-15 14:18:57 UTC
786214,mainnet,247,106704000,107017657,313658,296961,16697,0.05323313927908741,2021-11-15 14:20:09 UTC
786216,mainnet,247,106704000,107017790,313791,297083,16708,0.05324563164654181,2021-11-15 14:21:23 UTC
786217,mainnet,247,106704000,107017889,313890,297171,16719,0.05326388225174424,2021-11-15 14:22:33 UTC
786219,mainnet,247,106704000,107018014,314015,297284,16731,0.053280894224798175,2021-11-15 14:23:44 UTC
786220,mainnet,247,106704000,107018165,314166,297426,16740,0.05328393269800042,2021-11-15 14:24:55 UTC
786221,mainnet,247,106704000,107018283,314284,297535,16749,0.05329256341398226,2021-11-15 14:25:56 UTC
786223,mainnet,247,106704000,107018400,314401,297652,16749,0.05327273132082913,2021-11-15 14:26:57 UTC
786224,mainnet,247,106704000,107018529,314530,297773,16757,0.05327631704447906,2021-11-15 14:28:07 UTC
786225,mainnet,247,106704000,107018644,314645,297884,16761,0.0532695577555658,2021-11-15 14:29:12 UTC
786227,mainnet,247,106704000,107018761,314762,297994,16768,0.053271995984267476,2021-11-15 14:30:12 UTC
786228,mainnet,247,106704000,107018882,314883,298110,16773,0.05326740408342146,2021-11-15 14:31:15 UTC
786230,mainnet,247,106704000,107018984,314985,298212,16773,0.05325015476927473,2021-11-15 14:32:17 UTC
786231,mainnet,247,106704000,107019111,315112,298330,16782,0.053257254563456806,2021-11-15 14:33:20 UTC
786232,mainnet,247,106704000,107019213,315214,298427,16787,0.05325588330467555,2021-11-15 14:34:22 UTC
786234,mainnet,247,106704000,107019357,315358,298559,16799,0.05326961738722341,2021-11-15 14:35:26 UTC
786235,mainnet,247,106704000,107019492,315493,298682,16811,0.05328485893506354,2021-11-15 14:36:41 UTC
786236,mainnet,247,106704000,107019633,315634,298819,16815,0.05327372843229817,2021-11-15 14:37:52 UTC
786238,mainnet,247,106704000,107019731,315732,298913,16819,0.0532698617815109,2021-11-15 14:38:55 UTC
786239,mainnet,247,106704000,107019860,315861,299021,16840,0.05331459091182514,2021-11-15 14:39:56 UTC
786241,mainnet,247,106704000,107019959,315960,299115,16845,0.05331371059627801,2021-11-15 14:41:00 UTC
786242,mainnet,247,106704000,107020108,316109,299243,16866,0.053355013618720123,2021-11-15 14:42:11 UTC
786243,mainnet,247,106704000,107020213,316214,299343,16871,0.05335310897050732,2021-11-15 14:43:11 UTC
786245,mainnet,247,106704000,107020387,316388,299495,16893,0.05339330189514141,2021-11-15 14:44:43 UTC
786246,mainnet,247,106704000,107020492,316493,299596,16897,0.05338822659584888,2021-11-15 14:45:49 UTC
786248,mainnet,247,106704000,107020592,316593,299682,16911,0.05341558404639395,2021-11-15 14:46:50 UTC
786249,mainnet,247,106704000,107020758,316759,299834,16925,0.05343178883630773,2021-11-15 14:47:52 UTC
786250,mainnet,247,106704000,107020903,316904,299962,16942,0.053460985030166865,2021-11-15 14:49:13 UTC
786252,mainnet,247,106704000,107021034,317035,300092,16943,0.053442048985127825,2021-11-15 14:50:24 UTC
786253,mainnet,247,106704000,107021157,317158,300213,16945,0.05342762913122166,2021-11-15 14:51:39 UTC
786255,mainnet,247,106704000,107021281,317282,300326,16956,0.053441418044515604,2021-11-15 14:52:41 UTC
786256,mainnet,247,106704000,107021422,317423,300461,16962,0.05343658147015182,2021-11-15 14:53:55 UTC
786257,mainnet,247,106704000,107021536,317537,300571,16966,0.053429993984952934,2021-11-15 14:54:57 UTC
786259,mainnet,247,106704000,107021652,317653,300681,16972,0.0534293710432453,2021-11-15 14:56:03 UTC
786260,mainnet,247,106704000,107021748,317749,300775,16974,0.053419522956799234,2021-11-15 14:57:07 UTC
786262,mainnet,247,106704000,107021892,317893,300899,16994,0.05345823909302816,2021-11-15 14:58:10 UTC
786263,mainnet,247,106704000,107022004,318005,301007,16998,0.053451989748588856,2021-11-15 14:59:15 UTC
786264,mainnet,247,106704000,107022130,318131,301121,17010,0.053468539689624714,2021-11-15 15:00:25 UTC
786266,mainnet,247,106704000,107022241,318242,301230,17012,0.053456174860640644,2021-11-15 15:01:29 UTC
786267,mainnet,247,106704000,107022357,318358,301325,17033,0.05350266052682829,2021-11-15 15:02:33 UTC
786268,mainnet,247,106704000,107022473,318474,301429,17045,0.05352085256567255,2021-11-15 15:03:36 UTC
786270,mainnet,247,106704000,107022579,318580,301530,17050,0.05351873940611463,2021-11-15 15:04:39 UTC
786271,mainnet,247,106704000,107022674,318675,301617,17058,0.05352788891503883,2021-11-15 15:05:41 UTC
786273,mainnet,247,106704000,107022835,318836,301761,17075,0.053554178323652286,2021-11-15 15:07:16 UTC
786274,mainnet,247,106704000,107022940,318941,301850,17091,0.053586713530088634,2021-11-15 15:08:19 UTC
786275,mainnet,247,106704000,107023038,319039,301944,17095,0.05358279081867734,2021-11-15 15:09:24 UTC
786277,mainnet,247,106704000,107023171,319172,302057,17115,0.05362312483551189,2021-11-15 15:10:36 UTC
786278,mainnet,247,106704000,107023290,319291,302169,17122,0.053625063030276456,2021-11-15 15:11:38 UTC
786280,mainnet,247,106704000,107023414,319415,302287,17128,0.05362302960098931,2021-11-15 15:12:51 UTC
786281,mainnet,247,106704000,107023552,319553,302420,17133,0.053615519178352264,2021-11-15 15:14:04 UTC
786282,mainnet,247,106704000,107023683,319684,302541,17143,0.05362482951915016,2021-11-15 15:15:08 UTC
786284,mainnet,247,106704000,107023808,319809,302662,17147,0.053616377275186124,2021-11-15 15:16:22 UTC
786285,mainnet,247,106704000,107023929,319930,302780,17150,0.05360547619791829,2021-11-15 15:17:27 UTC
786287,mainnet,247,106704000,107024039,320040,302888,17152,0.05359330083739532,2021-11-15 15:18:32 UTC
786288,mainnet,247,106704000,107024161,320162,302996,17166,0.05361660659291234,2021-11-15 15:19:34 UTC
786289,mainnet,247,106704000,107024273,320274,303099,17175,0.05362595777365631,2021-11-15 15:20:40 UTC
786291,mainnet,247,106704000,107024380,320381,303202,17179,0.05362053305283397,2021-11-15 15:21:52 UTC
786292,mainnet,247,106704000,107024528,320529,303326,17203,0.05367065070555238,2021-11-15 15:22:58 UTC
786293,mainnet,247,106704000,107024650,320651,303444,17207,0.05366270493464857,2021-11-15 15:24:02 UTC
786295,mainnet,247,106704000,107024772,320773,303561,17212,0.05365788267715799,2021-11-15 15:25:07 UTC
786296,mainnet,247,106704000,107024892,320893,303673,17220,0.0536627473955493,2021-11-15 15:26:15 UTC
786298,mainnet,247,106704000,107025051,321052,303831,17221,0.053639285847775435,2021-11-15 15:27:37 UTC
786299,mainnet,247,106704000,107025176,321177,303952,17225,0.05363086397842934,2021-11-15 15:28:41 UTC
786300,mainnet,247,106704000,107025275,321276,304046,17230,0.053629900770676926,2021-11-15 15:29:45 UTC
786302,mainnet,247,106704000,107025395,321396,304150,17246,0.05365965973440864,2021-11-15 15:30:49 UTC
786303,mainnet,247,106704000,107025532,321533,304275,17258,0.05367411743118125,2021-11-15 15:31:55 UTC
786305,mainnet,247,106704000,107025656,321657,304396,17261,0.05366275255940334,2021-11-15 15:33:27 UTC
786306,mainnet,247,106704000,107025812,321813,304531,17282,0.0537019946366368,2021-11-15 15:34:33 UTC
786307,mainnet,247,106704000,107025923,321924,304633,17291,0.05371143499708005,2021-11-15 15:35:48 UTC
786309,mainnet,247,106704000,107026058,322059,304749,17310,0.05374791575456671,2021-11-15 15:36:54 UTC
786310,mainnet,247,106704000,107026179,322180,304849,17331,0.05379291079520765,2021-11-15 15:38:00 UTC
786312,mainnet,247,106704000,107026305,322306,304962,17344,0.0538122157204644,2021-11-15 15:39:16 UTC
786313,mainnet,247,106704000,107026454,322455,305097,17358,0.05383076708377913,2021-11-15 15:40:33 UTC
786314,mainnet,247,106704000,107026593,322594,305225,17369,0.05384167095482247,2021-11-15 15:41:48 UTC
786316,mainnet,247,106704000,107026707,322708,305337,17371,0.05382884837066326,2021-11-15 15:42:50 UTC
786317,mainnet,247,106704000,107026824,322825,305444,17381,0.0538403159606598,2021-11-15 15:43:55 UTC
786318,mainnet,247,106704000,107026936,322937,305546,17391,0.0538526090228125,2021-11-15 15:44:59 UTC
786320,mainnet,247,106704000,107027029,323030,305638,17392,0.053840200600563416,2021-11-15 15:46:04 UTC
786321,mainnet,247,106704000,107027164,323165,305758,17407,0.053864125137313756,2021-11-15 15:47:10 UTC
786323,mainnet,247,106704000,107027276,323277,305865,17412,0.05386093040952496,2021-11-15 15:48:15 UTC
786324,mainnet,247,106704000,107027389,323390,305969,17421,0.053869940319737776,2021-11-15 15:49:18 UTC
786325,mainnet,247,106704000,107027498,323499,306075,17424,0.053861062939916354,2021-11-15 15:50:23 UTC
786327,mainnet,247,106704000,107027620,323621,306188,17433,0.05386856847979581,2021-11-15 15:51:28 UTC
786328,mainnet,247,106704000,107027747,323748,306307,17441,0.0538721474727257,2021-11-15 15:52:35 UTC
786329,mainnet,247,106704000,107027869,323870,306415,17455,0.05389508135980486,2021-11-15 15:53:38 UTC
786331,mainnet,247,106704000,107028008,324009,306546,17463,0.053896651018953176,2021-11-15 15:54:56 UTC
786332,mainnet,247,106704000,107028140,324141,306672,17469,0.053893213138726664,2021-11-15 15:56:10 UTC
786334,mainnet,247,106704000,107028229,324230,306756,17474,0.05389384079203035,2021-11-15 15:57:12 UTC
786335,mainnet,247,106704000,107028295,324296,306805,17491,0.05393529368231492,2021-11-15 15:58:17 UTC
786336,mainnet,247,106704000,107028475,324476,306945,17531,0.05402864926835883,2021-11-15 15:59:18 UTC
786338,mainnet,247,106704000,107028589,324590,307050,17540,0.05403740102899042,2021-11-15 16:00:28 UTC
786339,mainnet,247,106704000,107028740,324741,307179,17562,0.05408002069341414,2021-11-15 16:01:48 UTC
786340,mainnet,247,106704000,107028864,324865,307295,17570,0.054084004124790294,2021-11-15 16:02:57 UTC
786341,mainnet,247,106704000,107028969,324970,307397,17573,0.054075760839462104,2021-11-15 16:04:04 UTC
786343,mainnet,247,106704000,107029086,325087,307509,17578,0.05407167927354831,2021-11-15 16:05:12 UTC
786344,mainnet,247,106704000,107029191,325192,307597,17595,0.054106497084799136,2021-11-15 16:06:16 UTC
786345,mainnet,247,106704000,107029323,325324,307717,17607,0.054121429713147505,2021-11-15 16:07:31 UTC
786347,mainnet,247,106704000,107029442,325443,307830,17613,0.05412007632673003,2021-11-15 16:08:36 UTC
786348,mainnet,247,106704000,107029541,325542,307923,17619,0.054122048767900915,2021-11-15 16:09:42 UTC
786350,mainnet,247,106704000,107029642,325643,308002,17641,0.0541728211569111,2021-11-15 16:10:46 UTC
786351,mainnet,247,106704000,107029795,325796,308145,17651,0.054178074623383955,2021-11-15 16:11:59 UTC
786352,mainnet,247,106704000,107029894,325895,308239,17656,0.05417695883643505,2021-11-15 16:13:02 UTC
786354,mainnet,247,106704000,107030032,326033,308363,17670,0.05419696779160392,2021-11-15 16:14:09 UTC
786355,mainnet,247,106704000,107030143,326144,308470,17674,0.05419078689167975,2021-11-15 16:15:13 UTC
786356,mainnet,247,106704000,107030256,326257,308580,17677,0.05418121297014317,2021-11-15 16:16:17 UTC
786358,mainnet,247,106704000,107030377,326378,308696,17682,0.05417644571631666,2021-11-15 16:17:24 UTC
786359,mainnet,247,106704000,107030504,326505,308821,17684,0.05416149829252232,2021-11-15 16:18:31 UTC
786361,mainnet,247,106704000,107030626,326627,308939,17688,0.05415351455942099,2021-11-15 16:19:39 UTC
786362,mainnet,247,106704000,107030762,326763,309069,17694,0.054149337593301566,2021-11-15 16:20:49 UTC
786363,mainnet,247,106704000,107030872,326873,309175,17698,0.05414335231114225,2021-11-15 16:21:54 UTC
786365,mainnet,247,106704000,107030996,326997,309298,17699,0.054125878830692635,2021-11-15 16:22:59 UTC
786366,mainnet,247,106704000,107031123,327124,309425,17699,0.05410486543329135,2021-11-15 16:24:04 UTC
786367,mainnet,247,106704000,107031236,327237,309526,17711,0.05412285285588121,2021-11-15 16:25:07 UTC
786369,mainnet,247,106704000,107031344,327345,309627,17718,0.05412638042432296,2021-11-15 16:26:14 UTC
786370,mainnet,247,106704000,107031461,327462,309730,17732,0.0541497944799702,2021-11-15 16:27:19 UTC
786371,mainnet,247,106704000,107031563,327564,309822,17742,0.05416346118621094,2021-11-15 16:28:26 UTC
786373,mainnet,247,106704000,107031673,327674,309923,17751,0.054172744862271645,2021-11-15 16:29:29 UTC
786374,mainnet,247,106704000,107031795,327796,310039,17757,0.054170886771040525,2021-11-15 16:30:36 UTC
786376,mainnet,247,106704000,107031915,327916,310149,17767,0.05418155869186011,2021-11-15 16:31:41 UTC
786377,mainnet,247,106704000,107032051,328052,310267,17785,0.054213966078548524,2021-11-15 16:32:57 UTC
786378,mainnet,247,106704000,107032174,328175,310378,17797,0.05423021253904167,2021-11-15 16:34:08 UTC
786380,mainnet,247,106704000,107032309,328310,310503,17807,0.054238372270110566,2021-11-15 16:35:23 UTC
786381,mainnet,247,106704000,107032411,328412,310598,17814,0.05424284130908737,2021-11-15 16:36:28 UTC
786383,mainnet,247,106704000,107032524,328525,310703,17822,0.05424853511909292,2021-11-15 16:37:32 UTC
786384,mainnet,247,106704000,107032668,328669,310832,17837,0.0542704057881942,2021-11-15 16:38:40 UTC
786385,mainnet,247,106704000,107032788,328789,310947,17842,0.05426580572951042,2021-11-15 16:39:46 UTC
786387,mainnet,247,106704000,107032911,328912,311060,17852,0.05427591574646106,2021-11-15 16:40:54 UTC
786388,mainnet,247,106704000,107033044,329045,311177,17868,0.05430260298743333,2021-11-15 16:42:28 UTC
786390,mainnet,247,106704000,107033243,329244,311362,17882,0.05431230333734252,2021-11-15 16:43:57 UTC
786391,mainnet,247,106704000,107033368,329369,311481,17888,0.05430990773266458,2021-11-15 16:45:12 UTC
786392,mainnet,247,106704000,107033483,329484,311593,17891,0.054300057058916364,2021-11-15 16:46:17 UTC
786394,mainnet,247,106704000,107033611,329612,311708,17904,0.05431841073747315,2021-11-15 16:47:23 UTC
786395,mainnet,247,106704000,107033740,329741,311829,17912,0.05432142196451154,2021-11-15 16:48:30 UTC
786397,mainnet,247,106704000,107033860,329861,311945,17916,0.054313786716222896,2021-11-15 16:49:38 UTC
786398,mainnet,247,106704000,107033988,329989,312061,17928,0.054329083696729286,2021-11-15 16:50:44 UTC
786399,mainnet,247,106704000,107034098,330099,312167,17932,0.05432309701029085,2021-11-15 16:51:47 UTC
786401,mainnet,247,106704000,107034228,330229,312284,17945,0.05434107846373274,2021-11-15 16:52:56 UTC
786402,mainnet,247,106704000,107034366,330367,312418,17949,0.05433048700384724,2021-11-15 16:54:03 UTC
786403,mainnet,247,106704000,107034494,330495,312544,17951,0.05431549645229126,2021-11-15 16:55:09 UTC
786405,mainnet,247,106704000,107034636,330637,312682,17955,0.05430426721752254,2021-11-15 16:56:37 UTC
786406,mainnet,247,106704000,107034801,330802,312830,17972,0.05432857116946089,2021-11-15 16:57:51 UTC
786408,mainnet,247,106704000,107034919,330920,312946,17974,0.05431524235464765,2021-11-15 16:58:57 UTC
786409,mainnet,247,106704000,107035046,331047,313065,17982,0.054318571079031076,2021-11-15 17:00:19 UTC
786411,mainnet,247,106704000,107035177,331178,313191,17987,0.05431218257251388,2021-11-15 17:01:40 UTC
786412,mainnet,247,106704000,107035343,331344,313331,18013,0.05436344101598339,2021-11-15 17:03:07 UTC
786414,mainnet,247,106704000,107035511,331512,313485,18027,0.054378122058929994,2021-11-15 17:04:36 UTC
786415,mainnet,247,106704000,107035633,331634,313598,18036,0.054385256035267796,2021-11-15 17:05:44 UTC
786416,mainnet,247,106704000,107035762,331763,313698,18065,0.05445152111597737,2021-11-15 17:06:50 UTC
786418,mainnet,247,106704000,107035875,331876,313806,18070,0.054448046860875746,2021-11-15 17:07:56 UTC
786419,mainnet,247,106704000,107036028,332029,313940,18089,0.05448018094804972,2021-11-15 17:09:14 UTC
786421,mainnet,247,106704000,107036185,332186,314083,18103,0.05449657721878706,2021-11-15 17:10:30 UTC
786422,mainnet,247,106704000,107036312,332313,314204,18109,0.054493805538754124,2021-11-15 17:11:37 UTC
786423,mainnet,247,106704000,107036464,332465,314347,18118,0.0544959619809604,2021-11-15 17:12:52 UTC
786425,mainnet,247,106704000,107036607,332608,314486,18122,0.05448455839907639,2021-11-15 17:14:10 UTC
786426,mainnet,247,106704000,107036724,332725,314596,18129,0.054486437748891725,2021-11-15 17:15:15 UTC
786428,mainnet,247,106704000,107036884,332885,314745,18140,0.05449329347973024,2021-11-15 17:16:34 UTC
786429,mainnet,247,106704000,107036993,332994,314849,18145,0.054490471299783176,2021-11-15 17:17:39 UTC
786430,mainnet,247,106704000,107037151,333152,314986,18166,0.054527663048698494,2021-11-15 17:18:52 UTC
786432,mainnet,247,106704000,107037260,333261,315085,18176,0.0545398351442263,2021-11-15 17:19:58 UTC
786433,mainnet,247,106704000,107037385,333386,315196,18190,0.05456137930207027,2021-11-15 17:21:06 UTC
786434,mainnet,247,106704000,107037489,333490,315294,18196,0.054562355692824374,2021-11-15 17:22:13 UTC
786436,mainnet,247,106704000,107037642,333643,315429,18214,0.05459128469651694,2021-11-15 17:23:20 UTC
786437,mainnet,247,106704000,107037734,333735,315521,18214,0.05457623563605855,2021-11-15 17:24:24 UTC
786439,mainnet,247,106704000,107037893,333894,315659,18235,0.05461314069734706,2021-11-15 17:25:32 UTC
786440,mainnet,247,106704000,107038013,334014,315778,18236,0.05459651391857826,2021-11-15 17:26:42 UTC
786441,mainnet,247,106704000,107038139,334140,315896,18244,0.05459986831866882,2021-11-15 17:27:47 UTC
786443,mainnet,247,106704000,107038253,334254,316009,18245,0.05458423833372226,2021-11-15 17:28:53 UTC
786444,mainnet,247,106704000,107038387,334388,316138,18250,0.05457731736784813,2021-11-15 17:29:59 UTC
786445,mainnet,247,106704000,107038517,334518,316252,18266,0.054603937605749164,2021-11-15 17:31:07 UTC
786447,mainnet,247,106704000,107038635,334636,316364,18272,0.05460261298844117,2021-11-15 17:32:16 UTC
786448,mainnet,247,106704000,107038769,334770,316496,18274,0.05458673118857723,2021-11-15 17:33:22 UTC
786450,mainnet,247,106704000,107038896,334897,316619,18278,0.05457797472058573,2021-11-15 17:34:29 UTC
786451,mainnet,247,106704000,107039016,335017,316735,18282,0.05457036508595086,2021-11-15 17:35:40 UTC
786452,mainnet,247,106704000,107039180,335181,316888,18293,0.05457648255718552,2021-11-15 17:37:02 UTC
786454,mainnet,247,106704000,107039292,335293,316995,18298,0.05457316436668824,2021-11-15 17:38:12 UTC
786455,mainnet,247,106704000,107039434,335435,317114,18321,0.054618629540745596,2021-11-15 17:39:18 UTC
786457,mainnet,247,106704000,107039566,335567,317229,18338,0.0546478050583043,2021-11-15 17:40:26 UTC
786458,mainnet,247,106704000,107039702,335703,317355,18348,0.0546554543748492,2021-11-15 17:41:37 UTC
786459,mainnet,247,106704000,107039844,335845,317488,18357,0.05465914335482142,2021-11-15 17:42:57 UTC
786460,mainnet,247,106704000,107039984,335985,317624,18361,0.054648272988377454,2021-11-15 17:44:05 UTC
786461,mainnet,247,106704000,107040109,336110,317745,18365,0.05463985004909107,2021-11-15 17:45:16 UTC
786463,mainnet,247,106704000,107040255,336256,317878,18378,0.054654786829082605,2021-11-15 17:46:33 UTC
786464,mainnet,247,106704000,107040381,336382,318003,18379,0.05463728736971657,2021-11-15 17:47:42 UTC
786466,mainnet,247,106704000,107040511,336512,318129,18383,0.05462806675542031,2021-11-15 17:48:49 UTC
786467,mainnet,247,106704000,107040664,336665,318265,18400,0.05465373590958371,2021-11-15 17:50:01 UTC
786468,mainnet,247,106704000,107040792,336793,318385,18408,0.05465671792465995,2021-11-15 17:51:08 UTC
786470,mainnet,247,106704000,107040949,336950,318526,18424,0.054678735717465496,2021-11-15 17:52:26 UTC
786471,mainnet,247,106704000,107041083,337084,318651,18433,0.054683699018642236,2021-11-15 17:53:48 UTC
786473,mainnet,247,106704000,107041223,337224,318789,18435,0.05466692762080991,2021-11-15 17:54:54 UTC
786474,mainnet,247,106704000,107041386,337387,318939,18448,0.054679048096103286,2021-11-15 17:56:21 UTC
786476,mainnet,247,106704000,107041516,337517,319067,18450,0.054663913225111625,2021-11-15 17:57:31 UTC
786477,mainnet,247,106704000,107041637,337638,319179,18459,0.05467097897748476,2021-11-15 17:58:46 UTC
786478,mainnet,247,106704000,107041778,337779,319308,18471,0.054683683710354994,2021-11-15 17:59:53 UTC
786480,mainnet,247,106704000,107041922,337923,319437,18486,0.05470477002157296,2021-11-15 18:01:05 UTC
786481,mainnet,247,106704000,107042061,338062,319558,18504,0.054735521886517854,2021-11-15 18:02:26 UTC
786483,mainnet,247,106704000,107042173,338174,319652,18522,0.05477062104123913,2021-11-15 18:03:34 UTC
786484,mainnet,247,106704000,107042310,338311,319778,18533,0.054780955984286644,2021-11-15 18:04:44 UTC
786485,mainnet,247,106704000,107042438,338439,319893,18546,0.05479864909185998,2021-11-15 18:05:55 UTC
786487,mainnet,247,106704000,107042558,338559,319998,18561,0.05482353149672583,2021-11-15 18:07:05 UTC
786488,mainnet,247,106704000,107042724,338725,320135,18590,0.05488227913499151,2021-11-15 18:08:17 UTC
786490,mainnet,247,106704000,107042871,338872,320282,18590,0.05485847163530773,2021-11-15 18:09:36 UTC
786491,mainnet,247,106704000,107042991,338992,320400,18592,0.05484495209326474,2021-11-15 18:10:48 UTC
786492,mainnet,247,106704000,107043131,339132,320529,18603,0.054854746824245425,2021-11-15 18:11:59 UTC
786494,mainnet,247,106704000,107043258,339259,320654,18605,0.05484010741056243,2021-11-15 18:13:11 UTC
786495,mainnet,247,106704000,107043409,339410,320790,18620,0.054859903950973746,2021-11-15 18:14:34 UTC
786496,mainnet,247,106704000,107043531,339532,320904,18628,0.05486375363735966,2021-11-15 18:15:43 UTC
786498,mainnet,247,106704000,107043684,339685,321039,18646,0.05489203232406494,2021-11-15 18:17:07 UTC
786499,mainnet,247,106704000,107043838,339839,321186,18653,0.054887755672539056,2021-11-15 18:18:27 UTC
786501,mainnet,247,106704000,107043986,339987,321322,18665,0.054899157908978875,2021-11-15 18:19:42 UTC
786502,mainnet,247,106704000,107044112,340113,321440,18673,0.054902341280692005,2021-11-15 18:20:51 UTC
786504,mainnet,247,106704000,107044246,340247,321573,18674,0.054883658048417765,2021-11-15 18:22:01 UTC
786505,mainnet,247,106704000,107044392,340393,321706,18687,0.05489830871962702,2021-11-15 18:23:32 UTC
786506,mainnet,247,106704000,107044563,340564,321866,18698,0.054903043187183614,2021-11-15 18:25:02 UTC
786507,mainnet,247,106704000,107044725,340726,322022,18704,0.05489454869895458,2021-11-15 18:26:32 UTC
786509,mainnet,247,106704000,107044885,340886,322162,18724,0.054927453752867526,2021-11-15 18:27:52 UTC
786510,mainnet,247,106704000,107045068,341069,322336,18733,0.05492437014211201,2021-11-15 18:29:16 UTC
786512,mainnet,247,106704000,107045208,341209,322467,18742,0.054928211155039874,2021-11-15 18:30:44 UTC
786513,mainnet,247,106704000,107045392,341393,322646,18747,0.05491325246856262,2021-11-15 18:32:16 UTC
786515,mainnet,247,106704000,107045524,341525,322770,18755,0.05491545274870068,2021-11-15 18:33:23 UTC
786516,mainnet,247,106704000,107045652,341653,322893,18760,0.05490951345370888,2021-11-15 18:34:34 UTC
786517,mainnet,247,106704000,107045799,341800,323034,18766,0.054903452311293156,2021-11-15 18:35:55 UTC
786519,mainnet,247,106704000,107045927,341928,323151,18777,0.054915069839264405,2021-11-15 18:37:24 UTC
786520,mainnet,247,106704000,107046138,342139,323352,18787,0.05491043114055983,2021-11-15 18:38:56 UTC
786522,mainnet,247,106704000,107046263,342264,323474,18790,0.054899142182642635,2021-11-15 18:40:07 UTC
786523,mainnet,247,106704000,107046402,342403,323604,18799,0.05490314045145633,2021-11-15 18:41:29 UTC
786525,mainnet,247,106704000,107046536,342537,323720,18817,0.05493421148664232,2021-11-15 18:42:42 UTC
786526,mainnet,247,106704000,107046664,342665,323839,18826,0.05493995593363781,2021-11-15 18:43:53 UTC
786528,mainnet,247,106704000,107046796,342797,323961,18836,0.05494797212344332,2021-11-15 18:45:06 UTC
786529,mainnet,247,106704000,107046933,342934,324086,18848,0.05496101290627351,2021-11-15 18:46:29 UTC
786530,mainnet,247,106704000,107047050,343051,324193,18858,0.054971418243934575,2021-11-15 18:47:37 UTC
786532,mainnet,247,106704000,107047251,343252,324366,18886,0.055020801044130846,2021-11-15 18:49:06 UTC
786533,mainnet,247,106704000,107047309,343310,324423,18887,0.055014418455623194,2021-11-15 18:50:14 UTC
786535,mainnet,247,106704000,107047450,343451,324537,18914,0.0550704467303924,2021-11-15 18:51:19 UTC
786536,mainnet,247,106704000,107047594,343595,324676,18919,0.05506191882885374,2021-11-15 18:52:35 UTC
786537,mainnet,247,106704000,107047758,343759,324834,18925,0.055053104064184503,2021-11-15 18:54:07 UTC
786538,mainnet,247,106704000,107047888,343889,324948,18941,0.05507881903753827,2021-11-15 18:55:12 UTC
786539,mainnet,247,106704000,107048001,344002,325059,18943,0.055066540310812144,2021-11-15 18:56:19 UTC
786541,mainnet,247,106704000,107048163,344164,325202,18962,0.05509582640834021,2021-11-15 18:57:38 UTC
786542,mainnet,247,106704000,107048305,344306,325338,18968,0.05509052993558056,2021-11-15 18:58:45 UTC
786544,mainnet,247,106704000,107048436,344437,325469,18968,0.05506957731021928,2021-11-15 19:00:01 UTC
786545,mainnet,247,106704000,107048599,344600,325623,18977,0.05506964596633778,2021-11-15 19:01:13 UTC
786546,mainnet,247,106704000,107048735,344736,325755,18981,0.05505952380952381,2021-11-15 19:02:24 UTC
786548,mainnet,247,106704000,107048856,344857,325870,18987,0.05505760358641408,2021-11-15 19:03:31 UTC
786549,mainnet,247,106704000,107048979,344980,325990,18990,0.055046669372137515,2021-11-15 19:04:48 UTC
786551,mainnet,247,106704000,107049119,345120,326111,19009,0.05507939267501159,2021-11-15 19:06:06 UTC
786552,mainnet,247,106704000,107049323,345324,326297,19027,0.0550989795090987,2021-11-15 19:07:46 UTC
786554,mainnet,247,106704000,107049508,345509,326467,19042,0.05511289141527428,2021-11-15 19:09:20 UTC
786555,mainnet,247,106704000,107049644,345645,326596,19049,0.055111458288127996,2021-11-15 19:10:38 UTC
786557,mainnet,247,106704000,107049780,345781,326729,19052,0.05509845827272175,2021-11-15 19:11:57 UTC
786558,mainnet,247,106704000,107049910,345911,326856,19055,0.05508642396454579,2021-11-15 19:13:15 UTC
786560,mainnet,247,106704000,107050066,346067,327006,19061,0.05507892980261048,2021-11-15 19:14:43 UTC
786561,mainnet,247,106704000,107050220,346221,327154,19067,0.055071760522903,2021-11-15 19:15:52 UTC
786562,mainnet,247,106704000,107050350,346351,327279,19072,0.055065526012628804,2021-11-15 19:17:02 UTC
786563,mainnet,247,106704000,107050483,346484,327412,19072,0.0550443887740848,2021-11-15 19:18:09 UTC
786565,mainnet,247,106704000,107050660,346661,327585,19076,0.055027822570176625,2021-11-15 19:19:49 UTC
786566,mainnet,247,106704000,107050829,346830,327745,19085,0.05502695845226768,2021-11-15 19:21:07 UTC
786568,mainnet,247,106704000,107050953,346954,327863,19091,0.0550245853917234,2021-11-15 19:22:15 UTC
786569,mainnet,247,106704000,107051086,347087,327987,19100,0.05502943066147681,2021-11-15 19:23:30 UTC
786570,mainnet,247,106704000,107051208,347209,328107,19102,0.055015855003758544,2021-11-15 19:24:37 UTC
786572,mainnet,247,106704000,107051341,347342,328231,19111,0.055020700059307544,2021-11-15 19:25:56 UTC
786573,mainnet,247,106704000,107051494,347495,328373,19122,0.05502812990114966,2021-11-15 19:27:10 UTC
786575,mainnet,247,106704000,107051628,347629,328503,19126,0.055018424814960776,2021-11-15 19:28:19 UTC
786576,mainnet,247,106704000,107051764,347765,328632,19133,0.05501703736718761,2021-11-15 19:29:31 UTC
786578,mainnet,247,106704000,107051897,347898,328749,19149,0.05504199506751979,2021-11-15 19:30:43 UTC
786579,mainnet,247,106704000,107052042,348043,328880,19163,0.05505928865111495,2021-11-15 19:31:58 UTC
786580,mainnet,247,106704000,107052175,348176,329008,19168,0.055052617067230365,2021-11-15 19:33:09 UTC
786582,mainnet,247,106704000,107052325,348326,329158,19168,0.05502890969953434,2021-11-15 19:34:24 UTC
786583,mainnet,247,106704000,107052370,348371,329199,19172,0.0550332834822646,2021-11-15 19:35:48 UTC
786585,mainnet,247,106704000,107052625,348626,329437,19189,0.05504179263738218,2021-11-15 19:37:00 UTC
786586,mainnet,247,106704000,107052788,348789,329585,19204,0.055059075830946505,2021-11-15 19:38:24 UTC
786587,mainnet,247,106704000,107052959,348960,329746,19214,0.05506075194864741,2021-11-15 19:39:49 UTC
786588,mainnet,247,106704000,107053124,349125,329901,19224,0.05506337271750806,2021-11-15 19:41:17 UTC
786590,mainnet,247,106704000,107053292,349293,330063,19230,0.05505406635689808,2021-11-15 19:42:40 UTC
786591,mainnet,247,106704000,107053439,349440,330206,19234,0.05504235347985348,2021-11-15 19:43:55 UTC
786593,mainnet,247,106704000,107053586,349587,330340,19247,0.05505639511766742,2021-11-15 19:45:09 UTC
786594,mainnet,247,106704000,107053706,349707,330454,19253,0.05505466004397967,2021-11-15 19:46:23 UTC
786596,mainnet,247,106704000,107053857,349858,330599,19259,0.05504804806521503,2021-11-15 19:47:58 UTC
786597,mainnet,247,106704000,107054024,350025,330750,19275,0.05506749517891579,2021-11-15 19:49:14 UTC
786599,mainnet,247,106704000,107054153,350154,330872,19282,0.05506719900386687,2021-11-15 19:50:29 UTC
786600,mainnet,247,106704000,107054274,350275,330983,19292,0.05507672543001927,2021-11-15 19:51:42 UTC
786601,mainnet,247,106704000,107054411,350412,331111,19301,0.055080876225700036,2021-11-15 19:52:57 UTC
786603,mainnet,247,106704000,107054573,350574,331259,19315,0.05509535789876032,2021-11-15 19:54:11 UTC
786604,mainnet,247,106704000,107054732,350733,331418,19315,0.055070381173143106,2021-11-15 19:55:30 UTC
786606,mainnet,247,106704000,107054903,350904,331581,19323,0.05506634293140004,2021-11-15 19:57:04 UTC
786607,mainnet,247,106704000,107055062,351063,331726,19337,0.05508128170727192,2021-11-15 19:58:21 UTC
786608,mainnet,247,106704000,107055179,351180,331838,19342,0.05507716840366764,2021-11-15 19:59:35 UTC
786610,mainnet,247,106704000,107055362,351363,332004,19359,0.055096865634685493,2021-11-15 20:01:05 UTC
786611,mainnet,247,106704000,107055512,351513,332139,19374,0.055116027003268724,2021-11-15 20:02:21 UTC
786613,mainnet,247,106704000,107055626,351627,332244,19383,0.05512375329539541,2021-11-15 20:03:35 UTC
786614,mainnet,247,106704000,107055783,351784,332395,19389,0.05511620767289018,2021-11-15 20:04:51 UTC
786615,mainnet,247,106704000,107055912,351913,332518,19395,0.05511305351038467,2021-11-15 20:06:05 UTC
786617,mainnet,247,106704000,107056058,352059,332649,19410,0.055132804444709554,2021-11-15 20:07:18 UTC
786618,mainnet,247,106704000,107056202,352203,332792,19411,0.05511310238697569,2021-11-15 20:08:33 UTC
786620,mainnet,247,106704000,107056360,352361,332950,19411,0.05508838946421426,2021-11-15 20:09:58 UTC
786621,mainnet,247,106704000,107056512,352513,333085,19428,0.05511286108597414,2021-11-15 20:11:14 UTC
786622,mainnet,247,106704000,107056656,352657,333228,19429,0.05509319253552319,2021-11-15 20:12:27 UTC
786624,mainnet,247,106704000,107056826,352827,333390,19437,0.05508932139547144,2021-11-15 20:13:53 UTC
786625,mainnet,247,106704000,107056955,352956,333511,19445,0.05509185280884869,2021-11-15 20:15:09 UTC
786627,mainnet,247,106704000,107057129,353130,333674,19456,0.05509585704981168,2021-11-15 20:16:28 UTC
786628,mainnet,247,106704000,107057265,353266,333804,19462,0.05509163066924074,2021-11-15 20:17:40 UTC
786630,mainnet,247,106704000,107057417,353418,333947,19471,0.05509340214703269,2021-11-15 20:18:54 UTC
786631,mainnet,247,106704000,107057551,353552,334080,19472,0.05507534959496764,2021-11-15 20:20:06 UTC
786632,mainnet,247,106704000,107057685,353686,334202,19484,0.055088411755059574,2021-11-15 20:21:24 UTC
786634,mainnet,247,106704000,107057830,353831,334345,19486,0.0550714889311564,2021-11-15 20:22:40 UTC
786635,mainnet,247,106704000,107057981,353982,334486,19496,0.05507624681480979,2021-11-15 20:24:06 UTC
786637,mainnet,247,106704000,107058144,354145,334639,19506,0.055079134252919,2021-11-15 20:25:33 UTC
786638,mainnet,247,106704000,107058281,354282,334766,19516,0.055086061386127434,2021-11-15 20:26:49 UTC
786640,mainnet,247,106704000,107058414,354415,334892,19523,0.0550851403016238,2021-11-15 20:28:11 UTC
786641,mainnet,247,106704000,107058591,354592,335065,19527,0.05506892428481184,2021-11-15 20:29:30 UTC
786642,mainnet,247,106704000,107058738,354739,335195,19544,0.055094026876097636,2021-11-15 20:30:58 UTC
786644,mainnet,247,106704000,107058922,354923,335375,19548,0.055076734953778704,2021-11-15 20:32:41 UTC
786645,mainnet,247,106704000,107059074,355075,335522,19553,0.05506723931563754,2021-11-15 20:33:56 UTC
786647,mainnet,247,106704000,107059219,355220,335659,19561,0.05506728224762119,2021-11-15 20:35:08 UTC
786648,mainnet,247,106704000,107059336,355337,335775,19562,0.055051964754585084,2021-11-15 20:36:19 UTC
786649,mainnet,247,106704000,107059522,355523,335953,19570,0.05504566511871243,2021-11-15 20:37:40 UTC
786651,mainnet,247,106704000,107059647,355648,336062,19586,0.05507130646032032,2021-11-15 20:39:22 UTC
786653,mainnet,247,106704000,107059811,355812,336210,19602,0.055090890695086166,2021-11-15 20:40:45 UTC
786654,mainnet,247,106704000,107059944,355945,336330,19615,0.05510682830212533,2021-11-15 20:41:56 UTC
786656,mainnet,247,106704000,107060116,356117,336493,19624,0.05510548499509992,2021-11-15 20:43:36 UTC
786657,mainnet,247,106704000,107060249,356250,336622,19628,0.05509614035087719,2021-11-15 20:44:49 UTC
786658,mainnet,247,106704000,107060406,356407,336771,19636,0.055094316329365026,2021-11-15 20:46:19 UTC
786660,mainnet,247,106704000,107060564,356565,336923,19642,0.055086730329673414,2021-11-15 20:47:43 UTC
786661,mainnet,247,106704000,107060706,356707,337051,19656,0.05510404898137687,2021-11-15 20:48:54 UTC
786663,mainnet,247,106704000,107060840,356841,337175,19666,0.05511138013849305,2021-11-15 20:50:07 UTC
786664,mainnet,247,106704000,107060987,356988,337309,19679,0.055125102244333146,2021-11-15 20:51:34 UTC
786666,mainnet,247,106704000,107061156,357157,337473,19684,0.05511301752450603,2021-11-15 20:52:47 UTC
786667,mainnet,247,106704000,107061315,357316,337618,19698,0.05512767410359458,2021-11-15 20:54:12 UTC
786669,mainnet,247,106704000,107061462,357463,337756,19707,0.05513018130547777,2021-11-15 20:55:25 UTC
786670,mainnet,247,106704000,107061602,357603,337893,19710,0.0551169872735967,2021-11-15 20:56:40 UTC
786671,mainnet,247,106704000,107061734,357735,338017,19718,0.05511901267698156,2021-11-15 20:57:51 UTC
786673,mainnet,247,106704000,107061869,357870,338138,19732,0.055137340374996506,2021-11-15 20:59:05 UTC
786674,mainnet,247,106704000,107062038,358039,338297,19742,0.05513924460743103,2021-11-15 21:00:36 UTC
786676,mainnet,247,106704000,107062163,358164,338413,19751,0.055145129047028736,2021-11-15 21:02:03 UTC
786677,mainnet,247,106704000,107062316,358317,338549,19768,0.05516902630910618,2021-11-15 21:03:18 UTC
786679,mainnet,247,106704000,107062446,358447,338658,19789,0.055207603913549286,2021-11-15 21:04:37 UTC
786680,mainnet,247,106704000,107062551,358552,338750,19802,0.05522769361208416,2021-11-15 21:05:50 UTC
786682,mainnet,247,106704000,107062690,358691,338864,19827,0.05527598964010806,2021-11-15 21:07:01 UTC
786683,mainnet,247,106704000,107062806,358807,338980,19827,0.05525811926746134,2021-11-15 21:08:25 UTC
786684,mainnet,247,106704000,107062966,358967,339127,19840,0.05526970445751281,2021-11-15 21:09:36 UTC
786686,mainnet,247,106704000,107063094,359095,339245,19850,0.05527785126498559,2021-11-15 21:10:48 UTC
786687,mainnet,247,106704000,107063226,359227,339368,19859,0.0552825929008677,2021-11-15 21:12:01 UTC
786688,mainnet,247,106704000,107063379,359380,339509,19871,0.05529244810506984,2021-11-15 21:13:16 UTC
786689,mainnet,247,106704000,107063536,359537,339661,19876,0.05528221017586507,2021-11-15 21:14:31 UTC
786691,mainnet,247,106704000,107063667,359668,339784,19884,0.05528431775971174,2021-11-15 21:15:43 UTC
786692,mainnet,247,106704000,107063818,359819,339930,19889,0.05527501327056103,2021-11-15 21:17:15 UTC
786694,mainnet,247,106704000,107063987,359988,340087,19901,0.05528239830216563,2021-11-15 21:18:37 UTC
786695,mainnet,247,106704000,107064126,360127,340225,19902,0.05526383747955582,2021-11-15 21:19:50 UTC
786697,mainnet,247,106704000,107064258,360259,340356,19903,0.055246364421152556,2021-11-15 21:21:03 UTC
786698,mainnet,247,106704000,107064404,360405,340485,19920,0.055271153285886714,2021-11-15 21:22:15 UTC
786700,mainnet,247,106704000,107064496,360497,340576,19921,0.05525982185704736,2021-11-15 21:23:38 UTC
786701,mainnet,247,106704000,107064719,360720,340782,19938,0.0552727877578177,2021-11-15 21:24:51 UTC
786702,mainnet,247,106704000,107064845,360846,340901,19945,0.055272886494515665,2021-11-15 21:26:06 UTC
786704,mainnet,247,106704000,107064985,360986,341035,19951,0.055268071337946624,2021-11-15 21:27:17 UTC
786705,mainnet,247,106704000,107065123,361124,341166,19958,0.05526633510926995,2021-11-15 21:28:33 UTC
786707,mainnet,247,106704000,107065260,361261,341303,19958,0.05524537661136962,2021-11-15 21:29:48 UTC
786708,mainnet,247,106704000,107065421,361422,341463,19959,0.05522353370851802,2021-11-15 21:31:13 UTC
786710,mainnet,247,106704000,107065563,361564,341599,19965,0.055218439888926996,2021-11-15 21:32:26 UTC
786711,mainnet,247,106704000,107065709,361710,341728,19982,0.05524315059025186,2021-11-15 21:33:40 UTC
786712,mainnet,247,106704000,107065863,361864,341873,19991,0.05524451175027082,2021-11-15 21:34:53 UTC
786714,mainnet,247,106704000,107066004,362005,341991,20014,0.05528652919158575,2021-11-15 21:36:07 UTC
786715,mainnet,247,106704000,107066154,362155,342133,20022,0.05528572020267565,2021-11-15 21:37:21 UTC
786717,mainnet,247,106704000,107066326,362327,342297,20030,0.05528155505938006,2021-11-15 21:38:47 UTC
786718,mainnet,247,106704000,107066476,362477,342441,20036,0.05527523125605211,2021-11-15 21:39:59 UTC
786720,mainnet,247,106704000,107066504,362505,342469,20036,0.05527096177983752,2021-11-15 21:41:14 UTC
786721,mainnet,247,106704000,107066751,362752,342703,20049,0.055269164608327453,2021-11-15 21:42:24 UTC
786722,mainnet,247,106704000,107066877,362878,342826,20052,0.05525824106173425,2021-11-15 21:43:40 UTC
786724,mainnet,247,106704000,107067032,363033,342979,20054,0.055240157230885344,2021-11-15 21:44:58 UTC
786725,mainnet,247,106704000,107067166,363167,343099,20068,0.05525832468258404,2021-11-15 21:46:12 UTC
786727,mainnet,247,106704000,107067318,363319,343250,20069,0.05523795892865498,2021-11-15 21:47:34 UTC
786728,mainnet,247,106704000,107067476,363477,343383,20094,0.05528272765539498,2021-11-15 21:48:50 UTC
786730,mainnet,247,106704000,107067648,363649,343554,20095,0.0552593297382916,2021-11-15 21:50:16 UTC
786731,mainnet,247,106704000,107067780,363781,343679,20102,0.05525852092330276,2021-11-15 21:51:30 UTC
786732,mainnet,247,106704000,107067933,363934,343826,20108,0.05525177642099941,2021-11-15 21:52:48 UTC
786734,mainnet,247,106704000,107068090,364091,343962,20129,0.055285629142165005,2021-11-15 21:54:05 UTC
786735,mainnet,247,106704000,107068212,364213,344082,20131,0.05527260147221543,2021-11-15 21:55:22 UTC
786737,mainnet,247,106704000,107068350,364351,344200,20151,0.0553065587853471,2021-11-15 21:56:34 UTC
786738,mainnet,247,106704000,107068494,364495,344335,20160,0.055309400677649896,2021-11-15 21:57:50 UTC
786740,mainnet,247,106704000,107068653,364654,344490,20164,0.05529625343476282,2021-11-15 21:59:13 UTC
786741,mainnet,247,106704000,107068842,364843,344663,20180,0.05531146273876709,2021-11-15 22:00:45 UTC
786743,mainnet,247,106704000,107068987,364988,344798,20190,0.0553168871305358,2021-11-15 22:02:03 UTC
786744,mainnet,247,106704000,107069126,365127,344931,20196,0.0553122612132217,2021-11-15 22:03:18 UTC
786745,mainnet,247,106704000,107069274,365275,345068,20207,0.055319964410375747,2021-11-15 22:04:35 UTC
786747,mainnet,247,106704000,107069432,365433,345217,20216,0.055320674378066564,2021-11-15 22:06:01 UTC
786748,mainnet,247,106704000,107069602,365603,345377,20226,0.05532230315396756,2021-11-15 22:07:38 UTC
786750,mainnet,247,106704000,107069799,365800,345557,20243,0.05533898305084746,2021-11-15 22:09:06 UTC
786751,mainnet,247,106704000,107069951,365952,345700,20252,0.055340591115774745,2021-11-15 22:10:33 UTC
786753,mainnet,247,106704000,107070113,366114,345852,20262,0.055343417624018745,2021-11-15 22:11:48 UTC
786754,mainnet,247,106704000,107070254,366255,345993,20262,0.05532211164352705,2021-11-15 22:13:09 UTC
786756,mainnet,247,106704000,107070430,366431,346169,20262,0.055295539951587064,2021-11-15 22:14:34 UTC
786757,mainnet,247,106704000,107070569,366570,346300,20270,0.055296396322666884,2021-11-15 22:15:49 UTC
786759,mainnet,247,106704000,107070738,366739,346451,20288,0.05531999596443247,2021-11-15 22:17:12 UTC
786760,mainnet,247,106704000,107070902,366903,346610,20293,0.05530889635680275,2021-11-15 22:18:30 UTC
786762,mainnet,247,106704000,107071039,367040,346740,20300,0.05530732345248474,2021-11-15 22:19:42 UTC
786763,mainnet,247,106704000,107071188,367189,346879,20310,0.055312114469660036,2021-11-15 22:20:57 UTC
786764,mainnet,247,106704000,107071333,367334,347014,20320,0.05531750396097285,2021-11-15 22:22:12 UTC
786766,mainnet,247,106704000,107071457,367458,347128,20330,0.05532605086839856,2021-11-15 22:23:27 UTC
786767,mainnet,247,106704000,107071616,367617,347277,20340,0.0553293237255078,2021-11-15 22:24:55 UTC
786769,mainnet,247,106704000,107071788,367789,347448,20341,0.05530616739489218,2021-11-15 22:26:11 UTC
786770,mainnet,247,106704000,107071940,367941,347594,20347,0.05529962684234701,2021-11-15 22:27:27 UTC
786772,mainnet,247,106704000,107072084,368085,347732,20353,0.055294293437657065,2021-11-15 22:28:43 UTC
786773,mainnet,247,106704000,107072246,368247,347889,20358,0.05528354609813522,2021-11-15 22:30:11 UTC
786775,mainnet,247,106704000,107072418,368419,348056,20363,0.05527130794014424,2021-11-15 22:31:30 UTC
786776,mainnet,247,106704000,107072598,368599,348236,20363,0.05524431699489147,2021-11-15 22:32:55 UTC
786777,mainnet,247,106704000,107072752,368753,348389,20364,0.055223957500006776,2021-11-15 22:34:15 UTC
786779,mainnet,247,106704000,107072932,368933,348552,20381,0.05524309291931055,2021-11-15 22:35:41 UTC
786780,mainnet,247,106704000,107073089,369090,348697,20393,0.0552521065322821,2021-11-15 22:36:58 UTC
786782,mainnet,247,106704000,107073238,369239,348836,20403,0.05525689323175504,2021-11-15 22:38:15 UTC
786783,mainnet,247,106704000,107073426,369427,349015,20412,0.055253135260822844,2021-11-15 22:39:49 UTC
786785,mainnet,247,106704000,107073575,369576,349164,20412,0.055230859146697835,2021-11-15 22:41:13 UTC
786786,mainnet,247,106704000,107073739,369740,349319,20421,0.05523070265592037,2021-11-15 22:42:29 UTC
786788,mainnet,247,106704000,107073888,369889,349464,20425,0.05521926848324768,2021-11-15 22:43:47 UTC
786789,mainnet,247,106704000,107074011,370012,349572,20440,0.05524145162859583,2021-11-15 22:45:03 UTC
786791,mainnet,247,106704000,107074171,370172,349719,20453,0.055252693342554275,2021-11-15 22:46:18 UTC
786792,mainnet,247,106704000,107074324,370325,349868,20457,0.05524066698170526,2021-11-15 22:47:45 UTC
786793,mainnet,247,106704000,107074482,370483,350024,20459,0.05522250683567127,2021-11-15 22:49:00 UTC
786795,mainnet,247,106704000,107074632,370633,350167,20466,0.05521904417577496,2021-11-15 22:50:25 UTC
786796,mainnet,247,106704000,107074803,370804,350328,20476,0.05522054778265607,2021-11-15 22:51:44 UTC
786798,mainnet,247,106704000,107074951,370952,350474,20478,0.05520390778321724,2021-11-15 22:52:58 UTC
786799,mainnet,247,106704000,107075081,371082,350596,20486,0.055206126947682725,2021-11-15 22:54:23 UTC
786801,mainnet,247,106704000,107075283,371284,350783,20501,0.0552164919576389,2021-11-15 22:55:50 UTC
786802,mainnet,247,106704000,107075423,371424,350913,20511,0.055222602739726026,2021-11-15 22:57:06 UTC
786804,mainnet,247,106704000,107075556,371557,351027,20530,0.05525397179975078,2021-11-15 22:58:21 UTC
786805,mainnet,247,106704000,107075706,371707,351172,20535,0.055245125865264845,2021-11-15 22:59:40 UTC
786807,mainnet,247,106704000,107075876,371877,351329,20548,0.05525482888159257,2021-11-15 23:01:05 UTC
786808,mainnet,247,106704000,107076034,372035,351475,20560,0.055263617670380474,2021-11-15 23:02:31 UTC
786809,mainnet,247,106704000,107076165,372166,351596,20570,0.055271034968266845,2021-11-15 23:03:47 UTC
786811,mainnet,247,106704000,107076300,372301,351712,20589,0.05530202712321482,2021-11-15 23:05:03 UTC
786812,mainnet,247,106704000,107076436,372437,351829,20608,0.05533284824010504,2021-11-15 23:06:28 UTC
786814,mainnet,247,106704000,107076576,372577,351968,20609,0.05531474030871471,2021-11-15 23:07:45 UTC
786815,mainnet,247,106704000,107076723,372724,352107,20617,0.05531438812633477,2021-11-15 23:09:01 UTC
786817,mainnet,247,106704000,107076875,372876,352242,20634,0.05533743121037557,2021-11-15 23:10:18 UTC
786818,mainnet,247,106704000,107077027,373028,352388,20640,0.05533096711238834,2021-11-15 23:11:38 UTC
786820,mainnet,247,106704000,107077191,373192,352543,20649,0.0553307680764861,2021-11-15 23:12:55 UTC
786821,mainnet,247,106704000,107077346,373347,352690,20657,0.055329224555172536,2021-11-15 23:14:22 UTC
786823,mainnet,247,106704000,107077511,373512,352851,20661,0.05531549187174709,2021-11-15 23:15:39 UTC
786824,mainnet,247,106704000,107077669,373670,353004,20666,0.05530548344796211,2021-11-15 23:16:58 UTC
786825,mainnet,247,106704000,107077825,373826,353155,20671,0.05529577931979049,2021-11-15 23:18:18 UTC
786827,mainnet,247,106704000,107077974,373975,353296,20679,0.05529514004946855,2021-11-15 23:19:35 UTC
786828,mainnet,247,106704000,107078127,374128,353428,20700,0.05532865757174015,2021-11-15 23:20:54 UTC
786830,mainnet,247,106704000,107078278,374279,353560,20719,0.05535709991744127,2021-11-15 23:22:19 UTC
786831,mainnet,247,106704000,107078422,374423,353688,20735,0.055378542450650735,2021-11-15 23:23:45 UTC
786833,mainnet,247,106704000,107078615,374616,353863,20753,0.05539806094774382,2021-11-15 23:25:06 UTC
786834,mainnet,247,106704000,107078764,374765,354003,20762,0.05540005069843769,2021-11-15 23:26:29 UTC
786836,mainnet,247,106704000,107078942,374943,354159,20784,0.055432425728710766,2021-11-15 23:27:51 UTC
786837,mainnet,247,106704000,107079097,375098,354305,20793,0.05543351337517129,2021-11-15 23:29:13 UTC
786839,mainnet,247,106704000,107079261,375262,354456,20806,0.055443929841017744,2021-11-15 23:30:31 UTC
786840,mainnet,247,106704000,107079408,375409,354594,20815,0.05544619335178432,2021-11-15 23:32:03 UTC
786842,mainnet,247,106704000,107079611,375612,354787,20825,0.055442850601152255,2021-11-15 23:34:09 UTC
786843,mainnet,247,106704000,107079845,375846,355006,20840,0.055448242099157635,2021-11-15 23:35:41 UTC
786845,mainnet,247,106704000,107079996,375997,355152,20845,0.05543927212185203,2021-11-15 23:37:30 UTC
786846,mainnet,247,106704000,107080268,376269,355418,20851,0.05541514182672503,2021-11-15 23:39:16 UTC
786848,mainnet,247,106704000,107080436,376437,355583,20854,0.05539838007422225,2021-11-15 23:40:44 UTC
786849,mainnet,247,106704000,107080590,376591,355732,20859,0.05538900292359616,2021-11-15 23:42:04 UTC
786851,mainnet,247,106704000,107080802,376803,355936,20867,0.0553790707611139,2021-11-15 23:43:51 UTC
786853,mainnet,247,106704000,107080946,376947,356076,20871,0.0553685266098417,2021-11-15 23:45:21 UTC
786854,mainnet,247,106704000,107081153,377154,356269,20885,0.055375257852230124,2021-11-15 23:46:53 UTC
786855,mainnet,247,106704000,107081294,377295,356406,20889,0.05536516518904306,2021-11-15 23:48:10 UTC
786857,mainnet,247,106704000,107081479,377480,356579,20901,0.055369820917664514,2021-11-15 23:49:40 UTC
786858,mainnet,247,106704000,107081670,377671,356754,20917,0.0553841835883613,2021-11-15 23:51:08 UTC
786860,mainnet,247,106704000,107081826,377827,356908,20919,0.05536660958586866,2021-11-15 23:52:27 UTC
786861,mainnet,247,106704000,107082019,378020,357100,20920,0.05534098724935189,2021-11-15 23:54:05 UTC
786863,mainnet,247,106704000,107082250,378251,357330,20921,0.055309833946242046,2021-11-15 23:55:53 UTC
786865,mainnet,247,106704000,107082397,378398,357469,20929,0.055309488950787265,2021-11-15 23:57:13 UTC
786866,mainnet,247,106704000,107082542,378543,357610,20933,0.05529886961322756,2021-11-15 23:58:34 UTC
786867,mainnet,247,106704000,107082719,378720,357768,20952,0.05532319391634981,2021-11-15 23:59:51 UTC
786869,mainnet,247,106704000,107082876,378877,357911,20966,0.05533722025881751,2021-11-16 00:01:28 UTC
786870,mainnet,247,106704000,107083030,379031,358051,20980,0.05535167308214895,2021-11-16 00:02:46 UTC
786872,mainnet,247,106704000,107083171,379172,358182,20990,0.05535746310381568,2021-11-16 00:04:07 UTC
786873,mainnet,247,106704000,107083310,379311,358308,21003,0.05537144981295032,2021-11-16 00:05:28 UTC
786874,mainnet,247,106704000,107083432,379433,358422,21011,0.055374730189519626,2021-11-16 00:06:37 UTC
786876,mainnet,247,106704000,107083588,379589,358566,21023,0.05538358593109916,2021-11-16 00:07:59 UTC
786877,mainnet,247,106704000,107083716,379717,358689,21028,0.05537808420481569,2021-11-16 00:09:19 UTC
786879,mainnet,247,106704000,107083846,379847,358802,21045,0.05540388630158985,2021-11-16 00:10:41 UTC
786880,mainnet,247,106704000,107084019,380020,358961,21059,0.05541550444713436,2021-11-16 00:12:13 UTC
786882,mainnet,247,106704000,107084145,380146,359070,21076,0.0554418565498519,2021-11-16 00:13:33 UTC
786883,mainnet,247,106704000,107084311,380312,359219,21093,0.05546235722249101,2021-11-16 00:15:06 UTC
786885,mainnet,247,106704000,107084451,380452,359344,21108,0.05548137478578112,2021-11-16 00:16:25 UTC
786886,mainnet,247,106704000,107084589,380590,359464,21126,0.05550855251057569,2021-11-16 00:17:41 UTC
786888,mainnet,247,106704000,107084724,380725,359591,21134,0.055509882461093965,2021-11-16 00:19:01 UTC
786889,mainnet,247,106704000,107084863,380864,359721,21143,0.05551325407494539,2021-11-16 00:20:21 UTC
786891,mainnet,247,106704000,107085022,381023,359863,21160,0.055534705254013536,2021-11-16 00:21:41 UTC
786892,mainnet,247,106704000,107085176,381177,359996,21181,0.05556736109471453,2021-11-16 00:23:02 UTC
786893,mainnet,247,106704000,107085324,381325,360143,21182,0.05554841670491051,2021-11-16 00:24:21 UTC
786895,mainnet,247,106704000,107085466,381467,360278,21189,0.05554608917678331,2021-11-16 00:25:40 UTC
786896,mainnet,247,106704000,107085617,381618,360427,21191,0.05552935134086966,2021-11-16 00:26:58 UTC
786898,mainnet,247,106704000,107085764,381765,360568,21197,0.05552368603722185,2021-11-16 00:28:16 UTC
786899,mainnet,247,106704000,107085899,381900,360689,21211,0.055540717465305055,2021-11-16 00:29:37 UTC
786900,mainnet,247,106704000,107086049,382050,360823,21227,0.05556079047245125,2021-11-16 00:31:07 UTC
786901,mainnet,247,106704000,107086205,382206,360969,21237,0.055564276855936325,2021-11-16 00:32:26 UTC
786903,mainnet,247,106704000,107086344,382345,361103,21242,0.0555571538793498,2021-11-16 00:33:44 UTC
786904,mainnet,247,106704000,107086498,382499,361247,21252,0.0555609295710577,2021-11-16 00:35:04 UTC
786906,mainnet,247,106704000,107086642,382643,361391,21252,0.05554002033226794,2021-11-16 00:36:24 UTC
786907,mainnet,247,106704000,107086827,382828,361562,21266,0.055549750801926714,2021-11-16 00:38:04 UTC
786909,mainnet,247,106704000,107086982,382983,361710,21273,0.05554554640806511,2021-11-16 00:39:33 UTC
786910,mainnet,247,106704000,107087152,383153,361860,21293,0.0555731000409758,2021-11-16 00:40:51 UTC
786912,mainnet,247,106704000,107087254,383255,361958,21297,0.055568746656925544,2021-11-16 00:42:11 UTC
786913,mainnet,247,106704000,107087450,383451,362120,21331,0.05562901126871491,2021-11-16 00:43:32 UTC
786915,mainnet,247,106704000,107087604,383605,362272,21333,0.05561189244144367,2021-11-16 00:45:03 UTC
786916,mainnet,247,106704000,107087788,383789,362452,21337,0.055595652819648296,2021-11-16 00:46:35 UTC
786918,mainnet,247,106704000,107087960,383961,362611,21350,0.05560460567609731,2021-11-16 00:48:03 UTC
786919,mainnet,247,106704000,107088112,384113,362760,21353,0.05559041219641095,2021-11-16 00:49:23 UTC
786921,mainnet,247,106704000,107088272,384273,362910,21363,0.05559328914599777,2021-11-16 00:50:46 UTC
786922,mainnet,247,106704000,107088424,384425,363058,21367,0.055581712947909215,2021-11-16 00:52:04 UTC
786924,mainnet,247,106704000,107088577,384578,363188,21390,0.05561940620628325,2021-11-16 00:53:23 UTC
786925,mainnet,247,106704000,107088737,384738,363338,21400,0.0556222676210824,2021-11-16 00:54:46 UTC
786926,mainnet,247,106704000,107088902,384903,363490,21413,0.05563219824215452,2021-11-16 00:56:15 UTC
786928,mainnet,247,106704000,107089027,385028,363603,21425,0.05564530371817115,2021-11-16 00:57:37 UTC
786929,mainnet,247,106704000,107089188,385189,363752,21437,0.05565319881928092,2021-11-16 00:58:55 UTC
786931,mainnet,247,106704000,107089334,385335,363881,21454,0.05567622977409267,2021-11-16 01:00:22 UTC
786932,mainnet,247,106704000,107089507,385508,364037,21471,0.05569534224970688,2021-11-16 01:02:15 UTC
786934,mainnet,247,106704000,107089688,385689,364200,21489,0.05571587470734193,2021-11-16 01:03:49 UTC
786936,mainnet,247,106704000,107089922,385923,364408,21515,0.05574946297577496,2021-11-16 01:05:59 UTC
786937,mainnet,247,106704000,107090048,386049,364518,21531,0.05577271279034527,2021-11-16 01:07:27 UTC
786939,mainnet,247,106704000,107090181,386182,364636,21546,0.05579234661377278,2021-11-16 01:09:10 UTC
786940,mainnet,247,106704000,107090351,386352,364776,21576,0.05584544663933408,2021-11-16 01:10:44 UTC
786942,mainnet,247,106704000,107090470,386471,364892,21579,0.05583601356893531,2021-11-16 01:12:07 UTC
786943,mainnet,247,106704000,107090633,386634,365037,21597,0.055859029469731064,2021-11-16 01:13:40 UTC
786944,mainnet,247,106704000,107090782,386783,365167,21616,0.05588663410749697,2021-11-16 01:15:05 UTC
786946,mainnet,247,106704000,107091005,387006,365371,21635,0.055903526043523874,2021-11-16 01:17:12 UTC
786948,mainnet,247,106704000,107091199,387200,365551,21649,0.05591167355371901,2021-11-16 01:18:54 UTC
786949,mainnet,247,106704000,107091328,387329,365670,21659,0.05591887000456976,2021-11-16 01:20:21 UTC
786951,mainnet,247,106704000,107091528,387529,365849,21680,0.055944200305009434,2021-11-16 01:22:00 UTC
786952,mainnet,247,106704000,107091671,387672,365987,21685,0.05593646175117109,2021-11-16 01:23:36 UTC
786953,mainnet,247,106704000,107091857,387858,366155,21703,0.05595604576932795,2021-11-16 01:24:59 UTC
786955,mainnet,247,106704000,107092009,388010,366297,21713,0.055959897940774724,2021-11-16 01:26:42 UTC
786957,mainnet,247,106704000,107092152,388153,366423,21730,0.05598307883746873,2021-11-16 01:28:02 UTC
786958,mainnet,247,106704000,107092324,388325,366587,21738,0.05597888366703148,2021-11-16 01:29:25 UTC
786959,mainnet,247,106704000,107092484,388485,366730,21755,0.05599958814368637,2021-11-16 01:30:51 UTC
786961,mainnet,247,106704000,107092613,388614,366848,21766,0.056009304862923104,2021-11-16 01:32:11 UTC
786962,mainnet,247,106704000,107092756,388757,366979,21778,0.056019570065619397,2021-11-16 01:33:30 UTC
786964,mainnet,247,106704000,107092905,388906,367127,21779,0.056000678827274455,2021-11-16 01:34:52 UTC
786965,mainnet,247,106704000,107093050,389051,367263,21788,0.05600294048852207,2021-11-16 01:36:11 UTC
786966,mainnet,247,106704000,107093231,389232,367439,21793,0.055989743905948124,2021-11-16 01:37:43 UTC
786967,mainnet,247,106704000,107093378,389379,367581,21798,0.05598144738159993,2021-11-16 01:39:03 UTC
786969,mainnet,247,106704000,107093520,389521,367715,21806,0.05598157737323533,2021-11-16 01:40:25 UTC
786970,mainnet,247,106704000,107093664,389665,367837,21828,0.05601734823502239,2021-11-16 01:41:46 UTC
786972,mainnet,247,106704000,107093827,389828,367985,21843,0.05603240403459987,2021-11-16 01:43:16 UTC
786973,mainnet,247,106704000,107093977,389978,368124,21854,0.056039058613562814,2021-11-16 01:44:46 UTC
786975,mainnet,247,106704000,107094143,390144,368265,21879,0.0560792937992126,2021-11-16 01:46:16 UTC
786976,mainnet,247,106704000,107094283,390284,368384,21900,0.05611298439085384,2021-11-16 01:47:38 UTC
786978,mainnet,247,106704000,107094439,390440,368533,21907,0.05610849298227641,2021-11-16 01:49:00 UTC
786979,mainnet,247,106704000,107094585,390586,368675,21911,0.056097760800438316,2021-11-16 01:50:29 UTC
786981,mainnet,247,106704000,107094752,390753,368826,21927,0.056114732324511904,2021-11-16 01:51:53 UTC
786982,mainnet,247,106704000,107094886,390887,368951,21936,0.056118520186140754,2021-11-16 01:53:12 UTC
786984,mainnet,247,106704000,107095050,391051,369107,21944,0.05611544274276245,2021-11-16 01:54:32 UTC
786985,mainnet,247,106704000,107095192,391193,369249,21944,0.05609507327585105,2021-11-16 01:55:53 UTC
786987,mainnet,247,106704000,107095357,391358,369405,21953,0.05609441994286561,2021-11-16 01:57:13 UTC
786988,mainnet,247,106704000,107095520,391521,369563,21958,0.056083837137726966,2021-11-16 01:58:34 UTC
786990,mainnet,247,106704000,107095699,391700,369736,21964,0.05607352565739086,2021-11-16 02:00:11 UTC
786991,mainnet,247,106704000,107095838,391839,369866,21973,0.05607660289047287,2021-11-16 02:01:32 UTC
786993,mainnet,247,106704000,107095988,391989,370001,21988,0.0560934107844863,2021-11-16 02:02:52 UTC
786994,mainnet,247,106704000,107096132,392133,370136,21997,0.05609576342720454,2021-11-16 02:04:26 UTC
786996,mainnet,247,106704000,107096316,392317,370303,22014,0.05611278634369655,2021-11-16 02:05:52 UTC
786997,mainnet,247,106704000,107096477,392478,370448,22030,0.05613053470512997,2021-11-16 02:07:15 UTC
786998,mainnet,247,106704000,107096627,392628,370590,22038,0.05612946605947614,2021-11-16 02:08:37 UTC
787000,mainnet,247,106704000,107096808,392809,370760,22049,0.056131605945892275,2021-11-16 02:10:09 UTC
787001,mainnet,247,106704000,107096937,392938,370884,22054,0.05612590281418443,2021-11-16 02:11:30 UTC
787003,mainnet,247,106704000,107097118,393119,371053,22066,0.0561305864127656,2021-11-16 02:12:51 UTC
787004,mainnet,247,106704000,107097303,393304,371233,22071,0.05611689685332465,2021-11-16 02:14:23 UTC
787006,mainnet,247,106704000,107097457,393458,371369,22089,0.05614068083505736,2021-11-16 02:15:46 UTC
787007,mainnet,247,106704000,107097584,393585,371491,22094,0.05613526938272546,2021-11-16 02:17:09 UTC
787009,mainnet,247,106704000,107097767,393768,371657,22111,0.056152353670181426,2021-11-16 02:18:30 UTC
787010,mainnet,247,106704000,107097908,393909,371792,22117,0.05614748584063832,2021-11-16 02:19:53 UTC
787012,mainnet,247,106704000,107098073,394074,371952,22122,0.056136664687342984,2021-11-16 02:21:17 UTC
787013,mainnet,247,106704000,107098233,394234,372107,22127,0.05612656442620373,2021-11-16 02:22:52 UTC
787015,mainnet,247,106704000,107098417,394418,372259,22159,0.05618151301411193,2021-11-16 02:24:16 UTC
787016,mainnet,247,106704000,107098582,394583,372417,22166,0.05617576023295479,2021-11-16 02:25:39 UTC
787018,mainnet,247,106704000,107098743,394744,372573,22171,0.05616551486533044,2021-11-16 02:27:12 UTC
787019,mainnet,247,106704000,107098929,394930,372740,22190,0.05618717241030056,2021-11-16 02:28:37 UTC
787021,mainnet,247,106704000,107099088,395089,372890,22199,0.05618734006768095,2021-11-16 02:29:57 UTC
787022,mainnet,247,106704000,107099250,395251,373037,22214,0.056202261347852375,2021-11-16 02:31:22 UTC
787024,mainnet,247,106704000,107099412,395413,373194,22219,0.056191880388353446,2021-11-16 02:32:45 UTC
787025,mainnet,247,106704000,107099577,395578,373350,22228,0.056191193645753805,2021-11-16 02:34:16 UTC
787027,mainnet,247,106704000,107099770,395771,373533,22238,0.05618905882442119,2021-11-16 02:35:57 UTC
787028,mainnet,247,106704000,107099951,395952,373702,22250,0.056193680042025296,2021-11-16 02:37:31 UTC
787030,mainnet,247,106704000,107100127,396128,373869,22259,0.0561914330721383,2021-11-16 02:39:03 UTC
787031,mainnet,247,106704000,107100296,396297,374030,22267,0.056187657236870324,2021-11-16 02:41:00 UTC
787033,mainnet,247,106704000,107100541,396542,374266,22276,0.0561756383939154,2021-11-16 02:42:36 UTC
787034,mainnet,247,106704000,107100702,396703,374426,22277,0.05615536055941094,2021-11-16 02:43:59 UTC
787036,mainnet,247,106704000,107100942,396943,374647,22296,0.05616927367405396,2021-11-16 02:46:03 UTC
787038,mainnet,247,106704000,107101109,397110,374805,22305,0.05616831608370477,2021-11-16 02:47:33 UTC
787039,mainnet,247,106704000,107101269,397270,374963,22307,0.05615072872353815,2021-11-16 02:48:58 UTC
787041,mainnet,247,106704000,107101382,397383,375071,22312,0.05614734399810762,2021-11-16 02:50:31 UTC
787042,mainnet,247,106704000,107101552,397553,375218,22335,0.05618118842016033,2021-11-16 02:52:23 UTC
787044,mainnet,247,106704000,107101773,397774,375416,22358,0.05620779638689306,2021-11-16 02:53:50 UTC
787045,mainnet,247,106704000,107101945,397946,375568,22378,0.05623376035944575,2021-11-16 02:55:17 UTC
787047,mainnet,247,106704000,107102116,398117,375722,22395,0.056252307738679834,2021-11-16 02:56:50 UTC
787048,mainnet,247,106704000,107102289,398290,375886,22404,0.056250470762509726,2021-11-16 02:58:26 UTC
787050,mainnet,247,106704000,107102420,398421,376001,22420,0.056272134249951686,2021-11-16 02:59:48 UTC
787051,mainnet,247,106704000,107102626,398627,376173,22454,0.056328347051253426,2021-11-16 03:01:19 UTC
787052,mainnet,247,106704000,107102771,398772,376316,22456,0.05631288054326783,2021-11-16 03:02:41 UTC
787054,mainnet,247,106704000,107102923,398924,376466,22458,0.05629643741665079,2021-11-16 03:04:06 UTC
787055,mainnet,247,106704000,107103072,399073,376595,22478,0.05632553442603233,2021-11-16 03:05:29 UTC
787057,mainnet,247,106704000,107103249,399250,376760,22490,0.05633061991233563,2021-11-16 03:07:11 UTC
787058,mainnet,247,106704000,107103403,399404,376899,22505,0.05634645621976745,2021-11-16 03:08:31 UTC
787060,mainnet,247,106704000,107103547,399548,377034,22514,0.056348674001621836,2021-11-16 03:09:57 UTC
787061,mainnet,247,106704000,107103723,399724,377193,22531,0.05636639281103962,2021-11-16 03:11:34 UTC
787062,mainnet,247,106704000,107103917,399918,377379,22539,0.05635905360598923,2021-11-16 03:13:13 UTC
787064,mainnet,247,106704000,107104113,400114,377566,22548,0.05635393912734871,2021-11-16 03:14:40 UTC
787065,mainnet,247,106704000,107104280,400281,377731,22550,0.05633542436438402,2021-11-16 03:16:16 UTC
787067,mainnet,247,106704000,107104476,400477,377918,22559,0.056330326086142274,2021-11-16 03:17:46 UTC
787068,mainnet,247,106704000,107104646,400647,378075,22572,0.0563388718747426,2021-11-16 03:19:13 UTC
787070,mainnet,247,106704000,107104814,400815,378225,22590,0.056360166161446054,2021-11-16 03:20:42 UTC
787071,mainnet,247,106704000,107104983,400984,378382,22602,0.05636633880653592,2021-11-16 03:22:09 UTC
787073,mainnet,247,106704000,107105118,401119,378499,22620,0.05639224270104383,2021-11-16 03:23:33 UTC
787074,mainnet,247,106704000,107105263,401264,378630,22634,0.056406754655289285,2021-11-16 03:24:55 UTC
787076,mainnet,247,106704000,107105407,401408,378771,22637,0.056393993144132654,2021-11-16 03:26:19 UTC
787077,mainnet,247,106704000,107105573,401574,378916,22658,0.056422975591049224,2021-11-16 03:27:45 UTC
787079,mainnet,247,106704000,107105721,401722,379051,22671,0.0564345492654124,2021-11-16 03:29:09 UTC
787080,mainnet,247,106704000,107105865,401866,379172,22694,0.05647156017179856,2021-11-16 03:30:34 UTC
787081,mainnet,247,106704000,107105999,402000,379297,22703,0.056475124378109455,2021-11-16 03:31:56 UTC
787083,mainnet,247,106704000,107106167,402168,379446,22722,0.056498776630661815,2021-11-16 03:33:23 UTC
787084,mainnet,247,106704000,107106301,402302,379567,22735,0.05651227187535732,2021-11-16 03:34:46 UTC
787085,mainnet,247,106704000,107106513,402514,379755,22759,0.0565421326960056,2021-11-16 03:36:36 UTC
787087,mainnet,247,106704000,107106692,402693,379918,22775,0.05655673180313539,2021-11-16 03:38:03 UTC
787088,mainnet,247,106704000,107106845,402846,380050,22796,0.05658738078570968,2021-11-16 03:39:40 UTC
787090,mainnet,247,106704000,107106991,402992,380171,22821,0.05662891571048557,2021-11-16 03:41:08 UTC
787091,mainnet,247,106704000,107107147,403148,380314,22834,0.05663924910950817,2021-11-16 03:42:34 UTC
787093,mainnet,247,106704000,107107320,403321,380469,22852,0.05665958380545521,2021-11-16 03:44:00 UTC
787094,mainnet,247,106704000,107107480,403481,380604,22877,0.05669907628859847,2021-11-16 03:45:24 UTC
787096,mainnet,247,106704000,107107586,403587,380709,22878,0.05668666235532859,2021-11-16 03:46:48 UTC
787097,mainnet,247,106704000,107107780,403781,380880,22901,0.05671638833922349,2021-11-16 03:48:22 UTC
787099,mainnet,247,106704000,107107927,403928,381021,22907,0.05671060188944564,2021-11-16 03:49:46 UTC
787100,mainnet,247,106704000,107108064,404065,381149,22916,0.05671364755670499,2021-11-16 03:51:12 UTC
787102,mainnet,247,106704000,107108175,404176,381231,22945,0.056769823047385294,2021-11-16 03:52:37 UTC
787103,mainnet,247,106704000,107108374,404375,381399,22976,0.05681854714064915,2021-11-16 03:54:04 UTC
787105,mainnet,247,106704000,107108524,404525,381533,22992,0.05683703108584142,2021-11-16 03:55:28 UTC
787106,mainnet,247,106704000,107108700,404701,381704,22997,0.05682466808829235,2021-11-16 03:57:04 UTC
787108,mainnet,247,106704000,107108860,404861,381854,23007,0.05682691096450387,2021-11-16 03:58:31 UTC
787109,mainnet,247,106704000,107109012,405013,381995,23018,0.056832743640327595,2021-11-16 03:59:52 UTC
787111,mainnet,247,106704000,107109188,405189,382167,23022,0.05681792941071944,2021-11-16 04:01:30 UTC
787112,mainnet,247,106704000,107109324,405325,382281,23044,0.05685314253993709,2021-11-16 04:02:53 UTC
787113,mainnet,247,106704000,107109472,405473,382408,23065,0.05688418217735829,2021-11-16 04:04:18 UTC
787115,mainnet,247,106704000,107109632,405633,382550,23083,0.05690611957113943,2021-11-16 04:05:41 UTC
787116,mainnet,247,106704000,107109770,405771,382678,23093,0.0569114106232333,2021-11-16 04:07:06 UTC
787118,mainnet,247,106704000,107109937,405938,382825,23113,0.05693726628204307,2021-11-16 04:08:31 UTC
787120,mainnet,247,106704000,107110168,406169,383047,23122,0.05692704268420288,2021-11-16 04:10:35 UTC
787121,mainnet,247,106704000,107110304,406305,383173,23132,0.05693259989416818,2021-11-16 04:11:59 UTC
787123,mainnet,247,106704000,107110397,406398,383255,23143,0.05694663851692183,2021-11-16 04:13:23 UTC
787124,mainnet,247,106704000,107110615,406616,383446,23170,0.056982509296240186,2021-11-16 04:14:48 UTC
787125,mainnet,247,106704000,107110761,406762,383569,23193,0.057018600557574205,2021-11-16 04:16:10 UTC
787127,mainnet,247,106704000,107110914,406915,383707,23208,0.05703402430483025,2021-11-16 04:17:34 UTC
787128,mainnet,247,106704000,107111083,407084,383856,23228,0.05705947666820607,2021-11-16 04:19:07 UTC
787130,mainnet,247,106704000,107111250,407251,384002,23249,0.05708764373813692,2021-11-16 04:20:34 UTC
787131,mainnet,247,106704000,107111416,407417,384153,23264,0.05710120098081327,2021-11-16 04:21:58 UTC
787133,mainnet,247,106704000,107111597,407598,384317,23281,0.057117552097900384,2021-11-16 04:23:42 UTC
787135,mainnet,247,106704000,107111771,407772,384473,23299,0.057137321836712676,2021-11-16 04:25:17 UTC
787136,mainnet,247,106704000,107111955,407956,384629,23327,0.05718018609850082,2021-11-16 04:27:13 UTC
787138,mainnet,247,106704000,107112082,408083,384749,23334,0.05717954435739788,2021-11-16 04:28:37 UTC
787139,mainnet,247,106704000,107112300,408301,384932,23369,0.05723473613829013,2021-11-16 04:30:31 UTC
787141,mainnet,247,106704000,107112424,408425,385051,23374,0.057229601518026564,2021-11-16 04:31:55 UTC
787142,mainnet,247,106704000,107112615,408616,385222,23394,0.05725179630753568,2021-11-16 04:33:29 UTC
787144,mainnet,247,106704000,107112750,408751,385345,23406,0.057262245229981086,2021-11-16 04:34:54 UTC
787145,mainnet,247,106704000,107112928,408929,385506,23423,0.05727889193478575,2021-11-16 04:36:23 UTC
787147,mainnet,247,106704000,107113096,409097,385667,23430,0.057272480609733147,2021-11-16 04:37:57 UTC
787148,mainnet,247,106704000,107113270,409271,385835,23436,0.05726279164661068,2021-11-16 04:39:25 UTC
787150,mainnet,247,106704000,107113312,409313,385877,23436,0.057256915856569425,2021-11-16 04:40:50 UTC
787151,mainnet,247,106704000,107113594,409595,386137,23458,0.057271206923912646,2021-11-16 04:42:14 UTC
787153,mainnet,247,106704000,107113765,409766,386280,23486,0.057315638681589,2021-11-16 04:43:49 UTC
787154,mainnet,247,106704000,107113972,409973,386479,23494,0.057306212848163174,2021-11-16 04:45:28 UTC
787156,mainnet,247,106704000,107114165,410166,386661,23505,0.05730606632436623,2021-11-16 04:47:07 UTC
787157,mainnet,247,106704000,107114318,410319,386812,23507,0.05728957225963214,2021-11-16 04:48:33 UTC
787159,mainnet,247,106704000,107114500,410501,386977,23524,0.05730558512646741,2021-11-16 04:49:59 UTC
787160,mainnet,247,106704000,107114664,410665,387136,23529,0.057294875385046205,2021-11-16 04:51:34 UTC
787162,mainnet,247,106704000,107114838,410839,387300,23539,0.05729495008993791,2021-11-16 04:52:58 UTC
787163,mainnet,247,106704000,107115027,411028,387484,23544,0.057280769193339624,2021-11-16 04:54:32 UTC
787165,mainnet,247,106704000,107115192,411193,387638,23555,0.05728453548576946,2021-11-16 04:55:59 UTC
787166,mainnet,247,106704000,107115377,411378,387816,23562,0.05727579014920584,2021-11-16 04:57:26 UTC
787168,mainnet,247,106704000,107115541,411542,387974,23568,0.0572675449893328,2021-11-16 04:58:49 UTC
787169,mainnet,247,106704000,107115714,411715,388134,23581,0.05727505677471066,2021-11-16 05:00:27 UTC
787171,mainnet,247,106704000,107115887,411888,388307,23581,0.05725100027191858,2021-11-16 05:01:54 UTC
787172,mainnet,247,106704000,107116050,412051,388461,23590,0.057250194757445076,2021-11-16 05:03:21 UTC
787174,mainnet,247,106704000,107116229,412230,388627,23603,0.05725687116415593,2021-11-16 05:04:49 UTC
787175,mainnet,247,106704000,107116387,412388,388773,23615,0.05726403290105435,2021-11-16 05:06:13 UTC
787177,mainnet,247,106704000,107116560,412561,388935,23626,0.05726668298748549,2021-11-16 05:07:39 UTC
787178,mainnet,247,106704000,107116716,412717,389083,23634,0.05726442089858184,2021-11-16 05:09:04 UTC
787180,mainnet,247,106704000,107116897,412898,389238,23660,0.057302287732079106,2021-11-16 05:10:40 UTC
787181,mainnet,247,106704000,107117079,413080,389415,23665,0.05728914495981408,2021-11-16 05:12:10 UTC
787183,mainnet,247,106704000,107117250,413251,389574,23677,0.05729447720634675,2021-11-16 05:13:36 UTC
787184,mainnet,247,106704000,107117442,413443,389765,23678,0.05727028877015695,2021-11-16 05:15:11 UTC
787186,mainnet,247,106704000,107117602,413603,389917,23686,0.057267476299736705,2021-11-16 05:16:38 UTC
787187,mainnet,247,106704000,107117782,413783,390081,23702,0.057281231950080114,2021-11-16 05:18:02 UTC
787189,mainnet,247,106704000,107117920,413921,390214,23707,0.05727421416163954,2021-11-16 05:19:30 UTC
787190,mainnet,247,106704000,107118122,414123,390389,23734,0.057311475093148656,2021-11-16 05:20:59 UTC
787192,mainnet,247,106704000,107118306,414307,390559,23748,0.05731981356819943,2021-11-16 05:22:26 UTC
787193,mainnet,247,106704000,107118457,414458,390709,23749,0.057301342958755774,2021-11-16 05:23:50 UTC
787195,mainnet,247,106704000,107118630,414631,390855,23776,0.05734255277584165,2021-11-16 05:25:17 UTC
787196,mainnet,247,106704000,107118820,414821,391035,23786,0.05734039501375292,2021-11-16 05:26:44 UTC
787198,mainnet,247,106704000,107118993,414994,391204,23790,0.05732613001633759,2021-11-16 05:28:14 UTC
787199,mainnet,247,106704000,107119163,415164,391372,23792,0.057307473673054506,2021-11-16 05:29:38 UTC
787201,mainnet,247,106704000,107119332,415333,391533,23800,0.05730341677641796,2021-11-16 05:31:05 UTC
787202,mainnet,247,106704000,107119501,415502,391698,23804,0.05728973627082421,2021-11-16 05:32:28 UTC
787204,mainnet,247,106704000,107119672,415673,391861,23812,0.05728541425591751,2021-11-16 05:33:54 UTC
787205,mainnet,247,106704000,107119829,415830,392007,23823,0.05729023879950942,2021-11-16 05:35:25 UTC
787207,mainnet,247,106704000,107120016,416017,392180,23837,0.057298139258732214,2021-11-16 05:36:50 UTC
787208,mainnet,247,106704000,107120204,416205,392346,23859,0.05732511622878149,2021-11-16 05:38:36 UTC
787210,mainnet,247,106704000,107120421,416422,392558,23864,0.05730725081768014,2021-11-16 05:40:12 UTC
787211,mainnet,247,106704000,107120628,416629,392758,23871,0.05729557952038864,2021-11-16 05:42:03 UTC
787213,mainnet,247,106704000,107120796,416797,392916,23881,0.057296477661787394,2021-11-16 05:43:33 UTC
787214,mainnet,247,106704000,107121039,417040,393146,23894,0.05729426433915212,2021-11-16 05:45:32 UTC
787216,mainnet,247,106704000,107121204,417205,393305,23900,0.057285986505434976,2021-11-16 05:46:57 UTC
787218,mainnet,247,106704000,107121394,417395,393490,23905,0.05727188873848513,2021-11-16 05:48:44 UTC
787219,mainnet,247,106704000,107121616,417617,393694,23923,0.05728454540883154,2021-11-16 05:50:30 UTC
787221,mainnet,247,106704000,107121798,417799,393866,23933,0.05728352628895713,2021-11-16 05:52:08 UTC
787222,mainnet,247,106704000,107121951,417952,394014,23938,0.057274519562054975,2021-11-16 05:53:34 UTC
787224,mainnet,247,106704000,107122106,418107,394153,23954,0.05729155455421698,2021-11-16 05:55:00 UTC
787225,mainnet,247,106704000,107122276,418277,394314,23963,0.05728978643339223,2021-11-16 05:56:26 UTC
787227,mainnet,247,106704000,107122453,418454,394482,23972,0.05728706142132708,2021-11-16 05:58:01 UTC
787228,mainnet,247,106704000,107122720,418721,394737,23984,0.05727919067827981,2021-11-16 06:00:11 UTC
787230,mainnet,247,106704000,107122935,418936,394940,23996,0.057278438711402216,2021-11-16 06:02:10 UTC
787232,mainnet,247,106704000,107123094,419095,395094,24001,0.05726863837554731,2021-11-16 06:03:46 UTC
787233,mainnet,247,106704000,107123276,419277,395263,24014,0.057274784927386906,2021-11-16 06:05:13 UTC
787235,mainnet,247,106704000,107123445,419446,395423,24023,0.05727316507965269,2021-11-16 06:06:40 UTC
787236,mainnet,247,106704000,107123592,419593,395564,24029,0.057267399599135356,2021-11-16 06:08:17 UTC
787238,mainnet,247,106704000,107123760,419761,395712,24049,0.057292125757276165,2021-11-16 06:09:45 UTC
787239,mainnet,247,106704000,107123941,419942,395879,24063,0.05730077010634802,2021-11-16 06:11:12 UTC
787241,mainnet,247,106704000,107124134,420135,396061,24074,0.05730062955954634,2021-11-16 06:12:48 UTC
787242,mainnet,247,106704000,107124296,420297,396222,24075,0.05728092277603695,2021-11-16 06:14:14 UTC
787244,mainnet,247,106704000,107124482,420483,396405,24078,0.057262719301374845,2021-11-16 06:15:51 UTC
787245,mainnet,247,106704000,107124676,420677,396593,24084,0.05725057466892652,2021-11-16 06:17:30 UTC
787247,mainnet,247,106704000,107124845,420846,396752,24094,0.05725134609809764,2021-11-16 06:18:56 UTC
787248,mainnet,247,106704000,107125004,421005,396902,24103,0.05725110153086068,2021-11-16 06:20:24 UTC
787250,mainnet,247,106704000,107125163,421164,397051,24113,0.05725323152026289,2021-11-16 06:21:50 UTC
787251,mainnet,247,106704000,107125338,421339,397206,24133,0.05727691953510119,2021-11-16 06:23:27 UTC
787253,mainnet,247,106704000,107125505,421506,397352,24154,0.05730404786645979,2021-11-16 06:24:54 UTC
787254,mainnet,247,106704000,107125662,421663,397504,24159,0.05729456935989167,2021-11-16 06:26:20 UTC
787256,mainnet,247,106704000,107125836,421837,397672,24165,0.057285159907736874,2021-11-16 06:27:49 UTC
787257,mainnet,247,106704000,107125984,421985,397814,24171,0.05727928717845421,2021-11-16 06:29:14 UTC
787259,mainnet,247,106704000,107126152,422153,397966,24187,0.057294393265001076,2021-11-16 06:30:43 UTC
787260,mainnet,247,106704000,107126307,422308,398110,24198,0.05729941180370725,2021-11-16 06:32:11 UTC
787262,mainnet,247,106704000,107126468,422469,398265,24204,0.0572917776215533,2021-11-16 06:33:37 UTC
787263,mainnet,247,106704000,107126734,422735,398516,24219,0.05729121080582398,2021-11-16 06:35:54 UTC
787265,mainnet,247,106704000,107126900,422901,398668,24233,0.05730182714157687,2021-11-16 06:37:24 UTC
787266,mainnet,247,106704000,107127075,423076,398839,24237,0.057287579536537174,2021-11-16 06:38:51 UTC
787268,mainnet,247,106704000,107127248,423249,398992,24257,0.057311417156331146,2021-11-16 06:40:19 UTC
787269,mainnet,247,106704000,107127430,423431,399160,24271,0.0573198466810413,2021-11-16 06:41:55 UTC
787271,mainnet,247,106704000,107127593,423594,399313,24281,0.057321397375789084,2021-11-16 06:43:24 UTC
787272,mainnet,247,106704000,107127767,423768,399478,24290,0.05731909912971248,2021-11-16 06:44:50 UTC
787274,mainnet,247,106704000,107127921,423922,399624,24298,0.05731714796589939,2021-11-16 06:46:15 UTC
787275,mainnet,247,106704000,107128090,424091,399785,24306,0.0573131709939612,2021-11-16 06:47:45 UTC
787277,mainnet,247,106704000,107128273,424274,399950,24324,0.05733087580195817,2021-11-16 06:49:12 UTC
787278,mainnet,247,106704000,107128429,424430,400101,24329,0.05732158424239568,2021-11-16 06:50:41 UTC
787280,mainnet,247,106704000,107128621,424622,400283,24339,0.05731921567888616,2021-11-16 06:52:21 UTC
787281,mainnet,247,106704000,107128797,424798,400453,24345,0.05730959185306899,2021-11-16 06:53:47 UTC
787283,mainnet,247,106704000,107128969,424970,400617,24353,0.05730522154505024,2021-11-16 06:55:16 UTC
787284,mainnet,247,106704000,107129136,425137,400778,24359,0.057296824317808144,2021-11-16 06:56:46 UTC
787286,mainnet,247,106704000,107129306,425307,400939,24368,0.05729508331628683,2021-11-16 06:58:14 UTC
787287,mainnet,247,106704000,107129459,425460,401087,24373,0.057286231373102056,2021-11-16 06:59:44 UTC
787289,mainnet,247,106704000,107129657,425658,401270,24388,0.05729482354378398,2021-11-16 07:01:22 UTC
787290,mainnet,247,106704000,107129828,425829,401435,24394,0.05728590584483443,2021-11-16 07:02:51 UTC
787291,mainnet,247,106704000,107130007,426008,401605,24403,0.0572829618223132,2021-11-16 07:04:24 UTC
787293,mainnet,247,106704000,107130174,426175,401753,24422,0.05730509767114448,2021-11-16 07:05:52 UTC
787294,mainnet,247,106704000,107130380,426381,401954,24427,0.05728913811825574,2021-11-16 07:07:39 UTC
787296,mainnet,247,106704000,107130534,426535,402100,24435,0.05728720972487603,2021-11-16 07:09:06 UTC
787297,mainnet,247,106704000,107130715,426716,402277,24439,0.057272284142146065,2021-11-16 07:10:39 UTC
787299,mainnet,247,106704000,107130888,426889,402445,24444,0.057260786761898295,2021-11-16 07:12:08 UTC
787300,mainnet,247,106704000,107131094,427095,402651,24444,0.05723316826467179,2021-11-16 07:13:56 UTC
787302,mainnet,247,106704000,107131281,427282,402832,24450,0.057222162412645515,2021-11-16 07:15:27 UTC
787304,mainnet,247,106704000,107131536,427537,403081,24456,0.05720206672171064,2021-11-16 07:17:35 UTC
787305,mainnet,247,106704000,107131736,427737,403269,24468,0.05720337497106867,2021-11-16 07:19:15 UTC
787307,mainnet,247,106704000,107131907,427908,403440,24468,0.057180515437897865,2021-11-16 07:20:53 UTC
787308,mainnet,247,106704000,107132026,428027,403542,24485,0.05720433524053389,2021-11-16 07:22:30 UTC
787310,mainnet,247,106704000,107132263,428264,403747,24517,0.05724739880073973,2021-11-16 07:23:58 UTC
787311,mainnet,247,106704000,107132418,428419,403890,24529,0.05725469692053807,2021-11-16 07:25:27 UTC
787313,mainnet,247,106704000,107132589,428590,404054,24536,0.05724818591194382,2021-11-16 07:26:56 UTC
787314,mainnet,247,106704000,107132747,428748,404197,24551,0.05726207469189361,2021-11-16 07:28:25 UTC
787316,mainnet,247,106704000,107132922,428923,404360,24563,0.05726668889287821,2021-11-16 07:29:55 UTC
787317,mainnet,247,106704000,107133083,429084,404514,24570,0.057261515227787566,2021-11-16 07:31:24 UTC
787319,mainnet,247,106704000,107133258,429259,404681,24578,0.05725680766157495,2021-11-16 07:32:55 UTC
787320,mainnet,247,106704000,107133424,429425,404839,24586,0.05725330383652558,2021-11-16 07:34:25 UTC
787322,mainnet,247,106704000,107133603,429604,405008,24596,0.05725272576605432,2021-11-16 07:35:54 UTC
787323,mainnet,247,106704000,107133772,429773,405165,24608,0.05725813394512917,2021-11-16 07:37:23 UTC
787325,mainnet,247,106704000,107133954,429955,405323,24632,0.057289716365666175,2021-11-16 07:39:12 UTC
787326,mainnet,247,106704000,107134131,430132,405484,24648,0.05730333943998586,2021-11-16 07:40:44 UTC
787327,mainnet,247,106704000,107134305,430306,405634,24672,0.057335942329412096,2021-11-16 07:42:17 UTC
787328,mainnet,247,106704000,107134476,430477,405798,24679,0.05732942758846582,2021-11-16 07:43:48 UTC
787330,mainnet,247,106704000,107134647,430648,405965,24683,0.057315951774999534,2021-11-16 07:45:19 UTC
787331,mainnet,247,106704000,107134810,430811,406127,24684,0.05729658713449749,2021-11-16 07:46:49 UTC
787333,mainnet,247,106704000,107134967,430968,406270,24698,0.05730819921664718,2021-11-16 07:48:22 UTC
787334,mainnet,247,106704000,107135142,431143,406430,24713,0.05731972918498039,2021-11-16 07:49:50 UTC
787336,mainnet,247,106704000,107135326,431327,406600,24727,0.057327735105847766,2021-11-16 07:51:22 UTC
787338,mainnet,247,106704000,107135518,431519,406780,24739,0.057330036452624335,2021-11-16 07:53:03 UTC
787339,mainnet,247,106704000,107135698,431699,406958,24741,0.05731076513959958,2021-11-16 07:54:33 UTC
787341,mainnet,247,106704000,107135864,431865,407117,24748,0.05730494483229713,2021-11-16 07:56:07 UTC
787342,mainnet,247,106704000,107135947,431948,407188,24760,0.0573217146508376,2021-11-16 07:57:45 UTC
787344,mainnet,247,106704000,107135947,431948,407188,24760,0.0573217146508376,2021-11-16 07:59:13 UTC
787348,mainnet,248,107136000,107137005,1006,746,260,0.2584493041749503,2021-11-16 08:08:31 UTC
787350,mainnet,248,107136000,107137188,1189,904,285,0.2396972245584525,2021-11-16 08:10:10 UTC
787351,mainnet,248,107136000,107137340,1341,1030,311,0.2319164802386279,2021-11-16 08:11:30 UTC
787352,mainnet,248,107136000,107137500,1501,1185,316,0.21052631578947367,2021-11-16 08:13:04 UTC
787353,mainnet,248,107136000,107137652,1653,1329,324,0.19600725952813067,2021-11-16 08:14:23 UTC
787355,mainnet,248,107136000,107137796,1797,1464,333,0.18530884808013356,2021-11-16 08:15:44 UTC
787356,mainnet,248,107136000,107137947,1948,1612,336,0.17248459958932238,2021-11-16 08:17:04 UTC
787358,mainnet,248,107136000,107138116,2117,1776,341,0.161076995748701,2021-11-16 08:18:36 UTC
787359,mainnet,248,107136000,107138292,2293,1938,355,0.15481901439162668,2021-11-16 08:20:06 UTC
787361,mainnet,248,107136000,107138438,2439,2076,363,0.14883148831488316,2021-11-16 08:21:28 UTC
787362,mainnet,248,107136000,107138608,2609,2228,381,0.14603296282100423,2021-11-16 08:22:49 UTC
787364,mainnet,248,107136000,107138766,2767,2378,389,0.1405854716299241,2021-11-16 08:24:18 UTC
787365,mainnet,248,107136000,107138942,2943,2529,414,0.14067278287461774,2021-11-16 08:25:47 UTC
787367,mainnet,248,107136000,107139093,3094,2676,418,0.13510019392372333,2021-11-16 08:27:12 UTC
787368,mainnet,248,107136000,107139244,3245,2821,424,0.13066255778120184,2021-11-16 08:28:31 UTC
787370,mainnet,248,107136000,107139432,3433,2998,435,0.12671133119720362,2021-11-16 08:30:02 UTC
787371,mainnet,248,107136000,107139578,3579,3136,443,0.12377759150600727,2021-11-16 08:31:25 UTC
787373,mainnet,248,107136000,107139771,3772,3312,460,0.12195121951219512,2021-11-16 08:32:55 UTC
787374,mainnet,248,107136000,107139936,3937,3469,468,0.11887223774447549,2021-11-16 08:34:18 UTC
787375,mainnet,248,107136000,107140103,4104,3635,469,0.11427875243664717,2021-11-16 08:35:42 UTC
787377,mainnet,248,107136000,107140253,4254,3764,490,0.1151857075693465,2021-11-16 08:37:16 UTC
787378,mainnet,248,107136000,107140441,4442,3936,506,0.11391265195857722,2021-11-16 08:38:40 UTC
787380,mainnet,248,107136000,107140633,4634,4126,508,0.10962451445835132,2021-11-16 08:40:17 UTC
787381,mainnet,248,107136000,107140781,4782,4265,517,0.10811375993308239,2021-11-16 08:41:51 UTC
787383,mainnet,248,107136000,107140950,4951,4407,544,0.10987679256715815,2021-11-16 08:43:14 UTC
787384,mainnet,248,107136000,107141111,5112,4546,566,0.11071987480438185,2021-11-16 08:44:36 UTC
787386,mainnet,248,107136000,107141259,5260,4693,567,0.10779467680608365,2021-11-16 08:45:56 UTC
787387,mainnet,248,107136000,107141422,5423,4852,571,0.10529227364927161,2021-11-16 08:47:19 UTC
787389,mainnet,248,107136000,107141634,5635,5058,577,0.10239574090505768,2021-11-16 08:49:09 UTC
787390,mainnet,248,107136000,107141786,5787,5203,584,0.10091584586141351,2021-11-16 08:50:30 UTC
787392,mainnet,248,107136000,107141934,5935,5346,589,0.09924178601516428,2021-11-16 08:51:53 UTC
787393,mainnet,248,107136000,107142054,6055,5456,599,0.09892650701899257,2021-11-16 08:53:13 UTC
787395,mainnet,248,107136000,107142224,6225,5607,618,0.09927710843373494,2021-11-16 08:54:35 UTC
787396,mainnet,248,107136000,107142431,6432,5796,636,0.09888059701492537,2021-11-16 08:56:36 UTC
787398,mainnet,248,107136000,107142587,6588,5946,642,0.09744990892531877,2021-11-16 08:57:57 UTC
787399,mainnet,248,107136000,107142745,6746,6094,652,0.09664986658760748,2021-11-16 08:59:23 UTC
787401,mainnet,248,107136000,107142924,6925,6260,665,0.096028880866426,2021-11-16 09:01:20 UTC
787402,mainnet,248,107136000,107143102,7103,6436,667,0.09390398423201464,2021-11-16 09:02:42 UTC
787404,mainnet,248,107136000,107143247,7248,6569,679,0.09368101545253864,2021-11-16 09:04:05 UTC
787405,mainnet,248,107136000,107143420,7421,6729,692,0.09324888828998787,2021-11-16 09:05:38 UTC
787407,mainnet,248,107136000,107143575,7576,6869,707,0.09332101372756071,2021-11-16 09:06:58 UTC
787408,mainnet,248,107136000,107143739,7740,7025,715,0.09237726098191215,2021-11-16 09:08:21 UTC
787410,mainnet,248,107136000,107143899,7900,7168,732,0.09265822784810127,2021-11-16 09:09:44 UTC
787411,mainnet,248,107136000,107144083,8084,7347,737,0.09116773874319643,2021-11-16 09:11:25 UTC
787413,mainnet,248,107136000,107144245,8246,7504,742,0.0899830220713073,2021-11-16 09:12:47 UTC
787414,mainnet,248,107136000,107144438,8439,7687,752,0.08911008413319113,2021-11-16 09:14:22 UTC
787415,mainnet,248,107136000,107144604,8605,7848,757,0.08797210923881464,2021-11-16 09:15:48 UTC
787416,mainnet,248,107136000,107144756,8757,7995,762,0.08701610140459061,2021-11-16 09:17:11 UTC
787418,mainnet,248,107136000,107144916,8917,8151,766,0.08590333071660873,2021-11-16 09:18:37 UTC
787419,mainnet,248,107136000,107145071,9072,8298,774,0.08531746031746032,2021-11-16 09:20:01 UTC
787421,mainnet,248,107136000,107145220,9221,8443,778,0.08437262769764668,2021-11-16 09:21:25 UTC
787422,mainnet,248,107136000,107145396,9397,8609,788,0.08385654996275407,2021-11-16 09:23:01 UTC
787424,mainnet,248,107136000,107145544,9545,8751,794,0.08318491356731272,2021-11-16 09:24:24 UTC
787425,mainnet,248,107136000,107145748,9749,8949,800,0.08205969843060827,2021-11-16 09:26:09 UTC
787427,mainnet,248,107136000,107145924,9925,9116,809,0.08151133501259446,2021-11-16 09:27:44 UTC
787428,mainnet,248,107136000,107146094,10095,9281,814,0.08063397721644379,2021-11-16 09:29:08 UTC
787430,mainnet,248,107136000,107146260,10261,9442,819,0.07981678199005945,2021-11-16 09:30:37 UTC
787431,mainnet,248,107136000,107146473,10474,9626,848,0.08096238304372733,2021-11-16 09:32:28 UTC
787433,mainnet,248,107136000,107146661,10662,9809,853,0.08000375164134309,2021-11-16 09:34:04 UTC
787434,mainnet,248,107136000,107146827,10828,9970,858,0.07923900997414111,2021-11-16 09:35:28 UTC
787436,mainnet,248,107136000,107146976,10977,10114,863,0.0786189304910267,2021-11-16 09:36:54 UTC
787437,mainnet,248,107136000,107147139,11140,10266,874,0.07845601436265709,2021-11-16 09:38:20 UTC
787439,mainnet,248,107136000,107147303,11304,10423,881,0.07793701344656759,2021-11-16 09:39:46 UTC
787440,mainnet,248,107136000,107147500,11501,10607,894,0.07773237109816537,2021-11-16 09:41:22 UTC
787442,mainnet,248,107136000,107147652,11653,10757,896,0.07689007122629365,2021-11-16 09:42:47 UTC
787443,mainnet,248,107136000,107147821,11822,10924,898,0.07596007443748942,2021-11-16 09:44:13 UTC
787445,mainnet,248,107136000,107147986,11987,11075,912,0.07608242262450989,2021-11-16 09:45:41 UTC
787446,mainnet,248,107136000,107148140,12141,11218,923,0.07602339181286549,2021-11-16 09:47:08 UTC
787448,mainnet,248,107136000,107148295,12296,11373,923,0.07506506180871829,2021-11-16 09:48:31 UTC
787449,mainnet,248,107136000,107148454,12455,11527,928,0.07450822962665596,2021-11-16 09:49:57 UTC
787451,mainnet,248,107136000,107148613,12614,11679,935,0.07412398921832884,2021-11-16 09:51:34 UTC
787452,mainnet,248,107136000,107148770,12771,11819,952,0.07454388849737686,2021-11-16 09:52:59 UTC
787454,mainnet,248,107136000,107148907,12908,11932,976,0.07561202355128602,2021-11-16 09:54:26 UTC
787455,mainnet,248,107136000,107149068,13069,12072,997,0.07628739765858138,2021-11-16 09:56:02 UTC
787457,mainnet,248,107136000,107149234,13235,12220,1015,0.07669059312429165,2021-11-16 09:57:28 UTC
787458,mainnet,248,107136000,107149411,13412,12380,1032,0.07694601849090367,2021-11-16 09:58:56 UTC
787460,mainnet,248,107136000,107149559,13560,12525,1035,0.07632743362831858,2021-11-16 10:00:29 UTC
787461,mainnet,248,107136000,107149730,13731,12686,1045,0.07610516349865268,2021-11-16 10:02:07 UTC
787462,mainnet,248,107136000,107149862,13863,12800,1063,0.07667892952463391,2021-11-16 10:03:32 UTC
787464,mainnet,248,107136000,107149987,13988,12916,1072,0.07663711752931084,2021-11-16 10:05:01 UTC
787465,mainnet,248,107136000,107150121,14122,13028,1094,0.07746778076759665,2021-11-16 10:06:28 UTC
787467,mainnet,248,107136000,107150254,14255,13144,1111,0.07793756576639775,2021-11-16 10:07:52 UTC
787468,mainnet,248,107136000,107150408,14409,13279,1130,0.07842320771739884,2021-11-16 10:09:19 UTC
787469,mainnet,248,107136000,107150514,14515,13369,1146,0.07895280744057871,2021-11-16 10:10:46 UTC
787470,mainnet,248,107136000,107150640,14641,13471,1170,0.07991257427771327,2021-11-16 10:12:13 UTC
787472,mainnet,248,107136000,107150818,14819,13608,1211,0.08171941426547001,2021-11-16 10:13:37 UTC
787473,mainnet,248,107136000,107150981,14982,13747,1235,0.08243225203577627,2021-11-16 10:15:25 UTC
787475,mainnet,248,107136000,107151112,15113,13857,1256,0.0831072586514921,2021-11-16 10:17:06 UTC
787477,mainnet,248,107136000,107151286,15287,13987,1300,0.08503957611042062,2021-11-16 10:18:42 UTC
787478,mainnet,248,107136000,107151292,15293,13993,1300,0.08500621199241483,2021-11-16 10:20:06 UTC
787480,mainnet,248,107136000,107151559,15560,14211,1349,0.08669665809768637,2021-11-16 10:21:44 UTC
787481,mainnet,248,107136000,107151799,15800,14417,1383,0.08753164556962026,2021-11-16 10:24:03 UTC
787483,mainnet,248,107136000,107151962,15963,14545,1418,0.08883042034705256,2021-11-16 10:25:44 UTC
787484,mainnet,248,107136000,107152120,16121,14690,1431,0.08876620557037404,2021-11-16 10:27:13 UTC
787486,mainnet,248,107136000,107152315,16316,14875,1441,0.0883182152488355,2021-11-16 10:29:10 UTC
787487,mainnet,248,107136000,107152470,16471,15013,1458,0.0885192155910388,2021-11-16 10:30:46 UTC
787489,mainnet,248,107136000,107152617,16618,15142,1476,0.08881935250932724,2021-11-16 10:32:12 UTC
787491,mainnet,248,107136000,107152806,16807,15311,1496,0.08901053132623311,2021-11-16 10:34:02 UTC
787492,mainnet,248,107136000,107152974,16975,15458,1517,0.08936671575846833,2021-11-16 10:35:41 UTC
787494,mainnet,248,107136000,107153167,17168,15622,1546,0.09005125815470644,2021-11-16 10:37:48 UTC
787495,mainnet,248,107136000,107153373,17374,15801,1573,0.09053758489697249,2021-11-16 10:39:47 UTC
787497,mainnet,248,107136000,107153545,17546,15949,1597,0.09101789581671037,2021-11-16 10:41:22 UTC
787498,mainnet,248,107136000,107153730,17731,16112,1619,0.09130900682420619,2021-11-16 10:43:04 UTC
787500,mainnet,248,107136000,107153882,17883,16251,1632,0.09125985572890455,2021-11-16 10:44:34 UTC
787502,mainnet,248,107136000,107154078,18079,16432,1647,0.09110017146966093,2021-11-16 10:46:16 UTC
787503,mainnet,248,107136000,107154242,18243,16579,1664,0.0912130680260922,2021-11-16 10:47:55 UTC
787505,mainnet,248,107136000,107154428,18429,16726,1703,0.09240870367355798,2021-11-16 10:49:25 UTC
787506,mainnet,248,107136000,107154568,18569,16849,1720,0.09262749744197318,2021-11-16 10:50:54 UTC
787508,mainnet,248,107136000,107154758,18759,17016,1743,0.0929154006077083,2021-11-16 10:52:30 UTC
787509,mainnet,248,107136000,107154957,18958,17211,1747,0.09215107078805782,2021-11-16 10:54:10 UTC
787511,mainnet,248,107136000,107155117,19118,17366,1752,0.09164138508212157,2021-11-16 10:55:36 UTC
787512,mainnet,248,107136000,107155278,19279,17503,1776,0.0921209606307381,2021-11-16 10:57:07 UTC
787513,mainnet,248,107136000,107155437,19438,17644,1794,0.09229344582776006,2021-11-16 10:58:35 UTC
787515,mainnet,248,107136000,107155533,19534,17737,1797,0.09199344732261698,2021-11-16 11:00:02 UTC
787517,mainnet,248,107136000,107155721,19722,17885,1837,0.09314471148970693,2021-11-16 11:01:34 UTC
787518,mainnet,248,107136000,107155893,19894,18040,1854,0.0931939278174324,2021-11-16 11:03:13 UTC
787520,mainnet,248,107136000,107156033,20034,18162,1872,0.09344115004492363,2021-11-16 11:04:42 UTC
787521,mainnet,248,107136000,107156195,20196,18309,1887,0.09343434343434344,2021-11-16 11:06:13 UTC
787523,mainnet,248,107136000,107156344,20345,18448,1897,0.0932415826984517,2021-11-16 11:07:41 UTC
787524,mainnet,248,107136000,107156501,20502,18593,1909,0.09311286703736221,2021-11-16 11:09:10 UTC
787526,mainnet,248,107136000,107156653,20654,18737,1917,0.09281495109906071,2021-11-16 11:10:48 UTC
787527,mainnet,248,107136000,107156928,20929,18980,1949,0.09312437287973625,2021-11-16 11:13:16 UTC
787529,mainnet,248,107136000,107157104,21105,19138,1967,0.09320066334991708,2021-11-16 11:14:37 UTC
787530,mainnet,248,107136000,107157255,21256,19273,1983,0.0932913059841927,2021-11-16 11:15:57 UTC
787531,mainnet,248,107136000,107157410,21411,19421,1990,0.09294287982812573,2021-11-16 11:17:20 UTC
787533,mainnet,248,107136000,107157560,21561,19568,1993,0.09243541579704095,2021-11-16 11:18:54 UTC
787535,mainnet,248,107136000,107157759,21760,19759,2001,0.0919577205882353,2021-11-16 11:20:31 UTC
787536,mainnet,248,107136000,107157921,21922,19907,2015,0.09191679591278168,2021-11-16 11:21:57 UTC
787538,mainnet,248,107136000,107158078,22079,20055,2024,0.0916708184247475,2021-11-16 11:23:19 UTC
787539,mainnet,248,107136000,107158241,22242,20198,2044,0.09189821059257261,2021-11-16 11:24:44 UTC
787541,mainnet,248,107136000,107158408,22409,20346,2063,0.09206122540050872,2021-11-16 11:26:22 UTC
787542,mainnet,248,107136000,107158664,22665,20569,2096,0.09247738804323848,2021-11-16 11:29:01 UTC
787544,mainnet,248,107136000,107158856,22857,20746,2111,0.09235682723017019,2021-11-16 11:30:25 UTC
787545,mainnet,248,107136000,107159032,23033,20900,2133,0.09260626058264229,2021-11-16 11:32:00 UTC
787547,mainnet,248,107136000,107159227,23228,21081,2147,0.09243154813156536,2021-11-16 11:33:45 UTC
787549,mainnet,248,107136000,107159388,23389,21231,2158,0.09226559493779127,2021-11-16 11:35:10 UTC
787550,mainnet,248,107136000,107159586,23587,21422,2165,0.09178784923898758,2021-11-16 11:37:07 UTC
787552,mainnet,248,107136000,107159790,23791,21610,2181,0.09167332184439494,2021-11-16 11:38:42 UTC
787553,mainnet,248,107136000,107159950,23951,21757,2194,0.09160369086885725,2021-11-16 11:40:06 UTC
787555,mainnet,248,107136000,107160129,24130,21922,2208,0.09150435142975549,2021-11-16 11:41:42 UTC
787556,mainnet,248,107136000,107160278,24279,22066,2213,0.09114872935458627,2021-11-16 11:43:07 UTC
787558,mainnet,248,107136000,107160443,24444,22210,2234,0.09139257077401407,2021-11-16 11:44:33 UTC
787559,mainnet,248,107136000,107160602,24603,22353,2250,0.09145226191927813,2021-11-16 11:46:08 UTC
787561,mainnet,248,107136000,107160778,24779,22514,2265,0.09140804713668832,2021-11-16 11:47:34 UTC
787562,mainnet,248,107136000,107160937,24938,22657,2281,0.09146683775763895,2021-11-16 11:48:59 UTC
787564,mainnet,248,107136000,107161114,25115,22829,2286,0.09102130201075055,2021-11-16 11:50:26 UTC
787565,mainnet,248,107136000,107161255,25256,22965,2291,0.09071111815014254,2021-11-16 11:51:59 UTC
787567,mainnet,248,107136000,107161475,25476,23152,2324,0.09122311194850055,2021-11-16 11:53:36 UTC
787568,mainnet,248,107136000,107161631,25632,23301,2331,0.09094101123595505,2021-11-16 11:54:59 UTC
787570,mainnet,248,107136000,107161789,25790,23456,2334,0.09050019387359441,2021-11-16 11:56:25 UTC
787571,mainnet,248,107136000,107161960,25961,23608,2353,0.09063595393089635,2021-11-16 11:57:51 UTC
787573,mainnet,248,107136000,107162148,26149,23789,2360,0.09025201728555585,2021-11-16 11:59:30 UTC
787574,mainnet,248,107136000,107162308,26309,23939,2370,0.09008324147630088,2021-11-16 12:01:07 UTC
787576,mainnet,248,107136000,107162492,26493,24109,2384,0.08998603404672932,2021-11-16 12:02:34 UTC
787577,mainnet,248,107136000,107162654,26655,24258,2397,0.08992684299380979,2021-11-16 12:04:11 UTC
787579,mainnet,248,107136000,107162812,26813,24406,2407,0.08976988774102114,2021-11-16 12:05:38 UTC
787580,mainnet,248,107136000,107162959,26960,24531,2429,0.09009643916913947,2021-11-16 12:07:00 UTC
787582,mainnet,248,107136000,107163103,27104,24656,2448,0.09031877213695395,2021-11-16 12:08:40 UTC
787583,mainnet,248,107136000,107163280,27281,24821,2460,0.09017264763021883,2021-11-16 12:10:05 UTC
787585,mainnet,248,107136000,107163424,27425,24960,2465,0.08988149498632635,2021-11-16 12:11:30 UTC
787586,mainnet,248,107136000,107163579,27580,25101,2479,0.08988397389412618,2021-11-16 12:12:57 UTC
787588,mainnet,248,107136000,107163760,27761,25265,2496,0.08991030582471812,2021-11-16 12:14:23 UTC
787589,mainnet,248,107136000,107163927,27928,25418,2510,0.08987396161558293,2021-11-16 12:15:51 UTC
787591,mainnet,248,107136000,107164098,28099,25581,2518,0.08961172995480267,2021-11-16 12:17:23 UTC
787592,mainnet,248,107136000,107164272,28273,25748,2525,0.08930782018179889,2021-11-16 12:18:52 UTC
787594,mainnet,248,107136000,107164436,28437,25906,2531,0.08900376270352006,2021-11-16 12:20:23 UTC
787595,mainnet,248,107136000,107164596,28597,26058,2539,0.08878553694443474,2021-11-16 12:21:53 UTC
787597,mainnet,248,107136000,107164783,28784,26240,2544,0.08838243468593664,2021-11-16 12:23:34 UTC
787598,mainnet,248,107136000,107164970,28971,26421,2550,0.08801905353629491,2021-11-16 12:25:24 UTC
787600,mainnet,248,107136000,107165131,29132,26577,2555,0.08770424275710559,2021-11-16 12:26:55 UTC
787601,mainnet,248,107136000,107165311,29312,26749,2563,0.08743859170305676,2021-11-16 12:28:36 UTC
787603,mainnet,248,107136000,107165471,29472,26888,2584,0.08767643865363735,2021-11-16 12:30:06 UTC
787605,mainnet,248,107136000,107165650,29651,27058,2593,0.0874506761997909,2021-11-16 12:31:48 UTC
787606,mainnet,248,107136000,107165870,29871,27249,2622,0.08777744300492116,2021-11-16 12:33:28 UTC
787608,mainnet,248,107136000,107166042,30043,27400,2643,0.0879739040708318,2021-11-16 12:34:55 UTC
787609,mainnet,248,107136000,107166245,30246,27590,2656,0.08781326456390928,2021-11-16 12:36:33 UTC
787611,mainnet,248,107136000,107166416,30417,27747,2670,0.08777985994674031,2021-11-16 12:37:58 UTC
787612,mainnet,248,107136000,107166587,30588,27917,2671,0.08732182555250426,2021-11-16 12:39:36 UTC
787614,mainnet,248,107136000,107166817,30818,28122,2696,0.08748134207281459,2021-11-16 12:41:21 UTC
787615,mainnet,248,107136000,107166971,30972,28271,2701,0.08720780059408498,2021-11-16 12:42:56 UTC
787617,mainnet,248,107136000,107167183,31184,28465,2719,0.08719214982042073,2021-11-16 12:44:32 UTC
787618,mainnet,248,107136000,107167382,31383,28663,2720,0.0866711276805914,2021-11-16 12:46:12 UTC
787620,mainnet,248,107136000,107167551,31552,28823,2729,0.08649213995943204,2021-11-16 12:47:40 UTC
787622,mainnet,248,107136000,107167719,31720,28977,2743,0.08647540983606557,2021-11-16 12:49:23 UTC
787623,mainnet,248,107136000,107167899,31900,29127,2773,0.08692789968652037,2021-11-16 12:50:52 UTC
787624,mainnet,248,107136000,107168031,32032,29250,2782,0.08685064935064934,2021-11-16 12:52:18 UTC
787626,mainnet,248,107136000,107168226,32227,29410,2817,0.08741117696341577,2021-11-16 12:54:07 UTC
787628,mainnet,248,107136000,107168455,32456,29619,2837,0.08741064826226276,2021-11-16 12:55:44 UTC
787629,mainnet,248,107136000,107168616,32617,29758,2859,0.08765367753012233,2021-11-16 12:57:12 UTC
787631,mainnet,248,107136000,107168806,32807,29930,2877,0.08769469930197824,2021-11-16 12:58:44 UTC
787632,mainnet,248,107136000,107169026,33027,30133,2894,0.0876252762890968,2021-11-16 13:00:34 UTC
787634,mainnet,248,107136000,107169228,33229,30321,2908,0.08751391856510879,2021-11-16 13:02:18 UTC
787635,mainnet,248,107136000,107169403,33404,30483,2921,0.0874446174110885,2021-11-16 13:03:53 UTC
787637,mainnet,248,107136000,107169583,33584,30652,2932,0.08730347784659362,2021-11-16 13:05:28 UTC
787638,mainnet,248,107136000,107169767,33768,30803,2965,0.08780502250651505,2021-11-16 13:07:15 UTC
787640,mainnet,248,107136000,107169953,33954,30975,2979,0.08773634917830005,2021-11-16 13:08:52 UTC
787641,mainnet,248,107136000,107170140,34141,31143,2998,0.08781230778243168,2021-11-16 13:10:30 UTC
787643,mainnet,248,107136000,107170335,34336,31318,3018,0.08789608574091333,2021-11-16 13:12:17 UTC
787644,mainnet,248,107136000,107170551,34552,31526,3026,0.08757814308867794,2021-11-16 13:13:56 UTC
787646,mainnet,248,107136000,107170741,34742,31697,3045,0.08764607679465776,2021-11-16 13:15:42 UTC
787647,mainnet,248,107136000,107170938,34939,31879,3060,0.08758121297117834,2021-11-16 13:17:22 UTC
787649,mainnet,248,107136000,107171111,35112,32043,3069,0.08740601503759399,2021-11-16 13:19:12 UTC
787650,mainnet,248,107136000,107171333,35334,32264,3070,0.08688515311031868,2021-11-16 13:20:52 UTC
787651,mainnet,248,107136000,107171534,35535,32448,3087,0.08687209793161671,2021-11-16 13:22:28 UTC
787653,mainnet,248,107136000,107171723,35724,32628,3096,0.08666442727578098,2021-11-16 13:24:04 UTC
787654,mainnet,248,107136000,107171908,35909,32811,3098,0.08627363613578769,2021-11-16 13:25:42 UTC
787656,mainnet,248,107136000,107172086,36087,32980,3107,0.08609748662953418,2021-11-16 13:27:20 UTC
787658,mainnet,248,107136000,107172259,36260,33152,3108,0.08571428571428572,2021-11-16 13:28:52 UTC
787659,mainnet,248,107136000,107172445,36446,33330,3116,0.08549635076551611,2021-11-16 13:30:25 UTC
787661,mainnet,248,107136000,107172631,36632,33507,3125,0.08530792749508627,2021-11-16 13:32:03 UTC
787662,mainnet,248,107136000,107172805,36806,33681,3125,0.08490463511384014,2021-11-16 13:33:35 UTC
787664,mainnet,248,107136000,107172980,36981,33844,3137,0.08482734377112572,2021-11-16 13:35:04 UTC
787665,mainnet,248,107136000,107173186,37187,34037,3150,0.08470702127087423,2021-11-16 13:36:48 UTC
787667,mainnet,248,107136000,107173374,37375,34215,3160,0.08454849498327759,2021-11-16 13:38:20 UTC
787668,mainnet,248,107136000,107173540,37541,34373,3168,0.08438773607522441,2021-11-16 13:39:50 UTC
787669,mainnet,248,107136000,107173717,37718,34542,3176,0.08420382841083833,2021-11-16 13:41:23 UTC
787670,mainnet,248,107136000,107173857,37858,34681,3177,0.08391885466744149,2021-11-16 13:42:52 UTC
787672,mainnet,248,107136000,107174037,38038,34851,3187,0.08378463641621536,2021-11-16 13:44:33 UTC
787673,mainnet,248,107136000,107174263,38264,35056,3208,0.08383859502404349,2021-11-16 13:46:13 UTC
787675,mainnet,248,107136000,107174446,38447,35227,3220,0.08375165812677192,2021-11-16 13:47:55 UTC
787677,mainnet,248,107136000,107174599,38600,35369,3231,0.08370466321243523,2021-11-16 13:49:25 UTC
787678,mainnet,248,107136000,107174775,38776,35535,3241,0.08358262842995667,2021-11-16 13:50:57 UTC
787680,mainnet,248,107136000,107174922,38923,35675,3248,0.08344680523084037,2021-11-16 13:52:29 UTC
787681,mainnet,248,107136000,107175111,39112,35843,3269,0.08358048680711802,2021-11-16 13:54:00 UTC
787683,mainnet,248,107136000,107175308,39309,36031,3278,0.08339057213360808,2021-11-16 13:55:41 UTC
787684,mainnet,248,107136000,107175484,39485,36205,3280,0.083069520070913,2021-11-16 13:57:15 UTC
787686,mainnet,248,107136000,107175669,39670,36376,3294,0.08303503907234686,2021-11-16 13:58:50 UTC
787687,mainnet,248,107136000,107175852,39853,36544,3309,0.08303013574887712,2021-11-16 14:00:24 UTC
787689,mainnet,248,107136000,107176067,40068,36749,3319,0.08283418189078566,2021-11-16 14:02:24 UTC
787690,mainnet,248,107136000,107176234,40235,36906,3329,0.08273890891015286,2021-11-16 14:03:54 UTC
787692,mainnet,248,107136000,107176405,40406,37068,3338,0.08261149334257288,2021-11-16 14:05:33 UTC
787693,mainnet,248,107136000,107176573,40574,37223,3351,0.08258983585547394,2021-11-16 14:07:02 UTC
787695,mainnet,248,107136000,107176702,40703,37347,3356,0.08245092499324375,2021-11-16 14:08:30 UTC
787696,mainnet,248,107136000,107176918,40919,37509,3410,0.08333536987707423,2021-11-16 14:10:11 UTC
787698,mainnet,248,107136000,107177089,41090,37675,3415,0.08311024580189827,2021-11-16 14:11:44 UTC
787699,mainnet,248,107136000,107177252,41253,37834,3419,0.08287882093423508,2021-11-16 14:13:14 UTC
787701,mainnet,248,107136000,107177433,41434,38006,3428,0.08273398658106869,2021-11-16 14:14:47 UTC
787702,mainnet,248,107136000,107177603,41604,38163,3441,0.08270839342370925,2021-11-16 14:16:19 UTC
787704,mainnet,248,107136000,107177786,41787,38334,3453,0.08263335487113217,2021-11-16 14:17:49 UTC
787705,mainnet,248,107136000,107177959,41960,38503,3457,0.08238798856053384,2021-11-16 14:19:18 UTC
787707,mainnet,248,107136000,107178116,42117,38655,3462,0.08219958686516134,2021-11-16 14:20:50 UTC
787708,mainnet,248,107136000,107178308,42309,38833,3476,0.08215746058758183,2021-11-16 14:22:21 UTC
787710,mainnet,248,107136000,107178472,42473,38984,3489,0.08214630471122832,2021-11-16 14:23:49 UTC
787711,mainnet,248,107136000,107178641,42642,39139,3503,0.082149054922377,2021-11-16 14:25:28 UTC
787713,mainnet,248,107136000,107178812,42813,39305,3508,0.08193772919440356,2021-11-16 14:26:59 UTC
787715,mainnet,248,107136000,107178974,42975,39461,3514,0.08176847004072135,2021-11-16 14:28:49 UTC
787716,mainnet,248,107136000,107179197,43198,39661,3537,0.08187879068475393,2021-11-16 14:30:41 UTC
787718,mainnet,248,107136000,107179363,43364,39813,3551,0.08188820219536944,2021-11-16 14:32:19 UTC
787719,mainnet,248,107136000,107179588,43589,40014,3575,0.08201610498061437,2021-11-16 14:34:21 UTC
787721,mainnet,248,107136000,107179783,43784,40202,3582,0.08181070710761922,2021-11-16 14:36:12 UTC
787723,mainnet,248,107136000,107180028,44029,40402,3627,0.08237752390469917,2021-11-16 14:38:21 UTC
787724,mainnet,248,107136000,107180203,44204,40567,3637,0.08227762193466655,2021-11-16 14:40:03 UTC
787726,mainnet,248,107136000,107180381,44382,40732,3650,0.0822405479698977,2021-11-16 14:41:36 UTC
787727,mainnet,248,107136000,107180564,44565,40903,3662,0.08217210815662515,2021-11-16 14:43:10 UTC
787729,mainnet,248,107136000,107180734,44735,41063,3672,0.0820833799038784,2021-11-16 14:44:44 UTC
787730,mainnet,248,107136000,107180898,44899,41218,3681,0.081984008552529,2021-11-16 14:46:13 UTC
787732,mainnet,248,107136000,107181077,45078,41395,3683,0.08170282621234305,2021-11-16 14:47:53 UTC
787733,mainnet,248,107136000,107181241,45242,41541,3701,0.08180451792582114,2021-11-16 14:49:24 UTC
787735,mainnet,248,107136000,107181452,45453,41741,3712,0.0816667766704068,2021-11-16 14:51:14 UTC
787737,mainnet,248,107136000,107181617,45618,41893,3725,0.08165636371607699,2021-11-16 14:52:43 UTC
787738,mainnet,248,107136000,107181790,45791,42042,3749,0.08187198357755891,2021-11-16 14:54:14 UTC
787739,mainnet,248,107136000,107181959,45960,42201,3759,0.08178851174934726,2021-11-16 14:55:46 UTC
787741,mainnet,248,107136000,107182157,46158,42386,3772,0.0817193119285931,2021-11-16 14:57:45 UTC
787743,mainnet,248,107136000,107182317,46318,42531,3787,0.08176087050390776,2021-11-16 14:59:15 UTC
787744,mainnet,248,107136000,107182491,46492,42689,3803,0.08179901918609653,2021-11-16 15:00:51 UTC
787746,mainnet,248,107136000,107182653,46654,42841,3813,0.08172932653148712,2021-11-16 15:02:22 UTC
787747,mainnet,248,107136000,107182814,46815,42982,3833,0.08187546726476556,2021-11-16 15:03:53 UTC
787749,mainnet,248,107136000,107182976,46977,43131,3846,0.08186985120378057,2021-11-16 15:05:21 UTC
787750,mainnet,248,107136000,107183127,47128,43279,3849,0.0816711933457817,2021-11-16 15:06:51 UTC
787752,mainnet,248,107136000,107183285,47286,43418,3868,0.08180010996912405,2021-11-16 15:08:21 UTC
787753,mainnet,248,107136000,107183471,47472,43592,3880,0.08173238961914392,2021-11-16 15:09:53 UTC
787755,mainnet,248,107136000,107183639,47640,43756,3884,0.08152812762384551,2021-11-16 15:11:23 UTC
787756,mainnet,248,107136000,107183820,47821,43924,3897,0.08149139499383116,2021-11-16 15:12:57 UTC
787758,mainnet,248,107136000,107183993,47994,44091,3903,0.08132266533316665,2021-11-16 15:14:29 UTC
787759,mainnet,248,107136000,107184168,48169,44245,3924,0.08146318171438062,2021-11-16 15:15:59 UTC
787761,mainnet,248,107136000,107184335,48336,44411,3925,0.0812024164184045,2021-11-16 15:17:34 UTC
787762,mainnet,248,107136000,107184514,48515,44584,3931,0.08102648665361228,2021-11-16 15:19:05 UTC
787763,mainnet,248,107136000,107184675,48676,44740,3936,0.0808612047004684,2021-11-16 15:20:37 UTC
787764,mainnet,248,107136000,107184837,48838,44883,3955,0.08098202219583112,2021-11-16 15:22:05 UTC
787766,mainnet,248,107136000,107184995,48996,45030,3966,0.08094538329659565,2021-11-16 15:23:36 UTC
787767,mainnet,248,107136000,107185148,49149,45171,3978,0.08093755722395166,2021-11-16 15:25:04 UTC
787769,mainnet,248,107136000,107185347,49348,45348,4000,0.08105698305909054,2021-11-16 15:26:39 UTC
787770,mainnet,248,107136000,107185518,49519,45517,4002,0.08081746400371574,2021-11-16 15:28:13 UTC
787772,mainnet,248,107136000,107185672,49673,45657,4016,0.08084875083043101,2021-11-16 15:29:46 UTC
787773,mainnet,248,107136000,107185854,49855,45828,4027,0.08077424531140306,2021-11-16 15:31:19 UTC
787775,mainnet,248,107136000,107186006,50007,45970,4037,0.08072869798228248,2021-11-16 15:33:13 UTC
787777,mainnet,248,107136000,107186213,50214,46145,4069,0.08103317799816784,2021-11-16 15:34:52 UTC
787778,mainnet,248,107136000,107186362,50363,46280,4083,0.0810714214800548,2021-11-16 15:36:24 UTC
787780,mainnet,248,107136000,107186545,50546,46443,4103,0.08117358445772167,2021-11-16 15:37:54 UTC
787781,mainnet,248,107136000,107186707,50708,46597,4111,0.08107202019405223,2021-11-16 15:39:23 UTC
787783,mainnet,248,107136000,107186875,50876,46754,4122,0.08102052048116991,2021-11-16 15:40:54 UTC
787784,mainnet,248,107136000,107186988,50989,46863,4126,0.08091941399125302,2021-11-16 15:42:25 UTC
787786,mainnet,248,107136000,107187224,51225,47077,4148,0.08097608589555881,2021-11-16 15:43:55 UTC
787787,mainnet,248,107136000,107187395,51396,47242,4154,0.08082341038213091,2021-11-16 15:45:30 UTC
787789,mainnet,248,107136000,107187576,51577,47409,4168,0.08081121430094809,2021-11-16 15:47:11 UTC
787790,mainnet,248,107136000,107187755,51756,47574,4182,0.0808022258288894,2021-11-16 15:48:51 UTC
787792,mainnet,248,107136000,107187943,51944,47755,4189,0.08064454027414138,2021-11-16 15:50:35 UTC
787793,mainnet,248,107136000,107188121,52122,47917,4205,0.0806761060588619,2021-11-16 15:52:15 UTC
787795,mainnet,248,107136000,107188290,52291,48073,4218,0.08066397659253026,2021-11-16 15:53:48 UTC
787796,mainnet,248,107136000,107188500,52501,48258,4243,0.08081750823793832,2021-11-16 15:55:31 UTC
787798,mainnet,248,107136000,107188674,52675,48407,4268,0.0810251542477456,2021-11-16 15:57:01 UTC
787799,mainnet,248,107136000,107188844,52845,48550,4295,0.08127542813889678,2021-11-16 15:58:28 UTC
787801,mainnet,248,107136000,107188995,52996,48689,4307,0.08127028454977735,2021-11-16 15:59:58 UTC
787802,mainnet,248,107136000,107189184,53185,48868,4317,0.08116950267932688,2021-11-16 16:01:48 UTC
787804,mainnet,248,107136000,107189391,53392,49054,4338,0.08124812706023374,2021-11-16 16:03:49 UTC
787805,mainnet,248,107136000,107189533,53534,49190,4344,0.08114469309224044,2021-11-16 16:05:21 UTC
787807,mainnet,248,107136000,107189698,53699,49337,4362,0.08123056295275517,2021-11-16 16:06:52 UTC
787809,mainnet,248,107136000,107189874,53875,49506,4369,0.08109512761020882,2021-11-16 16:08:41 UTC
787810,mainnet,248,107136000,107190042,54043,49668,4375,0.08095405510426883,2021-11-16 16:10:17 UTC
787812,mainnet,248,107136000,107190201,54202,49815,4387,0.08093797276853253,2021-11-16 16:11:47 UTC
787813,mainnet,248,107136000,107190377,54378,49974,4404,0.08098863510978704,2021-11-16 16:13:18 UTC
787815,mainnet,248,107136000,107190553,54554,50140,4414,0.08091065733035158,2021-11-16 16:14:51 UTC
787816,mainnet,248,107136000,107190723,54724,50293,4431,0.08096995833637892,2021-11-16 16:16:21 UTC
787818,mainnet,248,107136000,107190880,54881,50444,4437,0.08084765219292651,2021-11-16 16:17:56 UTC
787819,mainnet,248,107136000,107191080,55081,50612,4469,0.08113505564532235,2021-11-16 16:20:07 UTC
787821,mainnet,248,107136000,107191311,55312,50822,4490,0.08117587503615852,2021-11-16 16:21:38 UTC
787822,mainnet,248,107136000,107191513,55514,51022,4492,0.08091652556111972,2021-11-16 16:23:28 UTC
787824,mainnet,248,107136000,107191727,55728,51209,4519,0.08109029572207867,2021-11-16 16:25:27 UTC
787825,mainnet,248,107136000,107191876,55877,51340,4537,0.08119619879377919,2021-11-16 16:26:59 UTC
787827,mainnet,248,107136000,107192220,56221,51642,4579,0.08144643460628591,2021-11-16 16:29:57 UTC
787829,mainnet,248,107136000,107192400,56401,51817,4584,0.08127515469583872,2021-11-16 16:31:32 UTC
787830,mainnet,248,107136000,107192567,56568,51982,4586,0.08107056993353133,2021-11-16 16:33:02 UTC
787832,mainnet,248,107136000,107192730,56731,52138,4593,0.08096102659921384,2021-11-16 16:34:32 UTC
787833,mainnet,248,107136000,107192911,56912,52315,4597,0.08077382625808266,2021-11-16 16:36:04 UTC
787835,mainnet,248,107136000,107193084,57085,52479,4606,0.08068669527896996,2021-11-16 16:37:32 UTC
787836,mainnet,248,107136000,107193275,57276,52653,4623,0.08071443536559815,2021-11-16 16:39:05 UTC
787838,mainnet,248,107136000,107193436,57437,52812,4625,0.08052300781726066,2021-11-16 16:40:33 UTC
787839,mainnet,248,107136000,107193600,57601,52955,4646,0.0806583219041336,2021-11-16 16:42:06 UTC
787841,mainnet,248,107136000,107193771,57772,53112,4660,0.08066191234508066,2021-11-16 16:43:35 UTC
787842,mainnet,248,107136000,107193943,57944,53274,4670,0.08059505729670026,2021-11-16 16:45:09 UTC
787844,mainnet,248,107136000,107194109,58110,53425,4685,0.08062295646188264,2021-11-16 16:46:39 UTC
787845,mainnet,248,107136000,107194287,58288,53593,4695,0.08054831183090859,2021-11-16 16:48:14 UTC
787847,mainnet,248,107136000,107194488,58489,53788,4701,0.08037408743524424,2021-11-16 16:49:54 UTC
787848,mainnet,248,107136000,107194652,58653,53951,4702,0.08016640240055922,2021-11-16 16:51:28 UTC
787849,mainnet,248,107136000,107194819,58820,54105,4715,0.08015980958857531,2021-11-16 16:53:02 UTC
787851,mainnet,248,107136000,107195005,59006,54278,4728,0.08012744466664407,2021-11-16 16:54:33 UTC
787852,mainnet,248,107136000,107195178,59179,54445,4734,0.07999459267645617,2021-11-16 16:56:14 UTC
787854,mainnet,248,107136000,107195392,59393,54618,4775,0.0803966797434041,2021-11-16 16:57:43 UTC
787855,mainnet,248,107136000,107195567,59568,54793,4775,0.08016048885307547,2021-11-16 16:59:17 UTC
787857,mainnet,248,107136000,107195738,59739,54956,4783,0.08006494919566783,2021-11-16 17:00:54 UTC
787858,mainnet,248,107136000,107195900,59901,55103,4798,0.08009882973573063,2021-11-16 17:02:27 UTC
787860,mainnet,248,107136000,107196053,60054,55247,4807,0.08004462650281413,2021-11-16 17:03:55 UTC
787861,mainnet,248,107136000,107196247,60248,55430,4818,0.07996945956712256,2021-11-16 17:05:25 UTC
787863,mainnet,248,107136000,107196429,60430,55602,4828,0.0798940923382426,2021-11-16 17:07:05 UTC
787864,mainnet,248,107136000,107196614,60615,55770,4845,0.07993071022024252,2021-11-16 17:08:49 UTC
787866,mainnet,248,107136000,107196794,60795,55942,4853,0.07982564355621351,2021-11-16 17:10:21 UTC
787867,mainnet,248,107136000,107196992,60993,56138,4855,0.0795992982801305,2021-11-16 17:12:01 UTC
787869,mainnet,248,107136000,107197179,61180,56309,4871,0.07961752206603465,2021-11-16 17:13:41 UTC
787870,mainnet,248,107136000,107197376,61377,56489,4888,0.07963895270215227,2021-11-16 17:15:13 UTC
787872,mainnet,248,107136000,107197552,61553,56647,4906,0.07970367000796062,2021-11-16 17:16:46 UTC
787873,mainnet,248,107136000,107197736,61737,56823,4914,0.07959570435881239,2021-11-16 17:18:18 UTC
787875,mainnet,248,107136000,107197897,61898,56984,4914,0.07938867168567644,2021-11-16 17:19:46 UTC
787876,mainnet,248,107136000,107198068,62069,57149,4920,0.0792666226296541,2021-11-16 17:21:17 UTC
787878,mainnet,248,107136000,107198226,62227,57288,4939,0.07937069117907018,2021-11-16 17:22:57 UTC
787879,mainnet,248,107136000,107198416,62417,57449,4968,0.07959370043417659,2021-11-16 17:24:37 UTC
787881,mainnet,248,107136000,107198613,62614,57638,4976,0.07947104481425879,2021-11-16 17:26:10 UTC
787882,mainnet,248,107136000,107198806,62807,57824,4983,0.0793382903179582,2021-11-16 17:27:50 UTC
787884,mainnet,248,107136000,107198990,62991,57995,4996,0.07931291771840422,2021-11-16 17:29:23 UTC
787885,mainnet,248,107136000,107199154,63155,58155,5000,0.07917029530520149,2021-11-16 17:30:54 UTC
787887,mainnet,248,107136000,107199318,63319,58310,5009,0.07910737693267424,2021-11-16 17:32:36 UTC
787888,mainnet,248,107136000,107199534,63535,58517,5018,0.07898008971433068,2021-11-16 17:34:18 UTC
787889,mainnet,248,107136000,107199708,63709,58686,5023,0.07884286364563876,2021-11-16 17:35:57 UTC
787891,mainnet,248,107136000,107199883,63884,58847,5037,0.07884603343560202,2021-11-16 17:37:26 UTC
787892,mainnet,248,107136000,107200023,64024,58977,5047,0.07882981381981757,2021-11-16 17:38:54 UTC
787894,mainnet,248,107136000,107200223,64224,59160,5064,0.0788490284005979,2021-11-16 17:40:29 UTC
787895,mainnet,248,107136000,107200418,64419,59342,5077,0.07881215169437589,2021-11-16 17:42:08 UTC
787897,mainnet,248,107136000,107200655,64656,59576,5080,0.07856966097500619,2021-11-16 17:44:26 UTC
787899,mainnet,248,107136000,107200847,64848,59743,5105,0.07872255119664447,2021-11-16 17:46:05 UTC
787900,mainnet,248,107136000,107201010,65011,59890,5121,0.07877128485948531,2021-11-16 17:47:40 UTC
787902,mainnet,248,107136000,107201180,65181,60054,5127,0.07865789110323561,2021-11-16 17:49:13 UTC
787903,mainnet,248,107136000,107201359,65360,60216,5144,0.07870257037943697,2021-11-16 17:50:43 UTC
787905,mainnet,248,107136000,107201506,65507,60350,5157,0.07872441113163478,2021-11-16 17:52:09 UTC
787906,mainnet,248,107136000,107201730,65731,60557,5174,0.07871476168018135,2021-11-16 17:53:58 UTC
787908,mainnet,248,107136000,107201917,65918,60724,5194,0.07879486634910039,2021-11-16 17:55:29 UTC
787909,mainnet,248,107136000,107202081,66082,60880,5202,0.07872037771253897,2021-11-16 17:56:56 UTC
787910,mainnet,248,107136000,107202261,66262,61044,5218,0.07874800036219855,2021-11-16 17:58:29 UTC
787912,mainnet,248,107136000,107202430,66431,61195,5236,0.07881862383525763,2021-11-16 17:59:58 UTC
787913,mainnet,248,107136000,107202604,66605,61368,5237,0.07862773065085203,2021-11-16 18:01:33 UTC
787915,mainnet,248,107136000,107202759,66760,61508,5252,0.0786698621929299,2021-11-16 18:03:07 UTC
787916,mainnet,248,107136000,107202955,66956,61689,5267,0.07866359997610371,2021-11-16 18:04:48 UTC
787918,mainnet,248,107136000,107203124,67125,61853,5272,0.07854003724394786,2021-11-16 18:06:17 UTC
787919,mainnet,248,107136000,107203287,67288,61993,5295,0.07869159434074427,2021-11-16 18:07:48 UTC
787921,mainnet,248,107136000,107203470,67471,62172,5299,0.07853744571741933,2021-11-16 18:09:28 UTC
787922,mainnet,248,107136000,107203652,67653,62342,5311,0.07850354012386739,2021-11-16 18:11:02 UTC
787924,mainnet,248,107136000,107203843,67844,62526,5318,0.07838570838983551,2021-11-16 18:12:41 UTC
787925,mainnet,248,107136000,107204027,68028,62702,5326,0.07829129182101488,2021-11-16 18:14:17 UTC
787927,mainnet,248,107136000,107204201,68202,62875,5327,0.0781062138940207,2021-11-16 18:15:46 UTC
787928,mainnet,248,107136000,107204386,68387,63048,5339,0.07807039349583986,2021-11-16 18:17:16 UTC
787930,mainnet,248,107136000,107204566,68567,63218,5349,0.07801128822903146,2021-11-16 18:18:46 UTC
787931,mainnet,248,107136000,107204734,68735,63381,5354,0.07789335855095657,2021-11-16 18:20:14 UTC
787933,mainnet,248,107136000,107204900,68901,63545,5356,0.07773472083133771,2021-11-16 18:21:45 UTC
787934,mainnet,248,107136000,107205072,69073,63715,5358,0.0775701069882588,2021-11-16 18:23:16 UTC
787936,mainnet,248,107136000,107205247,69248,63882,5366,0.07748960258780037,2021-11-16 18:24:45 UTC
787937,mainnet,248,107136000,107205423,69424,64055,5369,0.07733636782668818,2021-11-16 18:26:17 UTC
787939,mainnet,248,107136000,107205585,69586,64207,5379,0.07730003161555485,2021-11-16 18:27:44 UTC
787940,mainnet,248,107136000,107205775,69776,64388,5388,0.07721852786058243,2021-11-16 18:29:17 UTC
787941,mainnet,248,107136000,107205936,69937,64543,5394,0.07712655675822526,2021-11-16 18:30:49 UTC
787943,mainnet,248,107136000,107206106,70107,64712,5395,0.07695379919266264,2021-11-16 18:32:22 UTC
787944,mainnet,248,107136000,107206314,70315,64900,5415,0.07701059517883808,2021-11-16 18:33:52 UTC
787946,mainnet,248,107136000,107206488,70489,65070,5419,0.07687724325781328,2021-11-16 18:35:22 UTC
787947,mainnet,248,107136000,107206668,70669,65240,5429,0.07682293509176584,2021-11-16 18:36:54 UTC
787949,mainnet,248,107136000,107206841,70842,65401,5441,0.0768047203636261,2021-11-16 18:38:27 UTC
787950,mainnet,248,107136000,107207022,71023,65572,5451,0.07674978528082452,2021-11-16 18:40:01 UTC
787952,mainnet,248,107136000,107207195,71196,65731,5465,0.07675993033316479,2021-11-16 18:41:42 UTC
787953,mainnet,248,107136000,107207385,71386,65905,5481,0.07677976073739949,2021-11-16 18:43:26 UTC
787955,mainnet,248,107136000,107207591,71592,66103,5489,0.0766705777181808,2021-11-16 18:45:07 UTC
787956,mainnet,248,107136000,107207757,71758,66264,5494,0.07656289194236182,2021-11-16 18:46:39 UTC
787958,mainnet,248,107136000,107207919,71920,66405,5515,0.07668242491657397,2021-11-16 18:48:12 UTC
787959,mainnet,248,107136000,107208087,72088,66556,5532,0.0767395405615359,2021-11-16 18:49:43 UTC
787961,mainnet,248,107136000,107208260,72261,66712,5549,0.07679107679107679,2021-11-16 18:51:14 UTC
787962,mainnet,248,107136000,107208420,72421,66868,5553,0.07667665456152221,2021-11-16 18:52:58 UTC
787964,mainnet,248,107136000,107208623,72624,67053,5571,0.07671017845340383,2021-11-16 18:54:28 UTC
787965,mainnet,248,107136000,107208819,72820,67236,5584,0.0766822301565504,2021-11-16 18:56:00 UTC
787967,mainnet,248,107136000,107209003,73004,67420,5584,0.07648895950906799,2021-11-16 18:57:30 UTC
787968,mainnet,248,107136000,107209179,73180,67586,5594,0.0764416507242416,2021-11-16 18:59:00 UTC
787970,mainnet,248,107136000,107209349,73350,67749,5601,0.076359918200409,2021-11-16 19:00:35 UTC
787971,mainnet,248,107136000,107209509,73510,67893,5617,0.07641137260236702,2021-11-16 19:02:18 UTC
787973,mainnet,248,107136000,107209768,73769,68139,5630,0.07631932112404939,2021-11-16 19:04:33 UTC
787975,mainnet,248,107136000,107209963,73964,68312,5652,0.07641555351251961,2021-11-16 19:06:18 UTC
787976,mainnet,248,107136000,107210132,74133,68476,5657,0.07630879635250158,2021-11-16 19:08:20 UTC
787978,mainnet,248,107136000,107210348,74349,68686,5663,0.07616780319842903,2021-11-16 19:09:56 UTC
787979,mainnet,248,107136000,107210540,74541,68861,5680,0.07619967534645362,2021-11-16 19:11:36 UTC
787981,mainnet,248,107136000,107210744,74745,69060,5685,0.07605859923740718,2021-11-16 19:13:28 UTC
787983,mainnet,248,107136000,107210915,74916,69213,5703,0.07612526029152651,2021-11-16 19:14:58 UTC
787984,mainnet,248,107136000,107211103,75104,69389,5715,0.07609448231785258,2021-11-16 19:16:38 UTC
787986,mainnet,248,107136000,107211294,75295,69563,5732,0.07612723288398963,2021-11-16 19:18:09 UTC
787987,mainnet,248,107136000,107211490,75491,69734,5757,0.07626074631413016,2021-11-16 19:20:02 UTC
787989,mainnet,248,107136000,107211703,75704,69931,5773,0.07625752932473845,2021-11-16 19:21:36 UTC
787990,mainnet,248,107136000,107211930,75931,70154,5777,0.07608223255323912,2021-11-16 19:23:36 UTC
787992,mainnet,248,107136000,107212108,76109,70327,5782,0.07596999040849309,2021-11-16 19:25:07 UTC
787994,mainnet,248,107136000,107212359,76360,70569,5791,0.07583813514929283,2021-11-16 19:27:17 UTC
787995,mainnet,248,107136000,107212544,76545,70745,5800,0.0757724214514338,2021-11-16 19:28:49 UTC
787997,mainnet,248,107136000,107212716,76717,70916,5801,0.07561557412307572,2021-11-16 19:30:22 UTC
787998,mainnet,248,107136000,107212891,76892,71085,5807,0.07552151069031889,2021-11-16 19:31:54 UTC
787999,mainnet,248,107136000,107213052,77053,71237,5816,0.0754805134128457,2021-11-16 19:33:29 UTC
788001,mainnet,248,107136000,107213225,77226,71402,5824,0.07541501566829824,2021-11-16 19:35:06 UTC
788002,mainnet,248,107136000,107213425,77426,71595,5831,0.07531061917185441,2021-11-16 19:36:50 UTC
788004,mainnet,248,107136000,107213617,77618,71777,5841,0.07525316292612538,2021-11-16 19:38:28 UTC
788005,mainnet,248,107136000,107213773,77774,71925,5849,0.0752050813896675,2021-11-16 19:39:59 UTC
788007,mainnet,248,107136000,107213971,77972,72114,5858,0.07512953367875648,2021-11-16 19:41:44 UTC
788008,mainnet,248,107136000,107214154,78155,72288,5867,0.07506877359094108,2021-11-16 19:43:23 UTC
788010,mainnet,248,107136000,107214333,78334,72455,5879,0.07505042510276508,2021-11-16 19:44:56 UTC
788011,mainnet,248,107136000,107214504,78505,72616,5889,0.07501433029743329,2021-11-16 19:46:30 UTC
788013,mainnet,248,107136000,107214697,78698,72791,5907,0.07505908663498437,2021-11-16 19:48:24 UTC
788014,mainnet,248,107136000,107214868,78869,72944,5925,0.07512457366011994,2021-11-16 19:49:58 UTC
788016,mainnet,248,107136000,107215052,79053,73107,5946,0.07521536184585025,2021-11-16 19:51:34 UTC
788017,mainnet,248,107136000,107215242,79243,73287,5956,0.07516121297780246,2021-11-16 19:53:12 UTC
788019,mainnet,248,107136000,107215425,79426,73453,5973,0.07520207488731649,2021-11-16 19:54:49 UTC
788020,mainnet,248,107136000,107215602,79603,73623,5980,0.07512279687951459,2021-11-16 19:56:27 UTC
788022,mainnet,248,107136000,107215766,79767,73777,5990,0.07509371043163213,2021-11-16 19:58:00 UTC
788023,mainnet,248,107136000,107215932,79933,73925,6008,0.07516294896976218,2021-11-16 19:59:32 UTC
788025,mainnet,248,107136000,107216157,80158,74131,6027,0.07518900172159984,2021-11-16 20:01:34 UTC
788026,mainnet,248,107136000,107216340,80341,74302,6039,0.07516710023524725,2021-11-16 20:03:21 UTC
788028,mainnet,248,107136000,107216535,80536,74470,6066,0.07532035363067448,2021-11-16 20:04:54 UTC
788029,mainnet,248,107136000,107216710,80711,74628,6083,0.07536766983434724,2021-11-16 20:06:30 UTC
788031,mainnet,248,107136000,107216880,80881,74788,6093,0.07533289647754107,2021-11-16 20:08:02 UTC
788032,mainnet,248,107136000,107217046,81047,74946,6101,0.07527730822855874,2021-11-16 20:09:40 UTC
788034,mainnet,248,107136000,107217224,81225,75114,6111,0.07523545706371192,2021-11-16 20:11:14 UTC
788035,mainnet,248,107136000,107217379,81380,75260,6120,0.07520275251904644,2021-11-16 20:12:45 UTC
788037,mainnet,248,107136000,107217557,81558,75420,6138,0.07525932465239461,2021-11-16 20:14:17 UTC
788038,mainnet,248,107136000,107217718,81719,75557,6162,0.0754047406355927,2021-11-16 20:15:55 UTC
788040,mainnet,248,107136000,107217879,81880,75707,6173,0.07539081582804104,2021-11-16 20:17:28 UTC
788041,mainnet,248,107136000,107218044,82045,75861,6184,0.07537327076604303,2021-11-16 20:19:04 UTC
788043,mainnet,248,107136000,107218254,82255,76063,6192,0.07527809859583004,2021-11-16 20:20:51 UTC
788044,mainnet,248,107136000,107218453,82454,76235,6219,0.07542387270478085,2021-11-16 20:22:35 UTC
788046,mainnet,248,107136000,107218647,82648,76423,6225,0.07531942696737973,2021-11-16 20:24:15 UTC
788047,mainnet,248,107136000,107218815,82816,76584,6232,0.07525115919629057,2021-11-16 20:25:51 UTC
788049,mainnet,248,107136000,107218967,82968,76735,6233,0.07512534953234982,2021-11-16 20:27:23 UTC
788050,mainnet,248,107136000,107219131,83132,76882,6250,0.07518163883943607,2021-11-16 20:28:57 UTC
788052,mainnet,248,107136000,107219315,83316,77048,6268,0.07523164818282203,2021-11-16 20:30:41 UTC
788053,mainnet,248,107136000,107219474,83475,77198,6277,0.07519616651692124,2021-11-16 20:32:17 UTC
788055,mainnet,248,107136000,107219626,83627,77345,6282,0.0751192796584835,2021-11-16 20:33:54 UTC
788056,mainnet,248,107136000,107219894,83895,77579,6316,0.07528458191787353,2021-11-16 20:36:09 UTC
788058,mainnet,248,107136000,107220030,84031,77709,6322,0.07523413978174721,2021-11-16 20:37:36 UTC
788059,mainnet,248,107136000,107220169,84170,77833,6337,0.07528810740168707,2021-11-16 20:39:03 UTC
788061,mainnet,248,107136000,107220331,84332,77967,6365,0.07547550158895792,2021-11-16 20:40:53 UTC
788062,mainnet,248,107136000,107220514,84515,78121,6394,0.07565520913447317,2021-11-16 20:42:22 UTC
788064,mainnet,248,107136000,107220672,84673,78272,6401,0.07559670733291604,2021-11-16 20:43:51 UTC
788065,mainnet,248,107136000,107220850,84851,78443,6408,0.07552061849595172,2021-11-16 20:45:42 UTC
788067,mainnet,248,107136000,107221029,85030,78611,6419,0.07549100317534987,2021-11-16 20:47:24 UTC
788068,mainnet,248,107136000,107221234,85235,78782,6453,0.07570833577755617,2021-11-16 20:49:18 UTC
788070,mainnet,248,107136000,107221404,85405,78938,6467,0.07572156196943973,2021-11-16 20:50:45 UTC
788071,mainnet,248,107136000,107221559,85560,79058,6502,0.0759934548854605,2021-11-16 20:52:14 UTC
788073,mainnet,248,107136000,107221708,85709,79192,6517,0.07603635557526048,2021-11-16 20:53:42 UTC
788074,mainnet,248,107136000,107221916,85917,79377,6540,0.0761199762561542,2021-11-16 20:55:32 UTC
788076,mainnet,248,107136000,107222111,86112,79558,6554,0.07611018208844296,2021-11-16 20:57:22 UTC
788077,mainnet,248,107136000,107222274,86275,79710,6565,0.07609388583019415,2021-11-16 20:58:51 UTC
788079,mainnet,248,107136000,107222494,86495,79912,6583,0.07610844557488872,2021-11-16 21:00:24 UTC
788080,mainnet,248,107136000,107222636,86637,80041,6596,0.07613375347715179,2021-11-16 21:01:54 UTC
788082,mainnet,248,107136000,107222807,86808,80200,6608,0.07612201640401807,2021-11-16 21:03:23 UTC
788083,mainnet,248,107136000,107222949,86950,80312,6638,0.07634272570442784,2021-11-16 21:04:53 UTC
788085,mainnet,248,107136000,107223086,87087,80423,6664,0.07652117996945583,2021-11-16 21:06:23 UTC
788086,mainnet,248,107136000,107223232,87233,80555,6678,0.07655359783568146,2021-11-16 21:07:50 UTC
788088,mainnet,248,107136000,107223352,87353,80656,6697,0.07666594163909654,2021-11-16 21:09:17 UTC
788089,mainnet,248,107136000,107223468,87469,80746,6723,0.07686151665161371,2021-11-16 21:10:47 UTC
788091,mainnet,248,107136000,107223696,87697,80951,6746,0.07692395406912438,2021-11-16 21:12:13 UTC
788092,mainnet,248,107136000,107223858,87859,81084,6775,0.07711219112441525,2021-11-16 21:13:51 UTC
788094,mainnet,248,107136000,107224020,88021,81238,6783,0.07706115586053328,2021-11-16 21:15:23 UTC
788095,mainnet,248,107136000,107224158,88159,81367,6792,0.07704261618212548,2021-11-16 21:16:57 UTC
788097,mainnet,248,107136000,107224341,88342,81516,6826,0.07726789069751647,2021-11-16 21:18:36 UTC
788098,mainnet,248,107136000,107224503,88504,81671,6833,0.07720555003163698,2021-11-16 21:20:05 UTC
788100,mainnet,248,107136000,107224658,88659,81812,6847,0.07722848216199145,2021-11-16 21:21:37 UTC
788101,mainnet,248,107136000,107224830,88831,81964,6867,0.07730409429140728,2021-11-16 21:23:07 UTC
788102,mainnet,248,107136000,107225012,89013,82135,6878,0.07726961230382079,2021-11-16 21:24:38 UTC
788104,mainnet,248,107136000,107225199,89200,82318,6882,0.077152466367713,2021-11-16 21:26:17 UTC
788105,mainnet,248,107136000,107225346,89347,82463,6884,0.0770479143116165,2021-11-16 21:27:45 UTC
788107,mainnet,248,107136000,107225514,89515,82626,6889,0.07695916885438195,2021-11-16 21:29:14 UTC
788108,mainnet,248,107136000,107225703,89704,82797,6907,0.07699768126281994,2021-11-16 21:30:50 UTC
788110,mainnet,248,107136000,107225859,89860,82944,6916,0.07696416648119296,2021-11-16 21:32:19 UTC
788111,mainnet,248,107136000,107226054,90055,83125,6930,0.0769529731830548,2021-11-16 21:34:00 UTC
788113,mainnet,248,107136000,107226231,90232,83295,6937,0.07687959925525313,2021-11-16 21:35:31 UTC
788114,mainnet,248,107136000,107226400,90401,83454,6947,0.07684649506089535,2021-11-16 21:37:00 UTC
788116,mainnet,248,107136000,107226579,90580,83624,6956,0.07679399425921837,2021-11-16 21:38:29 UTC
788117,mainnet,248,107136000,107226752,90753,83791,6962,0.07671371745286658,2021-11-16 21:39:59 UTC
788119,mainnet,248,107136000,107226936,90937,83966,6971,0.07665746615788953,2021-11-16 21:41:31 UTC
788120,mainnet,248,107136000,107227111,91112,84108,7004,0.07687242075687066,2021-11-16 21:43:02 UTC
788122,mainnet,248,107136000,107227269,91270,84253,7017,0.07688177933603593,2021-11-16 21:44:33 UTC
788123,mainnet,248,107136000,107227449,91450,84422,7028,0.07685073810825588,2021-11-16 21:46:11 UTC
788125,mainnet,248,107136000,107227607,91608,84576,7032,0.07676185485983757,2021-11-16 21:47:42 UTC
788126,mainnet,248,107136000,107227801,91802,84753,7049,0.07678481950284308,2021-11-16 21:49:12 UTC
788128,mainnet,248,107136000,107227962,91963,84908,7055,0.07671563563607103,2021-11-16 21:50:39 UTC
788129,mainnet,248,107136000,107228132,92133,85066,7067,0.07670432961045445,2021-11-16 21:52:08 UTC
788131,mainnet,248,107136000,107228324,92325,85240,7085,0.07673977795829949,2021-11-16 21:53:36 UTC
788132,mainnet,248,107136000,107228504,92505,85420,7085,0.07659045457002324,2021-11-16 21:55:07 UTC
788134,mainnet,248,107136000,107228686,92687,85587,7100,0.07660189670611844,2021-11-16 21:56:39 UTC
788135,mainnet,248,107136000,107228852,92853,85751,7102,0.07648648939721926,2021-11-16 21:58:09 UTC
788137,mainnet,248,107136000,107229022,93023,85904,7119,0.07652946045601626,2021-11-16 21:59:41 UTC
788138,mainnet,248,107136000,107229181,93182,86054,7128,0.07649546049666245,2021-11-16 22:01:23 UTC
788140,mainnet,248,107136000,107229336,93337,86187,7150,0.07660413340904465,2021-11-16 22:02:55 UTC
788141,mainnet,248,107136000,107229497,93498,86331,7167,0.07665404607585188,2021-11-16 22:04:26 UTC
788143,mainnet,248,107136000,107229725,93726,86532,7194,0.07675564944625825,2021-11-16 22:06:25 UTC
788144,mainnet,248,107136000,107229967,93968,86753,7215,0.07678145751745274,2021-11-16 22:08:32 UTC
788146,mainnet,248,107136000,107230175,94176,86944,7232,0.07679238871899423,2021-11-16 22:10:51 UTC
788148,mainnet,248,107136000,107230471,94472,87226,7246,0.07669997459564738,2021-11-16 22:12:48 UTC
788149,mainnet,248,107136000,107230718,94719,87468,7251,0.07655275076806131,2021-11-16 22:14:58 UTC
788151,mainnet,248,107136000,107230894,94895,87631,7264,0.07654776331735076,2021-11-16 22:16:28 UTC
788152,mainnet,248,107136000,107231096,95097,87816,7281,0.0765639294614972,2021-11-16 22:18:14 UTC
788154,mainnet,248,107136000,107231260,95261,87975,7286,0.07648460545238871,2021-11-16 22:19:54 UTC
788155,mainnet,248,107136000,107231462,95463,88169,7294,0.0764065658946398,2021-11-16 22:21:26 UTC
788157,mainnet,248,107136000,107231664,95665,88363,7302,0.07632885590341296,2021-11-16 22:23:16 UTC
788158,mainnet,248,107136000,107231854,95855,88547,7308,0.0762401543998748,2021-11-16 22:24:44 UTC
788160,mainnet,248,107136000,107232030,96031,88717,7314,0.07616290572835856,2021-11-16 22:26:16 UTC
788161,mainnet,248,107136000,107232219,96220,88895,7325,0.07612762419455414,2021-11-16 22:27:55 UTC
788163,mainnet,248,107136000,107232389,96390,89056,7334,0.07608673098869177,2021-11-16 22:29:28 UTC
788164,mainnet,248,107136000,107232582,96583,89245,7338,0.07597610345505938,2021-11-16 22:31:01 UTC
788166,mainnet,248,107136000,107232787,96788,89432,7356,0.076001157168244,2021-11-16 22:32:38 UTC
788167,mainnet,248,107136000,107232962,96963,89597,7366,0.07596712147932716,2021-11-16 22:34:07 UTC
788169,mainnet,248,107136000,107233129,97130,89760,7370,0.07587768969422423,2021-11-16 22:35:38 UTC
788170,mainnet,248,107136000,107233310,97311,89928,7383,0.07587014828744952,2021-11-16 22:37:12 UTC
788172,mainnet,248,107136000,107233475,97476,90091,7385,0.07576223891009069,2021-11-16 22:38:43 UTC
788173,mainnet,248,107136000,107233653,97654,90263,7391,0.07568558379585065,2021-11-16 22:40:24 UTC
788175,mainnet,248,107136000,107233806,97807,90407,7400,0.0756592063962702,2021-11-16 22:41:52 UTC
788176,mainnet,248,107136000,107233969,97970,90565,7405,0.07558436255996734,2021-11-16 22:43:21 UTC
788178,mainnet,248,107136000,107234167,98168,90753,7415,0.07553377882813136,2021-11-16 22:44:56 UTC
788179,mainnet,248,107136000,107234382,98383,90947,7436,0.07558216358517224,2021-11-16 22:46:35 UTC
788181,mainnet,248,107136000,107234616,98617,91144,7473,0.07577800987659329,2021-11-16 22:48:05 UTC
788182,mainnet,248,107136000,107234778,98779,91296,7483,0.07575496816124885,2021-11-16 22:49:33 UTC
788184,mainnet,248,107136000,107234951,98952,91466,7486,0.07565284178187404,2021-11-16 22:51:04 UTC
788185,mainnet,248,107136000,107235125,99126,91637,7489,0.07555030970683776,2021-11-16 22:52:45 UTC
788187,mainnet,248,107136000,107235341,99342,91836,7506,0.07555716615328864,2021-11-16 22:54:19 UTC
788188,mainnet,248,107136000,107235519,99520,92009,7511,0.07547226688102894,2021-11-16 22:55:51 UTC
788190,mainnet,248,107136000,107235688,99689,92169,7520,0.07543460161101025,2021-11-16 22:57:32 UTC
788191,mainnet,248,107136000,107235881,99882,92351,7531,0.07539897078552692,2021-11-16 22:58:59 UTC
788193,mainnet,248,107136000,107236082,100083,92548,7535,0.07528751136556658,2021-11-16 23:00:39 UTC
788194,mainnet,248,107136000,107236260,100261,92720,7541,0.07521369226319306,2021-11-16 23:02:11 UTC
788196,mainnet,248,107136000,107236434,100435,92885,7550,0.07517299746104446,2021-11-16 23:03:41 UTC
788197,mainnet,248,107136000,107236596,100597,93038,7559,0.07514140580733024,2021-11-16 23:05:09 UTC
788199,mainnet,248,107136000,107236758,100759,93193,7566,0.07509006639605395,2021-11-16 23:06:36 UTC
788200,mainnet,248,107136000,107236928,100929,93355,7574,0.07504285190579517,2021-11-16 23:08:05 UTC
788201,mainnet,248,107136000,107237085,101086,93508,7578,0.0749658706447975,2021-11-16 23:09:31 UTC
788203,mainnet,248,107136000,107237313,101314,93731,7583,0.07484651676964683,2021-11-16 23:11:26 UTC
788205,mainnet,248,107136000,107237500,101501,93910,7591,0.07478744051782742,2021-11-16 23:13:06 UTC
788206,mainnet,248,107136000,107237681,101682,94066,7616,0.07490017898939832,2021-11-16 23:14:48 UTC
788208,mainnet,248,107136000,107237867,101868,94237,7631,0.07491066870852475,2021-11-16 23:16:18 UTC
788209,mainnet,248,107136000,107238048,102049,94404,7645,0.07491499181765622,2021-11-16 23:17:49 UTC
788211,mainnet,248,107136000,107238212,102213,94564,7649,0.0748339252345592,2021-11-16 23:19:22 UTC
788212,mainnet,248,107136000,107238407,102408,94739,7669,0.0748867275994063,2021-11-16 23:20:54 UTC
788213,mainnet,248,107136000,107238571,102572,94893,7679,0.07486448543462153,2021-11-16 23:22:21 UTC
788215,mainnet,248,107136000,107238748,102749,95051,7698,0.07492043718187039,2021-11-16 23:23:50 UTC
788216,mainnet,248,107136000,107238912,102913,95200,7713,0.07494679972403875,2021-11-16 23:25:20 UTC
788218,mainnet,248,107136000,107239104,103105,95369,7736,0.07503030890839435,2021-11-16 23:27:03 UTC
788219,mainnet,248,107136000,107239274,103275,95527,7748,0.07502299685306221,2021-11-16 23:28:33 UTC
788221,mainnet,248,107136000,107239438,103439,95675,7764,0.07505873026614719,2021-11-16 23:30:02 UTC
788222,mainnet,248,107136000,107239644,103645,95863,7782,0.0750832167494814,2021-11-16 23:31:43 UTC
788224,mainnet,248,107136000,107239812,103813,96021,7792,0.07505803704738327,2021-11-16 23:33:14 UTC
788225,mainnet,248,107136000,107240001,104002,96205,7797,0.07496971212092075,2021-11-16 23:34:44 UTC
788227,mainnet,248,107136000,107240211,104212,96410,7802,0.07486661804782559,2021-11-16 23:36:35 UTC
788229,mainnet,248,107136000,107240422,104423,96602,7821,0.07489729274202044,2021-11-16 23:38:36 UTC
788230,mainnet,248,107136000,107240638,104639,96814,7825,0.07478091342616042,2021-11-16 23:40:15 UTC
788232,mainnet,248,107136000,107240810,104811,96970,7841,0.07481085000620163,2021-11-16 23:41:52 UTC
788233,mainnet,248,107136000,107240996,104997,97138,7859,0.07484975761212224,2021-11-16 23:43:22 UTC
788235,mainnet,248,107136000,107241199,105200,97338,7862,0.07473384030418251,2021-11-16 23:45:07 UTC
788236,mainnet,248,107136000,107241368,105369,97494,7875,0.07473735159297326,2021-11-16 23:46:33 UTC
788238,mainnet,248,107136000,107241563,105564,97684,7880,0.07464665984615967,2021-11-16 23:48:32 UTC
788239,mainnet,248,107136000,107241773,105774,97879,7895,0.07464027076597274,2021-11-16 23:50:10 UTC
788241,mainnet,248,107136000,107241925,105926,98025,7901,0.07458980797915526,2021-11-16 23:51:40 UTC
788242,mainnet,248,107136000,107242128,106129,98213,7916,0.07458847251929256,2021-11-16 23:53:30 UTC
788244,mainnet,248,107136000,107242288,106289,98373,7916,0.07447619226824977,2021-11-16 23:54:59 UTC
788245,mainnet,248,107136000,107242476,106477,98545,7932,0.07449496135315609,2021-11-16 23:56:30 UTC
788247,mainnet,248,107136000,107242635,106636,98691,7945,0.07450579541618216,2021-11-16 23:57:59 UTC
788248,mainnet,248,107136000,107242796,106797,98842,7955,0.07448711106117213,2021-11-16 23:59:27 UTC
788250,mainnet,248,107136000,107243008,107009,99047,7962,0.07440495659243615,2021-11-17 00:01:23 UTC
788251,mainnet,248,107136000,107243197,107198,99224,7974,0.07438571615142074,2021-11-17 00:03:12 UTC
788253,mainnet,248,107136000,107243363,107364,99369,7995,0.07446630155359338,2021-11-17 00:04:45 UTC
788254,mainnet,248,107136000,107243524,107525,99519,8006,0.07445710299930249,2021-11-17 00:06:16 UTC
788256,mainnet,248,107136000,107243680,107681,99660,8021,0.07448853558195039,2021-11-17 00:07:47 UTC
788257,mainnet,248,107136000,107243847,107848,99814,8034,0.07449373191899711,2021-11-17 00:09:16 UTC
788259,mainnet,248,107136000,107244016,108017,99966,8051,0.07453456400381421,2021-11-17 00:11:03 UTC
788260,mainnet,248,107136000,107244202,108203,100135,8068,0.07456355184237036,2021-11-17 00:12:34 UTC
788261,mainnet,248,107136000,107244365,108366,100290,8076,0.07452522008748132,2021-11-17 00:14:04 UTC
788263,mainnet,248,107136000,107244528,108529,100447,8082,0.07446857521952657,2021-11-17 00:15:34 UTC
788265,mainnet,248,107136000,107244738,108739,100645,8094,0.07443511527602792,2021-11-17 00:17:13 UTC
788266,mainnet,248,107136000,107244903,108904,100807,8097,0.0743498861382502,2021-11-17 00:18:54 UTC
788268,mainnet,248,107136000,107245076,109077,100975,8102,0.07427780375331187,2021-11-17 00:20:33 UTC
788269,mainnet,248,107136000,107245234,109235,101116,8119,0.07432599441570925,2021-11-17 00:22:03 UTC
788271,mainnet,248,107136000,107245439,109440,101317,8123,0.0742233187134503,2021-11-17 00:23:52 UTC
788272,mainnet,248,107136000,107245574,109575,101445,8130,0.07419575633127995,2021-11-17 00:25:19 UTC
788273,mainnet,248,107136000,107245716,109717,101583,8134,0.07413618673496358,2021-11-17 00:26:49 UTC
788275,mainnet,248,107136000,107245894,109895,101744,8151,0.07417079939942672,2021-11-17 00:28:18 UTC
788276,mainnet,248,107136000,107246068,110069,101907,8162,0.07415348554088799,2021-11-17 00:29:48 UTC
788278,mainnet,248,107136000,107246232,110233,102068,8165,0.07407037819890595,2021-11-17 00:31:22 UTC
788279,mainnet,248,107136000,107246395,110396,102217,8179,0.07408782926917643,2021-11-17 00:32:52 UTC
788281,mainnet,248,107136000,107246575,110576,102379,8197,0.0741300101287802,2021-11-17 00:34:31 UTC
788282,mainnet,248,107136000,107246756,110757,102552,8205,0.07408109645440017,2021-11-17 00:36:11 UTC
788284,mainnet,248,107136000,107247090,111091,102872,8219,0.07398439117480264,2021-11-17 00:37:45 UTC
788285,mainnet,248,107136000,107247110,111111,102892,8219,0.07397107397107397,2021-11-17 00:39:16 UTC
788287,mainnet,248,107136000,107247293,111294,103053,8241,0.07404711844304275,2021-11-17 00:40:46 UTC
788288,mainnet,248,107136000,107247456,111457,103202,8255,0.07406443740635402,2021-11-17 00:42:14 UTC
788289,mainnet,248,107136000,107247628,111629,103369,8260,0.07399510879789302,2021-11-17 00:43:43 UTC
788290,mainnet,248,107136000,107247788,111789,103518,8271,0.07398760164237984,2021-11-17 00:45:10 UTC
788292,mainnet,248,107136000,107247948,111949,103654,8295,0.07409624025225772,2021-11-17 00:46:38 UTC
788293,mainnet,248,107136000,107248123,112124,103818,8306,0.0740786985837109,2021-11-17 00:48:10 UTC
788295,mainnet,248,107136000,107248297,112298,103972,8326,0.0741420149958147,2021-11-17 00:49:51 UTC
788296,mainnet,248,107136000,107248483,112484,104151,8333,0.07408164716759717,2021-11-17 00:51:33 UTC
788298,mainnet,248,107136000,107248806,112807,104471,8336,0.07389612346751531,2021-11-17 00:53:04 UTC
788299,mainnet,248,107136000,107249008,113009,104507,8502,0.0752329460485448,2021-11-17 00:54:43 UTC
788301,mainnet,248,107136000,107249196,113197,104843,8354,0.07380054241720187,2021-11-17 00:56:19 UTC
788302,mainnet,248,107136000,107249398,113399,105033,8366,0.07377490101323644,2021-11-17 00:57:59 UTC
788304,mainnet,248,107136000,107249443,113444,105074,8370,0.07378089630125877,2021-11-17 00:59:36 UTC
788305,mainnet,248,107136000,107249797,113798,105412,8386,0.07369198052689854,2021-11-17 01:01:23 UTC
788307,mainnet,248,107136000,107250028,114029,105632,8397,0.07363916196756966,2021-11-17 01:03:16 UTC
788308,mainnet,248,107136000,107250216,114217,105811,8406,0.07359675004596514,2021-11-17 01:04:57 UTC
788310,mainnet,248,107136000,107250426,114427,106008,8419,0.07357529254459175,2021-11-17 01:06:38 UTC
788311,mainnet,248,107136000,107250610,114611,106173,8438,0.07362295067663663,2021-11-17 01:08:20 UTC
788313,mainnet,248,107136000,107250823,114824,106368,8456,0.07364314080679997,2021-11-17 01:10:04 UTC
788314,mainnet,248,107136000,107251042,115043,106574,8469,0.07361595229609798,2021-11-17 01:11:55 UTC
788316,mainnet,248,107136000,107251249,115250,106780,8470,0.07349240780911064,2021-11-17 01:13:50 UTC
788318,mainnet,248,107136000,107251450,115451,106975,8476,0.07341642774856866,2021-11-17 01:15:31 UTC
788319,mainnet,248,107136000,107251685,115686,107198,8488,0.07337102155835624,2021-11-17 01:17:22 UTC
788321,mainnet,248,107136000,107251926,115927,107427,8500,0.07332200436481578,2021-11-17 01:19:20 UTC
788322,mainnet,248,107136000,107252150,116151,107635,8516,0.07331835283381116,2021-11-17 01:21:14 UTC
788324,mainnet,248,107136000,107252359,116360,107838,8522,0.07323822619456859,2021-11-17 01:23:03 UTC
788325,mainnet,248,107136000,107252555,116556,108016,8540,0.07326950135557157,2021-11-17 01:24:56 UTC
788327,mainnet,248,107136000,107252756,116757,108207,8550,0.07322901410622061,2021-11-17 01:26:49 UTC
788328,mainnet,248,107136000,107252937,116938,108377,8561,0.0732097350732867,2021-11-17 01:28:26 UTC
788330,mainnet,248,107136000,107253124,117125,108551,8574,0.07320384204909285,2021-11-17 01:30:03 UTC
788331,mainnet,248,107136000,107253312,117313,108731,8582,0.07315472283549138,2021-11-17 01:31:41 UTC
788333,mainnet,248,107136000,107253510,117511,108922,8589,0.07309102977593587,2021-11-17 01:33:21 UTC
788335,mainnet,248,107136000,107253678,117679,109058,8621,0.073258610287307,2021-11-17 01:34:57 UTC
788336,mainnet,248,107136000,107253864,117865,109227,8638,0.07328723539642812,2021-11-17 01:36:30 UTC
788338,mainnet,248,107136000,107254053,118054,109410,8644,0.07322072949667101,2021-11-17 01:38:06 UTC
788339,mainnet,248,107136000,107254239,118240,109593,8647,0.0731309201623816,2021-11-17 01:39:42 UTC
788341,mainnet,248,107136000,107254431,118432,109780,8652,0.0730545798432856,2021-11-17 01:41:24 UTC
788342,mainnet,248,107136000,107254629,118630,109966,8664,0.0730338025794487,2021-11-17 01:42:59 UTC
788344,mainnet,248,107136000,107254819,118820,110151,8669,0.07295909779498401,2021-11-17 01:44:35 UTC
788345,mainnet,248,107136000,107255009,119010,110338,8672,0.07286782623308966,2021-11-17 01:46:12 UTC
788347,mainnet,248,107136000,107255164,119165,110486,8679,0.07283178785717283,2021-11-17 01:47:47 UTC
788348,mainnet,248,107136000,107255354,119355,110660,8695,0.0728499015541871,2021-11-17 01:49:27 UTC
788350,mainnet,248,107136000,107255537,119538,110835,8703,0.07280530040656527,2021-11-17 01:51:05 UTC
788351,mainnet,248,107136000,107255716,119717,111005,8712,0.07277161973654535,2021-11-17 01:52:41 UTC
788353,mainnet,248,107136000,107255896,119897,111172,8725,0.0727707949323169,2021-11-17 01:54:19 UTC
788354,mainnet,248,107136000,107256080,120081,111351,8730,0.0727009268743598,2021-11-17 01:55:57 UTC
788356,mainnet,248,107136000,107256268,120269,111523,8746,0.07272031861909553,2021-11-17 01:57:34 UTC
788357,mainnet,248,107136000,107256428,120429,111662,8767,0.07279808019663038,2021-11-17 01:59:12 UTC
788359,mainnet,248,107136000,107256613,120614,111828,8786,0.0728439484636941,2021-11-17 02:00:47 UTC
788360,mainnet,248,107136000,107256784,120785,111993,8792,0.07279049550854824,2021-11-17 02:02:23 UTC
788362,mainnet,248,107136000,107256952,120953,112146,8807,0.07281340686051607,2021-11-17 02:03:58 UTC
788363,mainnet,248,107136000,107257109,121110,112288,8822,0.07284287011807447,2021-11-17 02:05:35 UTC
788365,mainnet,248,107136000,107257310,121311,112462,8849,0.07294474532400194,2021-11-17 02:07:10 UTC
788366,mainnet,248,107136000,107257481,121482,112621,8861,0.07294084720370096,2021-11-17 02:08:47 UTC
788368,mainnet,248,107136000,107257680,121681,112806,8875,0.07293661294696789,2021-11-17 02:10:25 UTC
788369,mainnet,248,107136000,107257842,121843,112965,8878,0.07286425974409691,2021-11-17 02:12:02 UTC
788371,mainnet,248,107136000,107258039,122040,113142,8898,0.07291052114060964,2021-11-17 02:13:40 UTC
788372,mainnet,248,107136000,107258243,122244,113335,8909,0.07287883249893655,2021-11-17 02:15:24 UTC
788374,mainnet,248,107136000,107258400,122401,113482,8919,0.07286705173977337,2021-11-17 02:17:00 UTC
788375,mainnet,248,107136000,107258600,122601,113658,8943,0.07294394009836788,2021-11-17 02:18:36 UTC
788377,mainnet,248,107136000,107258774,122775,113818,8957,0.07295459173284463,2021-11-17 02:20:12 UTC
788378,mainnet,248,107136000,107258960,122961,113997,8964,0.07290116378363871,2021-11-17 02:21:52 UTC
788380,mainnet,248,107136000,107259132,123133,114167,8966,0.07281557340436763,2021-11-17 02:23:23 UTC
788381,mainnet,248,107136000,107259293,123294,114323,8971,0.07276104271091861,2021-11-17 02:24:50 UTC
788383,mainnet,248,107136000,107259472,123473,114486,8987,0.07278514331068331,2021-11-17 02:26:30 UTC
788384,mainnet,248,107136000,107259636,123637,114640,8997,0.07276947839239063,2021-11-17 02:27:57 UTC
788386,mainnet,248,107136000,107259736,123737,114732,9005,0.07277532185199254,2021-11-17 02:29:37 UTC
788387,mainnet,248,107136000,107260023,124024,115003,9021,0.0727359220795975,2021-11-17 02:31:09 UTC
788389,mainnet,248,107136000,107260144,124145,115120,9025,0.07269724918442144,2021-11-17 02:32:36 UTC
788390,mainnet,248,107136000,107260359,124360,115264,9096,0.07314248954647797,2021-11-17 02:34:08 UTC
788392,mainnet,248,107136000,107260476,124477,115368,9109,0.07317817749463756,2021-11-17 02:35:29 UTC
788393,mainnet,248,107136000,107260604,124605,115475,9130,0.07327153806027045,2021-11-17 02:36:48 UTC
788395,mainnet,248,107136000,107260788,124789,115645,9144,0.07327568936364584,2021-11-17 02:38:28 UTC
788396,mainnet,248,107136000,107260929,124930,115769,9161,0.07332906427599456,2021-11-17 02:39:50 UTC
788397,mainnet,248,107136000,107261133,125134,115940,9194,0.07347323669026803,2021-11-17 02:41:12 UTC
788399,mainnet,248,107136000,107261268,125269,116051,9218,0.07358564369476886,2021-11-17 02:42:32 UTC
788400,mainnet,248,107136000,107261384,125385,116156,9229,0.07360529568927703,2021-11-17 02:43:55 UTC
788402,mainnet,248,107136000,107261582,125583,116326,9257,0.07371220626995692,2021-11-17 02:45:34 UTC
788403,mainnet,248,107136000,107261743,125744,116473,9271,0.07372916401577809,2021-11-17 02:47:05 UTC
788405,mainnet,248,107136000,107261927,125928,116642,9286,0.0737405501556445,2021-11-17 02:48:51 UTC
788406,mainnet,248,107136000,107262083,126084,116791,9293,0.07370483169950191,2021-11-17 02:50:30 UTC
788408,mainnet,248,107136000,107262268,126269,116966,9303,0.07367604083345873,2021-11-17 02:51:56 UTC
788409,mainnet,248,107136000,107262417,126418,117098,9320,0.0737236785900742,2021-11-17 02:53:22 UTC
788411,mainnet,248,107136000,107262584,126585,117258,9327,0.07368171584310937,2021-11-17 02:54:51 UTC
788412,mainnet,248,107136000,107262786,126787,117450,9337,0.07364319685772201,2021-11-17 02:56:39 UTC
788414,mainnet,248,107136000,107263010,127011,117660,9351,0.07362354441741266,2021-11-17 02:58:35 UTC
788415,mainnet,248,107136000,107263204,127205,117850,9355,0.07354270665461263,2021-11-17 03:00:16 UTC
788417,mainnet,248,107136000,107263401,127402,118042,9360,0.07346823440762311,2021-11-17 03:02:05 UTC
788419,mainnet,248,107136000,107263584,127585,118224,9361,0.07337069404710585,2021-11-17 03:03:33 UTC
788420,mainnet,248,107136000,107263729,127730,118365,9365,0.07331871917325608,2021-11-17 03:04:59 UTC
788422,mainnet,248,107136000,107263924,127925,118540,9385,0.07336329880789526,2021-11-17 03:06:49 UTC
788423,mainnet,248,107136000,107264127,128128,118732,9396,0.07333291708291709,2021-11-17 03:08:44 UTC
788425,mainnet,248,107136000,107264276,128277,118868,9409,0.07334908050546864,2021-11-17 03:10:12 UTC
788426,mainnet,248,107136000,107264476,128477,119042,9435,0.07343726892751232,2021-11-17 03:12:03 UTC
788428,mainnet,248,107136000,107264622,128623,119185,9438,0.07337723424270931,2021-11-17 03:13:30 UTC
788429,mainnet,248,107136000,107264787,128788,119336,9452,0.07339193092524149,2021-11-17 03:15:08 UTC
788431,mainnet,248,107136000,107264944,128945,119478,9467,0.07341889953080771,2021-11-17 03:16:37 UTC
788432,mainnet,248,107136000,107265123,129124,119628,9496,0.0735417118428797,2021-11-17 03:18:04 UTC
788433,mainnet,248,107136000,107265259,129260,119757,9503,0.07351848986538759,2021-11-17 03:19:32 UTC
788435,mainnet,248,107136000,107265397,129398,119865,9533,0.07367192692313637,2021-11-17 03:20:53 UTC
788436,mainnet,248,107136000,107265562,129563,120000,9563,0.07380965244707208,2021-11-17 03:22:20 UTC
788438,mainnet,248,107136000,107265722,129723,120125,9598,0.07398842148269774,2021-11-17 03:23:49 UTC
788439,mainnet,248,107136000,107265869,129870,120264,9606,0.07396627396627396,2021-11-17 03:25:10 UTC
788441,mainnet,248,107136000,107266010,130011,120385,9626,0.07403988893247494,2021-11-17 03:26:28 UTC
788442,mainnet,248,107136000,107266166,130167,120524,9643,0.07408175651278742,2021-11-17 03:27:49 UTC
788444,mainnet,248,107136000,107266308,130309,120654,9655,0.07409311712928501,2021-11-17 03:29:07 UTC
788445,mainnet,248,107136000,107266473,130474,120794,9680,0.07419102656467955,2021-11-17 03:30:41 UTC
788447,mainnet,248,107136000,107266629,130630,120916,9714,0.07436270381994947,2021-11-17 03:32:14 UTC
788448,mainnet,248,107136000,107266787,130788,121046,9742,0.07448695598984616,2021-11-17 03:33:38 UTC
788449,mainnet,248,107136000,107266948,130949,121191,9758,0.07451756027155611,2021-11-17 03:35:05 UTC
788451,mainnet,248,107136000,107267120,131121,121349,9772,0.07452658231709643,2021-11-17 03:36:47 UTC
788452,mainnet,248,107136000,107267296,131297,121508,9789,0.074556158937371,2021-11-17 03:38:17 UTC
788454,mainnet,248,107136000,107267558,131559,121761,9798,0.07447609057533122,2021-11-17 03:40:45 UTC
788456,mainnet,248,107136000,107267724,131725,121925,9800,0.07439741886505978,2021-11-17 03:42:13 UTC
788457,mainnet,248,107136000,107267883,131884,122076,9808,0.07436838433775135,2021-11-17 03:43:42 UTC
788459,mainnet,248,107136000,107268055,132056,122239,9817,0.07433967407766402,2021-11-17 03:45:17 UTC
788460,mainnet,248,107136000,107268199,132200,122374,9826,0.0743267776096823,2021-11-17 03:46:52 UTC
788462,mainnet,248,107136000,107268407,132408,122554,9854,0.07442148510664008,2021-11-17 03:48:32 UTC
788463,mainnet,248,107136000,107268579,132580,122720,9860,0.07437019158244079,2021-11-17 03:50:00 UTC
788465,mainnet,248,107136000,107268758,132759,122894,9865,0.07430757990042107,2021-11-17 03:51:39 UTC
788466,mainnet,248,107136000,107268927,132928,123051,9877,0.0743033822821377,2021-11-17 03:53:08 UTC
788468,mainnet,248,107136000,107269131,133132,123245,9887,0.07426463960580476,2021-11-17 03:54:47 UTC
788469,mainnet,248,107136000,107269288,133289,123392,9897,0.07425218885279355,2021-11-17 03:56:18 UTC
788471,mainnet,248,107136000,107269449,133450,123536,9914,0.07428999625327838,2021-11-17 03:57:53 UTC
788472,mainnet,248,107136000,107269626,133627,123693,9934,0.07434126336743323,2021-11-17 03:59:31 UTC
788474,mainnet,248,107136000,107269810,133811,123852,9959,0.07442586932314982,2021-11-17 04:01:06 UTC
788475,mainnet,248,107136000,107269964,133965,124006,9959,0.07434031276826036,2021-11-17 04:02:36 UTC
788477,mainnet,248,107136000,107270131,134132,124164,9968,0.07431485402439388,2021-11-17 04:04:06 UTC
788478,mainnet,248,107136000,107270327,134328,124339,9989,0.0743627538562325,2021-11-17 04:05:45 UTC
788480,mainnet,248,107136000,107270492,134493,124495,9998,0.07433844140587242,2021-11-17 04:07:11 UTC
788481,mainnet,248,107136000,107270676,134677,124665,10012,0.07434083028282483,2021-11-17 04:08:50 UTC
788483,mainnet,248,107136000,107270839,134840,124813,10027,0.07436220706021952,2021-11-17 04:10:25 UTC
788484,mainnet,248,107136000,107270986,134987,124933,10054,0.07448124634224036,2021-11-17 04:11:52 UTC
788485,mainnet,248,107136000,107271128,135129,125071,10058,0.07443257923909745,2021-11-17 04:13:20 UTC
788487,mainnet,248,107136000,107271312,135313,125236,10077,0.07447178024284437,2021-11-17 04:14:46 UTC
788488,mainnet,248,107136000,107271452,135453,125370,10083,0.07443910433877433,2021-11-17 04:16:14 UTC
788490,mainnet,248,107136000,107271616,135617,125522,10095,0.07443757051107162,2021-11-17 04:17:56 UTC
788491,mainnet,248,107136000,107271819,135820,125709,10111,0.07444411721395965,2021-11-17 04:19:34 UTC
788493,mainnet,248,107136000,107271986,135987,125868,10119,0.0744115246310309,2021-11-17 04:21:11 UTC
788495,mainnet,248,107136000,107272159,136160,126018,10142,0.07448589894242068,2021-11-17 04:22:51 UTC
788496,mainnet,248,107136000,107272378,136379,126223,10156,0.07446894316573666,2021-11-17 04:24:46 UTC
788497,mainnet,248,107136000,107272521,136522,126358,10164,0.0744495392683963,2021-11-17 04:26:26 UTC
788498,mainnet,248,107136000,107272709,136710,126526,10184,0.07449345329529661,2021-11-17 04:27:54 UTC
788500,mainnet,248,107136000,107272890,136891,126693,10198,0.07449722772132572,2021-11-17 04:29:24 UTC
788502,mainnet,248,107136000,107273136,137137,126919,10218,0.07450943217366575,2021-11-17 04:31:43 UTC
788503,mainnet,248,107136000,107273326,137327,127096,10231,0.07450100854165605,2021-11-17 04:33:13 UTC
788505,mainnet,248,107136000,107273486,137487,127248,10239,0.07447249558140043,2021-11-17 04:34:41 UTC
788506,mainnet,248,107136000,107273752,137753,127504,10249,0.07440128345662163,2021-11-17 04:36:49 UTC
788508,mainnet,248,107136000,107273931,137932,127683,10249,0.07430472986689093,2021-11-17 04:38:27 UTC
788509,mainnet,248,107136000,107274096,138097,127845,10252,0.07423767351933785,2021-11-17 04:39:53 UTC
788511,mainnet,248,107136000,107274258,138259,128006,10253,0.07415792100333432,2021-11-17 04:41:23 UTC
788512,mainnet,248,107136000,107274427,138428,128166,10262,0.07413240095934348,2021-11-17 04:42:56 UTC
788514,mainnet,248,107136000,107274592,138593,128314,10279,0.07416680496128954,2021-11-17 04:44:27 UTC
788515,mainnet,248,107136000,107274744,138745,128454,10291,0.07417204223575624,2021-11-17 04:45:54 UTC
788517,mainnet,248,107136000,107274914,138915,128606,10309,0.07421084836050823,2021-11-17 04:47:23 UTC
788518,mainnet,248,107136000,107275087,139088,128764,10324,0.07422638904865984,2021-11-17 04:48:53 UTC
788520,mainnet,248,107136000,107275250,139251,128910,10341,0.07426158519507939,2021-11-17 04:50:26 UTC
788521,mainnet,248,107136000,107275406,139407,129057,10350,0.0742430437495965,2021-11-17 04:51:54 UTC
788523,mainnet,248,107136000,107275575,139576,129203,10373,0.07431793431535508,2021-11-17 04:53:21 UTC
788524,mainnet,248,107136000,107275746,139747,129369,10378,0.07426277487173248,2021-11-17 04:54:50 UTC
788526,mainnet,248,107136000,107275919,139920,129534,10386,0.07422813036020583,2021-11-17 04:56:18 UTC
788527,mainnet,248,107136000,107276085,140086,129698,10388,0.07415444798195395,2021-11-17 04:57:49 UTC
788529,mainnet,248,107136000,107276259,140260,129846,10414,0.07424782546698988,2021-11-17 04:59:24 UTC
788530,mainnet,248,107136000,107276480,140481,130048,10433,0.07426627088360703,2021-11-17 05:01:28 UTC
788532,mainnet,248,107136000,107276669,140670,130224,10446,0.07425890381744508,2021-11-17 05:03:08 UTC
788533,mainnet,248,107136000,107276814,140815,130367,10448,0.07419664098284984,2021-11-17 05:04:35 UTC
788534,mainnet,248,107136000,107276975,140976,130516,10460,0.07419702644421745,2021-11-17 05:06:06 UTC
788536,mainnet,248,107136000,107277121,141122,130659,10463,0.0741415229376001,2021-11-17 05:07:32 UTC
788537,mainnet,248,107136000,107277293,141294,130826,10468,0.07408665619205344,2021-11-17 05:09:09 UTC
788539,mainnet,248,107136000,107277446,141447,130961,10486,0.07413377448797076,2021-11-17 05:10:35 UTC
788540,mainnet,248,107136000,107277604,141605,131106,10499,0.07414286218706967,2021-11-17 05:12:03 UTC
788542,mainnet,248,107136000,107277787,141788,131264,10524,0.07422348858859706,2021-11-17 05:13:33 UTC
788543,mainnet,248,107136000,107277958,141959,131433,10526,0.07414816954190999,2021-11-17 05:15:01 UTC
788545,mainnet,248,107136000,107278116,142117,131589,10528,0.07407980748256718,2021-11-17 05:16:38 UTC
788546,mainnet,248,107136000,107278299,142300,131767,10533,0.07401967673928321,2021-11-17 05:18:09 UTC
788548,mainnet,248,107136000,107278495,142496,131928,10568,0.07416348529081518,2021-11-17 05:19:41 UTC
788549,mainnet,248,107136000,107278667,142668,132090,10578,0.07414416687694507,2021-11-17 05:21:10 UTC
788551,mainnet,248,107136000,107278840,142841,132257,10584,0.07409637289013658,2021-11-17 05:22:44 UTC
788552,mainnet,248,107136000,107279013,143014,132416,10598,0.0741046331128421,2021-11-17 05:24:13 UTC
788554,mainnet,248,107136000,107279181,143182,132578,10604,0.07405958849576064,2021-11-17 05:25:39 UTC
788555,mainnet,248,107136000,107279367,143368,132743,10625,0.07410998270185816,2021-11-17 05:27:08 UTC
788557,mainnet,248,107136000,107279538,143539,132896,10643,0.07414709591121577,2021-11-17 05:28:35 UTC
788558,mainnet,248,107136000,107279710,143711,133049,10662,0.0741905630049196,2021-11-17 05:30:05 UTC
788560,mainnet,248,107136000,107279885,143886,133221,10665,0.07412117926691965,2021-11-17 05:31:38 UTC
788561,mainnet,248,107136000,107280082,144083,133407,10676,0.0740961806736395,2021-11-17 05:33:19 UTC
788563,mainnet,248,107136000,107280254,144255,133578,10677,0.07401476551939275,2021-11-17 05:34:49 UTC
788564,mainnet,248,107136000,107280427,144428,133746,10682,0.07396072783670757,2021-11-17 05:36:21 UTC
788566,mainnet,248,107136000,107280594,144595,133908,10687,0.07390988623396383,2021-11-17 05:37:49 UTC
788567,mainnet,248,107136000,107280792,144793,134083,10710,0.07396766418266076,2021-11-17 05:39:22 UTC
788569,mainnet,248,107136000,107280969,144970,134255,10715,0.07391184382975788,2021-11-17 05:40:50 UTC
788570,mainnet,248,107136000,107281146,145147,134423,10724,0.07388371788600523,2021-11-17 05:42:18 UTC
788572,mainnet,248,107136000,107281308,145309,134561,10748,0.07396651274181228,2021-11-17 05:43:46 UTC
788573,mainnet,248,107136000,107281486,145487,134738,10749,0.07388288988019548,2021-11-17 05:45:16 UTC
788574,mainnet,248,107136000,107281667,145668,134910,10758,0.07385287091193674,2021-11-17 05:46:44 UTC
788576,mainnet,248,107136000,107281820,145821,135054,10767,0.07383710165202542,2021-11-17 05:48:12 UTC
788577,mainnet,248,107136000,107282002,146003,135231,10772,0.07377930590467319,2021-11-17 05:49:41 UTC
788579,mainnet,248,107136000,107282160,146161,135377,10784,0.07378165174020429,2021-11-17 05:51:21 UTC
788580,mainnet,248,107136000,107282418,146419,135629,10790,0.07369262185918495,2021-11-17 05:53:21 UTC
788582,mainnet,248,107136000,107282600,146601,135811,10790,0.07360113505364901,2021-11-17 05:54:53 UTC
788583,mainnet,248,107136000,107282826,146827,136037,10790,0.07348784624081402,2021-11-17 05:56:44 UTC
788585,mainnet,248,107136000,107283000,147001,136204,10797,0.07344847994231332,2021-11-17 05:58:11 UTC
788586,mainnet,248,107136000,107283179,147180,136379,10801,0.07338632966435657,2021-11-17 05:59:52 UTC
788588,mainnet,248,107136000,107283405,147406,136599,10807,0.07331451908334803,2021-11-17 06:01:36 UTC
788589,mainnet,248,107136000,107283643,147644,136827,10817,0.07326406762211807,2021-11-17 06:03:37 UTC
788591,mainnet,248,107136000,107283824,147825,136997,10828,0.0732487738880433,2021-11-17 06:05:11 UTC
788592,mainnet,248,107136000,107283997,147998,137161,10837,0.07322396248597954,2021-11-17 06:06:40 UTC
788594,mainnet,248,107136000,107284156,148157,137311,10846,0.07320612593397545,2021-11-17 06:08:06 UTC
788595,mainnet,248,107136000,107284330,148331,137481,10850,0.07314721804612657,2021-11-17 06:09:44 UTC
788597,mainnet,248,107136000,107284497,148498,137642,10856,0.07310536168837291,2021-11-17 06:11:13 UTC
788598,mainnet,248,107136000,107284658,148659,137798,10861,0.07305982147061396,2021-11-17 06:12:44 UTC
788600,mainnet,248,107136000,107284810,148811,137950,10861,0.07298519598685581,2021-11-17 06:14:12 UTC
788601,mainnet,248,107136000,107285001,149002,138132,10870,0.07295204091220252,2021-11-17 06:15:51 UTC
788603,mainnet,248,107136000,107285151,149152,138280,10872,0.07289208324393907,2021-11-17 06:17:17 UTC
788604,mainnet,248,107136000,107285359,149360,138464,10896,0.0729512587038029,2021-11-17 06:18:55 UTC
788605,mainnet,248,107136000,107285531,149532,138620,10912,0.07297434662814649,2021-11-17 06:20:28 UTC
788606,mainnet,248,107136000,107285728,149729,138804,10925,0.07296515705040439,2021-11-17 06:22:07 UTC
788608,mainnet,248,107136000,107285920,149921,138971,10950,0.07303846692591431,2021-11-17 06:23:41 UTC
788610,mainnet,248,107136000,107286126,150127,139174,10953,0.07295822869970092,2021-11-17 06:25:29 UTC
788611,mainnet,248,107136000,107286330,150331,139368,10963,0.07292574385855213,2021-11-17 06:27:11 UTC
788613,mainnet,248,107136000,107286515,150516,139548,10968,0.07286932950649765,2021-11-17 06:28:47 UTC
788614,mainnet,248,107136000,107286687,150688,139711,10977,0.07284588022934806,2021-11-17 06:30:20 UTC
788615,mainnet,248,107136000,107286850,150851,139861,10990,0.07285334535402484,2021-11-17 06:31:48 UTC
788617,mainnet,248,107136000,107287027,151028,140025,11003,0.07285404031040602,2021-11-17 06:33:16 UTC
788618,mainnet,248,107136000,107287194,151195,140173,11022,0.0728992360858494,2021-11-17 06:34:57 UTC
788620,mainnet,248,107136000,107287387,151388,140347,11041,0.07293180437022749,2021-11-17 06:36:30 UTC
788621,mainnet,248,107136000,107287564,151565,140521,11044,0.07286642694553491,2021-11-17 06:37:58 UTC
788623,mainnet,248,107136000,107287740,151741,140669,11072,0.07296643623015533,2021-11-17 06:39:28 UTC
788624,mainnet,248,107136000,107287926,151927,140839,11088,0.07298241918816274,2021-11-17 06:41:00 UTC
788626,mainnet,248,107136000,107288104,152105,141004,11101,0.07298247920844153,2021-11-17 06:42:31 UTC
788627,mainnet,248,107136000,107288279,152280,141166,11114,0.07298397688468611,2021-11-17 06:44:04 UTC
788629,mainnet,248,107136000,107288452,152453,141328,11125,0.0729733098069569,2021-11-17 06:45:32 UTC
788630,mainnet,248,107136000,107288608,152609,141483,11126,0.07290526771029232,2021-11-17 06:47:03 UTC
788632,mainnet,248,107136000,107288798,152799,141649,11150,0.07297168175184393,2021-11-17 06:48:34 UTC
788633,mainnet,248,107136000,107289006,153007,141849,11158,0.07292476814786251,2021-11-17 06:50:18 UTC
788635,mainnet,248,107136000,107289176,153177,142010,11167,0.07290258981439772,2021-11-17 06:51:51 UTC
788636,mainnet,248,107136000,107289353,153354,142177,11177,0.07288365481174276,2021-11-17 06:53:26 UTC
788638,mainnet,248,107136000,107289532,153533,142345,11188,0.07287032755173155,2021-11-17 06:55:17 UTC
788639,mainnet,248,107136000,107289743,153744,142549,11195,0.07281584972421688,2021-11-17 06:56:46 UTC
788641,mainnet,248,107136000,107289933,153934,142731,11203,0.07277794379409357,2021-11-17 06:58:24 UTC
788642,mainnet,248,107136000,107290090,154091,142876,11215,0.07278166797541713,2021-11-17 06:59:52 UTC
788644,mainnet,248,107136000,107290284,154285,143052,11233,0.07280681855008587,2021-11-17 07:01:29 UTC
788645,mainnet,248,107136000,107290452,154453,143200,11253,0.07285711510945077,2021-11-17 07:02:58 UTC
788647,mainnet,248,107136000,107290605,154606,143340,11266,0.07286909951748315,2021-11-17 07:04:29 UTC
788648,mainnet,248,107136000,107290786,154787,143502,11285,0.07290663944646514,2021-11-17 07:06:01 UTC
788650,mainnet,248,107136000,107291000,155001,143704,11297,0.0728834007522532,2021-11-17 07:07:45 UTC
788651,mainnet,248,107136000,107291166,155167,143852,11315,0.07292143303666372,2021-11-17 07:09:16 UTC
788653,mainnet,248,107136000,107291344,155345,144021,11324,0.07289581254626798,2021-11-17 07:10:45 UTC
788654,mainnet,248,107136000,107291526,155527,144195,11332,0.07286194680023404,2021-11-17 07:12:14 UTC
788656,mainnet,248,107136000,107291723,155724,144382,11342,0.07283398833834219,2021-11-17 07:13:55 UTC
788657,mainnet,248,107136000,107291894,155895,144548,11347,0.07278617017864589,2021-11-17 07:15:25 UTC
788659,mainnet,248,107136000,107292064,156065,144700,11365,0.07282222151026815,2021-11-17 07:16:52 UTC
788660,mainnet,248,107136000,107292149,156150,144785,11365,0.07278258085174512,2021-11-17 07:18:44 UTC
788662,mainnet,248,107136000,107292453,156454,145009,11445,0.073152492106306,2021-11-17 07:20:15 UTC
788663,mainnet,248,107136000,107292616,156617,145166,11451,0.07311466826717407,2021-11-17 07:21:57 UTC
788665,mainnet,248,107136000,107292813,156814,145344,11470,0.07314397949162703,2021-11-17 07:23:25 UTC
788666,mainnet,248,107136000,107293012,157013,145530,11483,0.07313407170106934,2021-11-17 07:25:02 UTC
788668,mainnet,248,107136000,107293216,157217,145723,11494,0.07310914214111705,2021-11-17 07:26:46 UTC
788670,mainnet,248,107136000,107293454,157455,145945,11510,0.07310025086532661,2021-11-17 07:28:50 UTC
788671,mainnet,248,107136000,107293642,157643,146124,11519,0.07307016486618499,2021-11-17 07:30:21 UTC
788673,mainnet,248,107136000,107293815,157816,146296,11520,0.07299640087190146,2021-11-17 07:31:54 UTC
788674,mainnet,248,107136000,107294002,158003,146478,11525,0.07294165300658849,2021-11-17 07:33:27 UTC
788676,mainnet,248,107136000,107294176,158177,146646,11531,0.07289934693413075,2021-11-17 07:35:00 UTC
788677,mainnet,248,107136000,107294336,158337,146804,11533,0.07283831321800968,2021-11-17 07:36:28 UTC
788678,mainnet,248,107136000,107294503,158504,146959,11545,0.07283727855448444,2021-11-17 07:37:56 UTC
788680,mainnet,248,107136000,107294612,158613,147068,11545,0.07278722425021909,2021-11-17 07:39:55 UTC
788682,mainnet,248,107136000,107294944,158945,147366,11579,0.07284909874484885,2021-11-17 07:41:37 UTC
788683,mainnet,248,107136000,107295083,159084,147494,11590,0.0728545925423047,2021-11-17 07:43:06 UTC
788684,mainnet,248,107136000,107295260,159261,147666,11595,0.07280501817770829,2021-11-17 07:44:53 UTC
788686,mainnet,248,107136000,107295407,159408,147792,11616,0.07286961758506474,2021-11-17 07:46:24 UTC
788688,mainnet,248,107136000,107295608,159609,147962,11647,0.0729720755095264,2021-11-17 07:48:07 UTC
788689,mainnet,248,107136000,107295792,159793,148134,11659,0.07296314607022836,2021-11-17 07:49:40 UTC
788690,mainnet,248,107136000,107295949,159950,148282,11668,0.07294779618630823,2021-11-17 07:51:09 UTC
788692,mainnet,248,107136000,107296158,160159,148477,11682,0.07294001585923988,2021-11-17 07:53:00 UTC
788694,mainnet,248,107136000,107296355,160356,148671,11685,0.07286911621641846,2021-11-17 07:54:44 UTC
788695,mainnet,248,107136000,107296535,160536,148850,11686,0.07279364130163951,2021-11-17 07:56:19 UTC
788697,mainnet,248,107136000,107296723,160724,149029,11695,0.07276449067967447,2021-11-17 07:57:58 UTC
788698,mainnet,248,107136000,107296935,160936,149227,11709,0.07275562956703285,2021-11-17 07:59:42 UTC
788700,mainnet,248,107136000,107297168,161169,149456,11713,0.07267526633533744,2021-11-17 08:01:46 UTC
788701,mainnet,248,107136000,107297332,161333,149613,11720,0.07264477819169048,2021-11-17 08:03:27 UTC
788703,mainnet,248,107136000,107297513,161514,149770,11744,0.07271196304964275,2021-11-17 08:04:58 UTC
788704,mainnet,248,107136000,107297742,161743,149978,11765,0.07273885114038939,2021-11-17 08:06:48 UTC
788706,mainnet,248,107136000,107297907,161908,150137,11771,0.07270178125849247,2021-11-17 08:08:17 UTC
788707,mainnet,248,107136000,107298068,162069,150280,11789,0.07274062282114407,2021-11-17 08:09:49 UTC
788709,mainnet,248,107136000,107298243,162244,150443,11801,0.07273612583516186,2021-11-17 08:11:19 UTC
788710,mainnet,248,107136000,107298413,162414,150602,11812,0.07272772051670423,2021-11-17 08:12:50 UTC
788712,mainnet,248,107136000,107298576,162577,150764,11813,0.07266095450155927,2021-11-17 08:14:32 UTC
788713,mainnet,248,107136000,107298781,162782,150964,11818,0.07260016463736776,2021-11-17 08:16:02 UTC
788715,mainnet,248,107136000,107298968,162969,151137,11832,0.07260276494302598,2021-11-17 08:17:35 UTC
788716,mainnet,248,107136000,107299133,163134,151300,11834,0.07254159157502421,2021-11-17 08:19:05 UTC
788718,mainnet,248,107136000,107299305,163306,151453,11853,0.07258153405263738,2021-11-17 08:20:31 UTC
788719,mainnet,248,107136000,107299461,163462,151597,11865,0.07258567740514615,2021-11-17 08:22:01 UTC
788721,mainnet,248,107136000,107299637,163638,151771,11867,0.07251983035725199,2021-11-17 08:23:33 UTC
788722,mainnet,248,107136000,107299812,163813,151941,11872,0.07247288066270687,2021-11-17 08:25:02 UTC
788724,mainnet,248,107136000,107300021,164022,152136,11886,0.07246588872224458,2021-11-17 08:26:52 UTC
788725,mainnet,248,107136000,107300188,164189,152294,11895,0.07244699705826821,2021-11-17 08:28:27 UTC
788727,mainnet,248,107136000,107300376,164377,152473,11904,0.07241889072072127,2021-11-17 08:30:08 UTC
788728,mainnet,248,107136000,107300576,164577,152649,11928,0.07247671302794437,2021-11-17 08:31:39 UTC
788730,mainnet,248,107136000,107300763,164764,152832,11932,0.07241873224733558,2021-11-17 08:33:21 UTC
788731,mainnet,248,107136000,107300951,164952,153004,11948,0.07243319268635724,2021-11-17 08:34:53 UTC
788733,mainnet,248,107136000,107301121,165122,153156,11966,0.07246762999479173,2021-11-17 08:36:24 UTC
788734,mainnet,248,107136000,107301304,165305,153333,11972,0.07242370164241856,2021-11-17 08:37:52 UTC
788736,mainnet,248,107136000,107301498,165499,153514,11985,0.07241735599610874,2021-11-17 08:39:26 UTC
788737,mainnet,248,107136000,107301664,165665,153668,11997,0.07241722753750038,2021-11-17 08:40:53 UTC
788739,mainnet,248,107136000,107301846,165847,153840,12007,0.07239805362774124,2021-11-17 08:42:23 UTC
788740,mainnet,248,107136000,107302027,166028,154020,12008,0.07232514997470306,2021-11-17 08:43:58 UTC
788742,mainnet,248,107136000,107302193,166194,154175,12019,0.07231909695897565,2021-11-17 08:45:30 UTC
788743,mainnet,248,107136000,107302372,166373,154350,12023,0.0722653315141279,2021-11-17 08:47:10 UTC
788745,mainnet,248,107136000,107302577,166578,154527,12051,0.07234448726722617,2021-11-17 08:48:45 UTC
788746,mainnet,248,107136000,107302770,166771,154703,12068,0.0723627009492058,2021-11-17 08:50:22 UTC
788748,mainnet,248,107136000,107302940,166941,154860,12081,0.07236688410875698,2021-11-17 08:51:57 UTC
788749,mainnet,248,107136000,107303136,167137,155056,12081,0.07228202013916726,2021-11-17 08:53:38 UTC
788751,mainnet,248,107136000,107303320,167321,155238,12083,0.07221448592824571,2021-11-17 08:55:11 UTC
788752,mainnet,248,107136000,107303532,167533,155444,12089,0.07215891794452436,2021-11-17 08:56:59 UTC
788754,mainnet,248,107136000,107303735,167736,155647,12089,0.07207158868698431,2021-11-17 08:58:41 UTC
788755,mainnet,248,107136000,107303921,167922,155826,12096,0.07203344409904598,2021-11-17 09:00:14 UTC
788757,mainnet,248,107136000,107304144,168145,156036,12109,0.07201522495465223,2021-11-17 09:02:32 UTC
788759,mainnet,248,107136000,107304338,168339,156198,12141,0.07212232459501364,2021-11-17 09:04:24 UTC
788760,mainnet,248,107136000,107304540,168541,156362,12179,0.07226134887060122,2021-11-17 09:05:55 UTC
788762,mainnet,248,107136000,107304718,168719,156539,12180,0.07219103953911533,2021-11-17 09:07:28 UTC
788763,mainnet,248,107136000,107304914,168915,156727,12188,0.07215463398750852,2021-11-17 09:09:10 UTC
788765,mainnet,248,107136000,107305103,169104,156910,12194,0.07210947109471094,2021-11-17 09:10:57 UTC
788766,mainnet,248,107136000,107305306,169307,157109,12198,0.07204663717389122,2021-11-17 09:12:40 UTC
788768,mainnet,248,107136000,107305507,169508,157289,12219,0.07208509332892843,2021-11-17 09:14:24 UTC
788769,mainnet,248,107136000,107305643,169644,157423,12221,0.07203909363136922,2021-11-17 09:16:17 UTC
788771,mainnet,248,107136000,107305923,169924,157674,12250,0.07209105247051623,2021-11-17 09:17:59 UTC
788772,mainnet,248,107136000,107306097,170098,157846,12252,0.0720290655974791,2021-11-17 09:19:31 UTC
788774,mainnet,248,107136000,107306268,170269,158003,12266,0.07203895013185019,2021-11-17 09:21:02 UTC
788775,mainnet,248,107136000,107306476,170477,158202,12275,0.07200384802641999,2021-11-17 09:22:44 UTC
788777,mainnet,248,107136000,107306641,170642,158367,12275,0.07193422486843802,2021-11-17 09:24:14 UTC
788778,mainnet,248,107136000,107306814,170815,158510,12305,0.07203699909258554,2021-11-17 09:25:40 UTC
788780,mainnet,248,107136000,107306973,170974,158663,12311,0.07200510019067227,2021-11-17 09:27:13 UTC
788781,mainnet,248,107136000,107307157,171158,158835,12323,0.07199780319938302,2021-11-17 09:28:45 UTC
788783,mainnet,248,107136000,107307327,171328,159003,12325,0.07193803698169593,2021-11-17 09:30:17 UTC
788784,mainnet,248,107136000,107307508,171509,159171,12338,0.07193791579450641,2021-11-17 09:31:49 UTC
788786,mainnet,248,107136000,107307688,171689,159343,12346,0.07190909143858955,2021-11-17 09:33:17 UTC
788787,mainnet,248,107136000,107307865,171866,159503,12363,0.07193394854130544,2021-11-17 09:34:48 UTC
788789,mainnet,248,107136000,107308060,172061,159671,12390,0.07200934552280877,2021-11-17 09:36:22 UTC
788790,mainnet,248,107136000,107308248,172249,159850,12399,0.07198300135269291,2021-11-17 09:38:02 UTC
788792,mainnet,248,107136000,107308449,172450,160043,12407,0.07194549144679617,2021-11-17 09:39:43 UTC
788793,mainnet,248,107136000,107308628,172629,160211,12418,0.07193461121827735,2021-11-17 09:41:13 UTC
788795,mainnet,248,107136000,107308790,172791,160370,12421,0.07188453102302782,2021-11-17 09:42:45 UTC
788796,mainnet,248,107136000,107308966,172967,160530,12437,0.07190388918117328,2021-11-17 09:44:17 UTC
788798,mainnet,248,107136000,107309092,173093,160655,12438,0.07185732525289873,2021-11-17 09:45:48 UTC
788799,mainnet,248,107136000,107309339,173340,160893,12447,0.07180685358255452,2021-11-17 09:47:17 UTC
788801,mainnet,248,107136000,107309496,173497,161018,12479,0.07192631572880223,2021-11-17 09:48:46 UTC
788802,mainnet,248,107136000,107309645,173646,161152,12494,0.07195098073091231,2021-11-17 09:50:19 UTC
788804,mainnet,248,107136000,107309830,173831,161299,12532,0.07209300987740967,2021-11-17 09:51:53 UTC
788805,mainnet,248,107136000,107309980,173981,161436,12545,0.07210557474666773,2021-11-17 09:53:22 UTC
788807,mainnet,248,107136000,107310180,174181,161616,12565,0.07213760398665756,2021-11-17 09:54:54 UTC
788808,mainnet,248,107136000,107310374,174375,161805,12570,0.07208602150537634,2021-11-17 09:56:34 UTC
788810,mainnet,248,107136000,107310541,174542,161964,12578,0.07206288457792394,2021-11-17 09:58:06 UTC
788811,mainnet,248,107136000,107310733,174734,162136,12598,0.07209816063273318,2021-11-17 09:59:45 UTC
788813,mainnet,248,107136000,107310954,174955,162349,12606,0.07205281358063502,2021-11-17 10:01:34 UTC
788814,mainnet,248,107136000,107311142,175143,162529,12614,0.07202114843299476,2021-11-17 10:03:06 UTC
788816,mainnet,248,107136000,107311315,175316,162687,12629,0.07203563850418672,2021-11-17 10:04:48 UTC
788817,mainnet,248,107136000,107311504,175505,162869,12636,0.07199794877638814,2021-11-17 10:06:17 UTC
788819,mainnet,248,107136000,107311686,175687,163045,12642,0.07195751535401025,2021-11-17 10:07:47 UTC
788820,mainnet,248,107136000,107311871,175872,163222,12650,0.07192731077147016,2021-11-17 10:09:19 UTC
788822,mainnet,248,107136000,107312064,176065,163407,12658,0.07189390281998126,2021-11-17 10:10:55 UTC
788823,mainnet,248,107136000,107312244,176245,163586,12659,0.071826151096485,2021-11-17 10:12:27 UTC
788825,mainnet,248,107136000,107312436,176437,163765,12672,0.07182167005786769,2021-11-17 10:14:01 UTC
788826,mainnet,248,107136000,107312619,176620,163944,12676,0.07176990148341071,2021-11-17 10:15:35 UTC
788828,mainnet,248,107136000,107312792,176793,164108,12685,0.07175057836000294,2021-11-17 10:17:09 UTC
788829,mainnet,248,107136000,107312974,176975,164271,12704,0.07178415030371521,2021-11-17 10:18:38 UTC
788830,mainnet,248,107136000,107313148,177149,164435,12714,0.07177009184358929,2021-11-17 10:20:10 UTC
788832,mainnet,248,107136000,107313343,177344,164624,12720,0.07172500902201372,2021-11-17 10:21:50 UTC
788833,mainnet,248,107136000,107313521,177522,164795,12727,0.07169252261691508,2021-11-17 10:23:21 UTC
788835,mainnet,248,107136000,107313737,177738,164999,12739,0.07167291181401839,2021-11-17 10:25:09 UTC
788837,mainnet,248,107136000,107313911,177912,165163,12749,0.07165902243805927,2021-11-17 10:26:42 UTC
788838,mainnet,248,107136000,107314129,178130,165370,12760,0.07163307696626059,2021-11-17 10:28:32 UTC
788840,mainnet,248,107136000,107314315,178316,165549,12767,0.07159761322595841,2021-11-17 10:30:03 UTC
788841,mainnet,248,107136000,107314424,178425,165653,12772,0.07158189715566765,2021-11-17 10:31:47 UTC
788843,mainnet,248,107136000,107314673,178674,165875,12799,0.0716332538589834,2021-11-17 10:32:54 UTC
788844,mainnet,248,107136000,107314848,178849,166038,12811,0.07163025792707815,2021-11-17 10:34:26 UTC
788845,mainnet,248,107136000,107314998,178999,166177,12822,0.07163168509321281,2021-11-17 10:35:56 UTC
788847,mainnet,248,107136000,107315185,179186,166351,12835,0.071629479981695,2021-11-17 10:37:47 UTC
788848,mainnet,248,107136000,107315351,179352,166502,12850,0.0716468174316428,2021-11-17 10:39:16 UTC
788850,mainnet,248,107136000,107315520,179521,166647,12874,0.07171305863937924,2021-11-17 10:41:02 UTC
788851,mainnet,248,107136000,107315677,179678,166782,12896,0.07177283807700442,2021-11-17 10:42:34 UTC
788853,mainnet,248,107136000,107315867,179868,166942,12926,0.0718638112393533,2021-11-17 10:44:12 UTC
788854,mainnet,248,107136000,107316030,180031,167095,12936,0.0718542917608634,2021-11-17 10:45:46 UTC
788856,mainnet,248,107136000,107316222,180223,167273,12950,0.0718554235585913,2021-11-17 10:47:38 UTC
788858,mainnet,248,107136000,107316396,180397,167434,12963,0.07185817945974711,2021-11-17 10:49:12 UTC
788859,mainnet,248,107136000,107316564,180565,167592,12973,0.0718467034032066,2021-11-17 10:50:47 UTC
788860,mainnet,248,107136000,107316729,180730,167738,12992,0.07188623914126044,2021-11-17 10:52:25 UTC
788862,mainnet,248,107136000,107316892,180893,167887,13006,0.07189885733555196,2021-11-17 10:53:58 UTC
788863,mainnet,248,107136000,107317052,181053,168038,13015,0.0718850281409311,2021-11-17 10:55:30 UTC
788865,mainnet,248,107136000,107317217,181218,168192,13026,0.07188027679369599,2021-11-17 10:57:13 UTC
788866,mainnet,248,107136000,107317382,181383,168347,13036,0.07187002089501221,2021-11-17 10:58:47 UTC
788868,mainnet,248,107136000,107317533,181534,168492,13042,0.07184329106393293,2021-11-17 11:00:23 UTC
788869,mainnet,248,107136000,107317713,181714,168639,13075,0.07195372948699605,2021-11-17 11:01:55 UTC
788871,mainnet,248,107136000,107317880,181881,168792,13089,0.07196463621818662,2021-11-17 11:03:35 UTC
788872,mainnet,248,107136000,107318204,182205,169091,13114,0.07197387557970418,2021-11-17 11:05:08 UTC
788874,mainnet,248,107136000,107318228,182229,169115,13114,0.07196439644622975,2021-11-17 11:06:40 UTC
788875,mainnet,248,107136000,107318394,182395,169270,13125,0.07195920940815263,2021-11-17 11:08:09 UTC
788877,mainnet,248,107136000,107318566,182567,169420,13147,0.07201191891196108,2021-11-17 11:09:42 UTC
788878,mainnet,248,107136000,107318749,182750,169597,13153,0.07197264021887825,2021-11-17 11:11:15 UTC
788880,mainnet,248,107136000,107318938,182939,169760,13179,0.07204040691159348,2021-11-17 11:12:55 UTC
788881,mainnet,248,107136000,107319120,183121,169929,13192,0.07203979882154422,2021-11-17 11:14:27 UTC
788883,mainnet,248,107136000,107319306,183307,170099,13208,0.07205398593616175,2021-11-17 11:16:00 UTC
788884,mainnet,248,107136000,107319504,183505,170280,13225,0.07206888095692215,2021-11-17 11:17:41 UTC
788886,mainnet,248,107136000,107319677,183678,170442,13236,0.07206088916473394,2021-11-17 11:19:14 UTC
788887,mainnet,248,107136000,107319852,183853,170602,13251,0.0720738851147384,2021-11-17 11:20:44 UTC
788889,mainnet,248,107136000,107320008,184009,170743,13266,0.07209429973533903,2021-11-17 11:22:13 UTC
788890,mainnet,248,107136000,107320179,184180,170890,13290,0.07215767184276252,2021-11-17 11:23:41 UTC
788892,mainnet,248,107136000,107320352,184353,171053,13300,0.07214420161320945,2021-11-17 11:25:12 UTC
788893,mainnet,248,107136000,107320527,184528,171219,13309,0.07212455562299488,2021-11-17 11:26:45 UTC
788895,mainnet,248,107136000,107320705,184706,171380,13326,0.07214708780440267,2021-11-17 11:28:27 UTC
788896,mainnet,248,107136000,107320907,184908,171564,13344,0.07216561749626842,2021-11-17 11:30:11 UTC
788898,mainnet,248,107136000,107321104,185105,171747,13358,0.07216444720564004,2021-11-17 11:31:53 UTC
788899,mainnet,248,107136000,107321278,185279,171913,13366,0.07213985394998894,2021-11-17 11:33:25 UTC
788901,mainnet,248,107136000,107321460,185461,172095,13366,0.07206906034152732,2021-11-17 11:34:59 UTC
788902,mainnet,248,107136000,107321633,185634,172259,13375,0.0720503787021774,2021-11-17 11:36:29 UTC
788904,mainnet,248,107136000,107321798,185799,172417,13382,0.07202406902082358,2021-11-17 11:38:00 UTC
788905,mainnet,248,107136000,107322133,186134,172610,13524,0.07265733288920885,2021-11-17 11:39:41 UTC
788907,mainnet,248,107136000,107322336,186337,172824,13513,0.0725191454193209,2021-11-17 11:41:16 UTC
788908,mainnet,248,107136000,107322528,186529,173012,13517,0.07246594363342966,2021-11-17 11:42:53 UTC
788910,mainnet,248,107136000,107322588,186589,173171,13418,0.07191206341209824,2021-11-17 11:44:23 UTC
788911,mainnet,248,107136000,107322872,186873,173430,13443,0.07193655584273811,2021-11-17 11:45:58 UTC
788913,mainnet,248,107136000,107322929,186930,173483,13447,0.07193601883057829,2021-11-17 11:47:42 UTC
788914,mainnet,248,107136000,107323112,187113,173648,13465,0.07196186261777643,2021-11-17 11:49:14 UTC
788916,mainnet,248,107136000,107323299,187300,173830,13470,0.07191671115856914,2021-11-17 11:50:46 UTC
788917,mainnet,248,107136000,107323513,187514,174033,13481,0.07189329863370202,2021-11-17 11:52:29 UTC
788919,mainnet,248,107136000,107323664,187665,174184,13481,0.07183545146937362,2021-11-17 11:54:02 UTC
788920,mainnet,248,107136000,107323851,187852,174359,13493,0.07182782190234865,2021-11-17 11:55:34 UTC
788922,mainnet,248,107136000,107324020,188021,174517,13504,0.07182176459012557,2021-11-17 11:57:00 UTC
788923,mainnet,248,107136000,107324195,188196,174687,13509,0.07178154689791494,2021-11-17 11:58:43 UTC
788925,mainnet,248,107136000,107324401,188402,174880,13522,0.07177206186770842,2021-11-17 12:00:22 UTC
788926,mainnet,248,107136000,107324591,188592,175049,13543,0.07181110545516246,2021-11-17 12:02:05 UTC
788928,mainnet,248,107136000,107324765,188766,175218,13548,0.07177139951050507,2021-11-17 12:03:37 UTC
788929,mainnet,248,107136000,107324938,188939,175377,13562,0.07177978077580595,2021-11-17 12:05:16 UTC
788931,mainnet,248,107136000,107325093,189094,175525,13569,0.07175796164870382,2021-11-17 12:06:44 UTC
788932,mainnet,248,107136000,107325241,189242,175664,13578,0.07174940023884761,2021-11-17 12:08:15 UTC
788933,mainnet,248,107136000,107325426,189427,175821,13606,0.07182714185411794,2021-11-17 12:09:45 UTC
788935,mainnet,248,107136000,107325603,189604,175992,13612,0.07179173435159596,2021-11-17 12:11:35 UTC
788936,mainnet,248,107136000,107325802,189803,176183,13620,0.07175861287756252,2021-11-17 12:13:15 UTC
788938,mainnet,248,107136000,107325984,189985,176357,13628,0.07173197884043477,2021-11-17 12:14:49 UTC
788939,mainnet,248,107136000,107326184,190185,176543,13642,0.07173015747824486,2021-11-17 12:16:30 UTC
788941,mainnet,248,107136000,107326394,190395,176748,13647,0.07167730245016939,2021-11-17 12:18:14 UTC
788942,mainnet,248,107136000,107326589,190590,176932,13658,0.07166168214491841,2021-11-17 12:19:47 UTC
788944,mainnet,248,107136000,107326771,190772,177101,13671,0.07166145975300359,2021-11-17 12:21:18 UTC
788945,mainnet,248,107136000,107326917,190918,177226,13692,0.0717166532228496,2021-11-17 12:22:46 UTC
788947,mainnet,248,107136000,107327069,191070,177349,13721,0.07181137802899461,2021-11-17 12:24:19 UTC
788948,mainnet,248,107136000,107327212,191213,177475,13738,0.07184657946896916,2021-11-17 12:25:48 UTC
788950,mainnet,248,107136000,107327396,191397,177624,13773,0.07196037555447578,2021-11-17 12:27:29 UTC
788951,mainnet,248,107136000,107327569,191570,177785,13785,0.07195803100694263,2021-11-17 12:28:58 UTC
788953,mainnet,248,107136000,107327760,191761,177972,13789,0.07190721783887234,2021-11-17 12:30:31 UTC
788954,mainnet,248,107136000,107327944,191945,178138,13807,0.07193206387246347,2021-11-17 12:32:10 UTC
788956,mainnet,248,107136000,107328132,192133,178315,13818,0.07191893115706308,2021-11-17 12:33:55 UTC
788958,mainnet,248,107136000,107328322,192323,178497,13826,0.07188947759758323,2021-11-17 12:35:35 UTC
788959,mainnet,248,107136000,107328516,192517,178691,13826,0.07181703433982453,2021-11-17 12:37:16 UTC
788961,mainnet,248,107136000,107328685,192686,178852,13834,0.07179556376695764,2021-11-17 12:38:46 UTC
788962,mainnet,248,107136000,107328888,192889,179043,13846,0.07178221671531296,2021-11-17 12:40:21 UTC
788964,mainnet,248,107136000,107329048,193049,179188,13861,0.07180042372661863,2021-11-17 12:41:51 UTC
788965,mainnet,248,107136000,107329225,193226,179352,13874,0.07180193141709708,2021-11-17 12:43:24 UTC
788967,mainnet,248,107136000,107329412,193413,179528,13885,0.07178938334031322,2021-11-17 12:45:04 UTC
788968,mainnet,248,107136000,107329596,193597,179700,13897,0.07178313713538949,2021-11-17 12:46:36 UTC
788970,mainnet,248,107136000,107329759,193760,179860,13900,0.0717382328654005,2021-11-17 12:48:07 UTC
788971,mainnet,248,107136000,107329936,193937,180019,13918,0.07176557335629612,2021-11-17 12:49:39 UTC
788972,mainnet,248,107136000,107330089,194090,180169,13921,0.07172445772579732,2021-11-17 12:51:10 UTC
788974,mainnet,248,107136000,107330268,194269,180342,13927,0.07168925561978494,2021-11-17 12:52:43 UTC
788975,mainnet,248,107136000,107330434,194435,180499,13936,0.07167433846786844,2021-11-17 12:54:13 UTC
788977,mainnet,248,107136000,107330604,194605,180662,13943,0.07164769661622261,2021-11-17 12:55:44 UTC
788978,mainnet,248,107136000,107330784,194785,180824,13961,0.07167389686064123,2021-11-17 12:57:15 UTC
788980,mainnet,248,107136000,107330994,194995,181026,13969,0.07163773430087951,2021-11-17 12:59:01 UTC
788981,mainnet,248,107136000,107331174,195175,181197,13978,0.07161777891635712,2021-11-17 13:00:37 UTC
788983,mainnet,248,107136000,107331386,195387,181405,13982,0.07156054394611719,2021-11-17 13:02:36 UTC
788984,mainnet,248,107136000,107331604,195605,181594,14011,0.07162904833721019,2021-11-17 13:04:23 UTC
788986,mainnet,248,107136000,107331783,195784,181762,14022,0.07161974420790258,2021-11-17 13:05:59 UTC
788987,mainnet,248,107136000,107331964,195965,181941,14024,0.07156379965810221,2021-11-17 13:07:36 UTC
788989,mainnet,248,107136000,107332156,196157,182121,14036,0.0715549279403743,2021-11-17 13:09:14 UTC
788990,mainnet,248,107136000,107332340,196341,182281,14060,0.07161010690584238,2021-11-17 13:10:56 UTC
788992,mainnet,248,107136000,107332536,196537,182445,14092,0.0717015116746465,2021-11-17 13:12:35 UTC
788993,mainnet,248,107136000,107332706,196707,182605,14102,0.07169038214196749,2021-11-17 13:14:26 UTC
788995,mainnet,248,107136000,107332916,196917,182786,14131,0.07176119888074671,2021-11-17 13:16:06 UTC
788996,mainnet,248,107136000,107333080,197081,182946,14135,0.07172177936990375,2021-11-17 13:17:41 UTC
788998,mainnet,248,107136000,107333291,197292,183135,14157,0.07175658414938264,2021-11-17 13:19:21 UTC
788999,mainnet,248,107136000,107333512,197513,183356,14157,0.07167629472490418,2021-11-17 13:21:20 UTC
789001,mainnet,248,107136000,107333716,197717,183550,14167,0.07165291805965092,2021-11-17 13:23:05 UTC
789002,mainnet,248,107136000,107333844,197845,183670,14175,0.0716469963860598,2021-11-17 13:24:38 UTC
789004,mainnet,248,107136000,107334064,198065,183877,14188,0.0716330497563931,2021-11-17 13:26:16 UTC
789005,mainnet,248,107136000,107334280,198281,184069,14212,0.07167605569873059,2021-11-17 13:27:51 UTC
789007,mainnet,248,107136000,107334474,198475,184255,14220,0.0716463030608389,2021-11-17 13:29:26 UTC
789008,mainnet,248,107136000,107334654,198655,184415,14240,0.07168206186604918,2021-11-17 13:30:56 UTC
789010,mainnet,248,107136000,107334848,198849,184604,14245,0.07163727250325624,2021-11-17 13:32:49 UTC
789011,mainnet,248,107136000,107335015,199016,184752,14264,0.07167262933633477,2021-11-17 13:34:20 UTC
789013,mainnet,248,107136000,107335207,199208,184943,14265,0.07160856993695032,2021-11-17 13:36:08 UTC
789014,mainnet,248,107136000,107335354,199355,185084,14271,0.07158586441273106,2021-11-17 13:37:35 UTC
789016,mainnet,248,107136000,107335544,199545,185261,14284,0.07158285098599314,2021-11-17 13:39:06 UTC
789017,mainnet,248,107136000,107335711,199712,185428,14284,0.07152299311007851,2021-11-17 13:40:34 UTC
789019,mainnet,248,107136000,107335888,199889,185592,14297,0.07152469620639455,2021-11-17 13:42:07 UTC
789020,mainnet,248,107136000,107336093,200094,185789,14305,0.07149139904245005,2021-11-17 13:43:57 UTC
789022,mainnet,248,107136000,107336342,200343,186016,14327,0.07151235630893019,2021-11-17 13:45:41 UTC
789023,mainnet,248,107136000,107336507,200508,186161,14347,0.07155325473297823,2021-11-17 13:47:20 UTC
789025,mainnet,248,107136000,107336684,200685,186329,14356,0.07153499265017316,2021-11-17 13:48:52 UTC
789027,mainnet,248,107136000,107336876,200877,186505,14372,0.07154626960776993,2021-11-17 13:50:34 UTC
789028,mainnet,248,107136000,107337058,201059,186686,14373,0.0714864790932015,2021-11-17 13:52:18 UTC
789030,mainnet,248,107136000,107337232,201233,186849,14384,0.07147932993097554,2021-11-17 13:53:58 UTC
789031,mainnet,248,107136000,107337442,201443,187052,14391,0.07143956354899401,2021-11-17 13:55:38 UTC
789033,mainnet,248,107136000,107337606,201607,187203,14404,0.07144593193688711,2021-11-17 13:57:08 UTC
789034,mainnet,248,107136000,107337812,201813,187399,14414,0.07142255454306709,2021-11-17 13:58:50 UTC
789036,mainnet,248,107136000,107337989,201990,187563,14427,0.07142432793702659,2021-11-17 14:00:24 UTC
789037,mainnet,248,107136000,107338174,202175,187743,14432,0.07138370223816001,2021-11-17 14:02:11 UTC
789039,mainnet,248,107136000,107338344,202345,187909,14436,0.07134349749190738,2021-11-17 14:03:40 UTC
789040,mainnet,248,107136000,107338512,202513,188067,14446,0.0713336921580343,2021-11-17 14:05:12 UTC
789042,mainnet,248,107136000,107338656,202657,188184,14473,0.07141623531385544,2021-11-17 14:06:41 UTC
789043,mainnet,248,107136000,107338810,202811,188323,14488,0.07143596747710923,2021-11-17 14:08:12 UTC
789045,mainnet,248,107136000,107338984,202985,188476,14509,0.07147818804345149,2021-11-17 14:09:53 UTC
789046,mainnet,248,107136000,107339160,203161,188651,14510,0.07142118812173597,2021-11-17 14:11:36 UTC
789048,mainnet,248,107136000,107339340,203341,188821,14520,0.07140714366507492,2021-11-17 14:13:06 UTC
789049,mainnet,248,107136000,107339519,203520,188997,14523,0.07135908018867924,2021-11-17 14:14:49 UTC
789051,mainnet,248,107136000,107339696,203697,189161,14536,0.0713608938766894,2021-11-17 14:16:19 UTC
789052,mainnet,248,107136000,107339891,203892,189336,14556,0.07139073627214408,2021-11-17 14:17:54 UTC
789054,mainnet,248,107136000,107340053,204054,189489,14565,0.07137816460348731,2021-11-17 14:19:26 UTC
789055,mainnet,248,107136000,107340222,204223,189653,14570,0.07134358030192485,2021-11-17 14:20:56 UTC
789057,mainnet,248,107136000,107340368,204369,189789,14580,0.07134154397193312,2021-11-17 14:22:27 UTC
789058,mainnet,248,107136000,107340548,204549,189947,14602,0.07138631819270688,2021-11-17 14:24:00 UTC
789060,mainnet,248,107136000,107340734,204735,190124,14611,0.07136542359635627,2021-11-17 14:25:44 UTC
789061,mainnet,248,107136000,107340923,204924,190292,14632,0.07140208077140793,2021-11-17 14:27:23 UTC
789063,mainnet,248,107136000,107341086,205087,190424,14663,0.07149648685679735,2021-11-17 14:29:07 UTC
789064,mainnet,248,107136000,107341223,205224,190553,14671,0.07148774022531477,2021-11-17 14:30:42 UTC
789066,mainnet,248,107136000,107341400,205401,190712,14689,0.07151377062429103,2021-11-17 14:32:14 UTC
789067,mainnet,248,107136000,107341568,205569,190872,14697,0.07149424280898385,2021-11-17 14:33:51 UTC
789069,mainnet,248,107136000,107341749,205750,191035,14715,0.07151883353584447,2021-11-17 14:35:33 UTC
789070,mainnet,248,107136000,107341922,205923,191194,14729,0.07152673572160467,2021-11-17 14:37:15 UTC
789072,mainnet,248,107136000,107342075,206076,191333,14743,0.07154156718880413,2021-11-17 14:38:43 UTC
789073,mainnet,248,107136000,107342249,206250,191492,14758,0.07155393939393939,2021-11-17 14:40:25 UTC
789075,mainnet,248,107136000,107342414,206415,191642,14773,0.07156941113775646,2021-11-17 14:41:54 UTC
789076,mainnet,248,107136000,107342587,206588,191807,14781,0.07154820221890913,2021-11-17 14:43:30 UTC
789078,mainnet,248,107136000,107342731,206732,191946,14786,0.07152255093551071,2021-11-17 14:44:57 UTC
789079,mainnet,248,107136000,107342892,206893,192100,14793,0.0715007274291542,2021-11-17 14:46:32 UTC
789081,mainnet,248,107136000,107343051,207052,192249,14803,0.07149411741977861,2021-11-17 14:48:01 UTC
789082,mainnet,248,107136000,107343212,207213,192398,14815,0.07149647946798705,2021-11-17 14:49:30 UTC
789083,mainnet,248,107136000,107343373,207374,192551,14823,0.07147954902736119,2021-11-17 14:50:59 UTC
789085,mainnet,248,107136000,107343573,207574,192734,14840,0.07149257614152062,2021-11-17 14:52:44 UTC
789086,mainnet,248,107136000,107343726,207727,192875,14852,0.07149768686786022,2021-11-17 14:54:13 UTC
789088,mainnet,248,107136000,107343900,207901,193042,14859,0.07147151769351759,2021-11-17 14:55:53 UTC
789089,mainnet,248,107136000,107344068,208069,193174,14895,0.07158682936910352,2021-11-17 14:57:22 UTC
789091,mainnet,248,107136000,107344287,208288,193371,14917,0.07161718389921647,2021-11-17 14:59:24 UTC
789092,mainnet,248,107136000,107344474,208475,193538,14937,0.07164887876244154,2021-11-17 15:01:14 UTC
789094,mainnet,248,107136000,107344651,208652,193690,14962,0.07170791557234055,2021-11-17 15:02:50 UTC
789095,mainnet,248,107136000,107344816,208817,193843,14974,0.07170872103324921,2021-11-17 15:04:21 UTC
789097,mainnet,248,107136000,107344983,208984,193993,14991,0.0717327642307545,2021-11-17 15:05:55 UTC
789098,mainnet,248,107136000,107345183,209184,194176,15008,0.07174544898271379,2021-11-17 15:07:48 UTC
789100,mainnet,248,107136000,107345359,209360,194340,15020,0.07174245319067635,2021-11-17 15:09:18 UTC
789101,mainnet,248,107136000,107345538,209539,194509,15030,0.07172889056452499,2021-11-17 15:11:00 UTC
789103,mainnet,248,107136000,107345730,209731,194688,15043,0.0717252099117441,2021-11-17 15:12:51 UTC
789104,mainnet,248,107136000,107346076,210077,195006,15071,0.07174036186731532,2021-11-17 15:14:33 UTC
789106,mainnet,248,107136000,107346118,210119,195048,15071,0.07172602192091149,2021-11-17 15:16:21 UTC
789107,mainnet,248,107136000,107346266,210267,195179,15088,0.07175638592836726,2021-11-17 15:17:50 UTC
789109,mainnet,248,107136000,107346512,210513,195385,15128,0.07186254530599061,2021-11-17 15:19:42 UTC
789111,mainnet,248,107136000,107346709,210710,195576,15134,0.07182383370509231,2021-11-17 15:21:45 UTC
789112,mainnet,248,107136000,107346872,210873,195714,15159,0.0718868702963395,2021-11-17 15:23:15 UTC
789114,mainnet,248,107136000,107347030,211031,195852,15179,0.07192782103103336,2021-11-17 15:24:50 UTC
789115,mainnet,248,107136000,107347182,211183,195991,15192,0.07193760861432975,2021-11-17 15:26:29 UTC
789117,mainnet,248,107136000,107347507,211508,196273,15235,0.0720303723736218,2021-11-17 15:28:04 UTC
789118,mainnet,248,107136000,107347680,211681,196440,15241,0.0719998488291344,2021-11-17 15:29:42 UTC
789120,mainnet,248,107136000,107347857,211858,196603,15255,0.07200577745471023,2021-11-17 15:31:23 UTC
789121,mainnet,248,107136000,107348041,212042,196777,15265,0.07199045472123447,2021-11-17 15:33:20 UTC
789123,mainnet,248,107136000,107348230,212231,196959,15272,0.07195932733672272,2021-11-17 15:35:01 UTC
789124,mainnet,248,107136000,107348422,212423,197149,15274,0.07190370157657128,2021-11-17 15:36:45 UTC
789126,mainnet,248,107136000,107348616,212617,197323,15294,0.07193215970500948,2021-11-17 15:38:26 UTC
789127,mainnet,248,107136000,107348791,212792,197493,15299,0.0718964998684161,2021-11-17 15:40:05 UTC
789129,mainnet,248,107136000,107348983,212984,197668,15316,0.07191150508958419,2021-11-17 15:41:47 UTC
789130,mainnet,248,107136000,107349150,213151,197825,15326,0.07190207880798119,2021-11-17 15:43:25 UTC
789132,mainnet,248,107136000,107349122,213123,197800,15323,0.07189744889101599,2021-11-17 15:45:00 UTC
789133,mainnet,248,107136000,107349524,213525,198109,15416,0.07219763493736096,2021-11-17 15:46:39 UTC
789135,mainnet,248,107136000,107349566,213567,198150,15417,0.07218811895096153,2021-11-17 15:48:13 UTC
789136,mainnet,248,107136000,107349744,213745,198293,15452,0.07229174951460852,2021-11-17 15:49:46 UTC
789137,mainnet,248,107136000,107349911,213912,198451,15461,0.07227738509293541,2021-11-17 15:51:21 UTC
789139,mainnet,248,107136000,107350075,214076,198608,15468,0.0722547132793961,2021-11-17 15:52:54 UTC
789140,mainnet,248,107136000,107350227,214228,198753,15475,0.07223612226226264,2021-11-17 15:54:26 UTC
789142,mainnet,248,107136000,107350393,214394,198900,15494,0.07226881349291492,2021-11-17 15:56:06 UTC
789143,mainnet,248,107136000,107350558,214559,199056,15503,0.0722551838888138,2021-11-17 15:57:40 UTC
789145,mainnet,248,107136000,107350845,214846,199323,15523,0.07225175241801104,2021-11-17 15:59:11 UTC
789146,mainnet,248,107136000,107351041,215042,199505,15537,0.0722510021298165,2021-11-17 16:01:02 UTC
789148,mainnet,248,107136000,107351226,215227,199676,15551,0.07225394583393348,2021-11-17 16:02:36 UTC
789149,mainnet,248,107136000,107351452,215453,199838,15615,0.07247520340863205,2021-11-17 16:04:07 UTC
789151,mainnet,248,107136000,107351620,215621,200044,15577,0.07224249957100654,2021-11-17 16:05:45 UTC
789152,mainnet,248,107136000,107351801,215802,200213,15589,0.07223751401747898,2021-11-17 16:07:21 UTC
789154,mainnet,248,107136000,107351971,215972,200375,15597,0.07221769488637415,2021-11-17 16:08:58 UTC
789155,mainnet,248,107136000,107352146,216147,200526,15621,0.07227026051714805,2021-11-17 16:10:37 UTC
789157,mainnet,248,107136000,107352302,216303,200679,15624,0.07223200787783804,2021-11-17 16:12:13 UTC
789158,mainnet,248,107136000,107352485,216486,200843,15643,0.07225871418937022,2021-11-17 16:13:49 UTC
789159,mainnet,248,107136000,107352644,216645,200992,15653,0.07225184056867225,2021-11-17 16:15:30 UTC
789161,mainnet,248,107136000,107352656,216657,201004,15653,0.07224783874972883,2021-11-17 16:16:58 UTC
789162,mainnet,248,107136000,107352913,216914,201222,15692,0.07234203417022414,2021-11-17 16:18:31 UTC
789164,mainnet,248,107136000,107352984,216985,201289,15696,0.0723367974744798,2021-11-17 16:20:03 UTC
789165,mainnet,248,107136000,107353144,217145,201437,15708,0.07233875981487024,2021-11-17 16:21:48 UTC
789167,mainnet,248,107136000,107353467,217468,201721,15747,0.07241065352143763,2021-11-17 16:23:25 UTC
789168,mainnet,248,107136000,107353504,217505,201750,15755,0.07243511643410497,2021-11-17 16:24:55 UTC
789170,mainnet,248,107136000,107353679,217680,201902,15778,0.07248254318265343,2021-11-17 16:26:26 UTC
789171,mainnet,248,107136000,107353831,217832,202037,15795,0.07251000771236549,2021-11-17 16:27:57 UTC
789173,mainnet,248,107136000,107353994,217995,202181,15814,0.07254294823275763,2021-11-17 16:29:29 UTC
789174,mainnet,248,107136000,107354168,218169,202335,15834,0.07257676388487824,2021-11-17 16:31:02 UTC
789176,mainnet,248,107136000,107354311,218312,202473,15839,0.07255212723075231,2021-11-17 16:32:33 UTC
789177,mainnet,248,107136000,107354491,218492,202639,15853,0.0725564322721198,2021-11-17 16:34:08 UTC
789179,mainnet,248,107136000,107354680,218681,202802,15879,0.07261261838019764,2021-11-17 16:36:01 UTC
789180,mainnet,248,107136000,107354831,218832,202942,15890,0.07261278058053666,2021-11-17 16:37:34 UTC
789182,mainnet,248,107136000,107354991,218992,203085,15907,0.07263735661576678,2021-11-17 16:39:07 UTC
789183,mainnet,248,107136000,107355176,219177,203247,15930,0.07268098386235781,2021-11-17 16:40:50 UTC
789185,mainnet,248,107136000,107355346,219347,203411,15936,0.0726520080055802,2021-11-17 16:42:20 UTC
789187,mainnet,248,107136000,107355524,219525,203572,15953,0.07267053866302244,2021-11-17 16:44:11 UTC
789188,mainnet,248,107136000,107355719,219720,203741,15979,0.07272437647915529,2021-11-17 16:45:42 UTC
789189,mainnet,248,107136000,107355914,219915,203918,15997,0.0727417411272537,2021-11-17 16:47:34 UTC
789191,mainnet,248,107136000,107356138,220139,204120,16019,0.07276766043272659,2021-11-17 16:49:04 UTC
789192,mainnet,248,107136000,107356306,220307,204267,16040,0.07280749136432342,2021-11-17 16:50:38 UTC
789194,mainnet,248,107136000,107356601,220602,204518,16084,0.07290958377530575,2021-11-17 16:52:17 UTC
789195,mainnet,248,107136000,107356791,220792,204704,16088,0.07286495887532157,2021-11-17 16:53:50 UTC
789197,mainnet,248,107136000,107356994,220995,204893,16102,0.07286137695422973,2021-11-17 16:55:37 UTC
789198,mainnet,248,107136000,107357179,221180,205074,16106,0.07281851885342255,2021-11-17 16:57:14 UTC
789200,mainnet,248,107136000,107357370,221371,205252,16119,0.07281441561902868,2021-11-17 16:58:50 UTC
789201,mainnet,248,107136000,107357426,221427,205308,16119,0.0727960004877454,2021-11-17 17:00:33 UTC
789202,mainnet,248,107136000,107357598,221599,205466,16133,0.07280267510232447,2021-11-17 17:02:07 UTC
789203,mainnet,248,107136000,107357911,221912,205750,16162,0.07283067161757814,2021-11-17 17:03:49 UTC
789205,mainnet,248,107136000,107358090,222091,205910,16181,0.0728575223669577,2021-11-17 17:06:39 UTC
789207,mainnet,248,107136000,107358291,222292,206098,16194,0.07285012506073094,2021-11-17 17:08:23 UTC
789208,mainnet,248,107136000,107358446,222447,206247,16200,0.07282633616097317,2021-11-17 17:09:47 UTC
789210,mainnet,248,107136000,107358624,222625,206412,16213,0.0728265019651881,2021-11-17 17:11:22 UTC
789211,mainnet,248,107136000,107358794,222795,206574,16221,0.07280684036894904,2021-11-17 17:13:06 UTC
789213,mainnet,248,107136000,107358989,222990,206748,16242,0.07283734696623168,2021-11-17 17:14:37 UTC
789214,mainnet,248,107136000,107359170,223171,206912,16259,0.07285444793454347,2021-11-17 17:16:04 UTC
789216,mainnet,248,107136000,107359341,223342,207067,16275,0.07287030652541841,2021-11-17 17:17:41 UTC
789217,mainnet,248,107136000,107359508,223509,207220,16289,0.0728784970627581,2021-11-17 17:19:06 UTC
789219,mainnet,248,107136000,107359663,223664,207359,16305,0.0728995278632234,2021-11-17 17:20:31 UTC
789220,mainnet,248,107136000,107359820,223821,207509,16312,0.07287966723408439,2021-11-17 17:21:58 UTC
789222,mainnet,248,107136000,107359985,223986,207657,16329,0.07290187779593367,2021-11-17 17:23:26 UTC
789223,mainnet,248,107136000,107360132,224133,207783,16350,0.07294775869684518,2021-11-17 17:24:51 UTC
789225,mainnet,248,107136000,107360314,224315,207957,16358,0.0729242360074003,2021-11-17 17:26:19 UTC
789226,mainnet,248,107136000,107360461,224462,208099,16363,0.07289875346383798,2021-11-17 17:27:43 UTC
789228,mainnet,248,107136000,107360612,224613,208239,16374,0.07289871913023734,2021-11-17 17:29:10 UTC
789229,mainnet,248,107136000,107360839,224840,208437,16403,0.07295410069382673,2021-11-17 17:30:56 UTC
789231,mainnet,248,107136000,107360965,224966,208551,16415,0.07296658161677765,2021-11-17 17:32:27 UTC
789232,mainnet,248,107136000,107361185,225186,208755,16431,0.07296634781913618,2021-11-17 17:33:53 UTC
789233,mainnet,248,107136000,107361377,225378,208931,16447,0.07297517947625766,2021-11-17 17:35:18 UTC
789234,mainnet,248,107136000,107361525,225526,209067,16459,0.07298049892251891,2021-11-17 17:36:44 UTC
789236,mainnet,248,107136000,107361717,225718,209253,16465,0.07294500217085036,2021-11-17 17:38:28 UTC
789237,mainnet,248,107136000,107361914,225915,209433,16482,0.07295664298519354,2021-11-17 17:40:20 UTC
789238,mainnet,248,107136000,107362216,226217,209709,16508,0.07297417965935363,2021-11-17 17:41:51 UTC
789240,mainnet,248,107136000,107362262,226263,209755,16508,0.07295934377251252,2021-11-17 17:43:28 UTC
789242,mainnet,248,107136000,107362567,226568,209944,16624,0.07337311535609618,2021-11-17 17:45:01 UTC
789243,mainnet,248,107136000,107362658,226659,210109,16550,0.07301717558093877,2021-11-17 17:46:31 UTC
789245,mainnet,248,107136000,107362782,226783,210221,16562,0.07303016540040479,2021-11-17 17:48:08 UTC
789246,mainnet,248,107136000,107362942,226943,210363,16580,0.0730579925355706,2021-11-17 17:49:34 UTC
789248,mainnet,248,107136000,107363136,227137,210547,16590,0.07303961926062244,2021-11-17 17:51:10 UTC
789249,mainnet,248,107136000,107363340,227341,210735,16606,0.07304445744498353,2021-11-17 17:53:07 UTC
789251,mainnet,248,107136000,107363616,227617,210986,16631,0.0730657200472724,2021-11-17 17:55:11 UTC
789253,mainnet,248,107136000,107363818,227819,211159,16660,0.07312822898880252,2021-11-17 17:56:58 UTC
789254,mainnet,248,107136000,107363974,227975,211311,16664,0.07309573418137953,2021-11-17 17:58:25 UTC
789256,mainnet,248,107136000,107364144,228145,211473,16672,0.07307633303381621,2021-11-17 17:59:51 UTC
789257,mainnet,248,107136000,107364321,228322,211646,16676,0.073037201846515,2021-11-17 18:01:25 UTC
789258,mainnet,248,107136000,107364486,228487,211803,16684,0.07301947156731017,2021-11-17 18:02:54 UTC
789259,mainnet,248,107136000,107364648,228649,211960,16689,0.07298960415309054,2021-11-17 18:04:24 UTC
789260,mainnet,248,107136000,107364827,228828,212133,16695,0.07295872882689182,2021-11-17 18:05:52 UTC
789262,mainnet,248,107136000,107364985,228986,212290,16696,0.07291275449154097,2021-11-17 18:07:21 UTC
789263,mainnet,248,107136000,107365153,229154,212436,16718,0.07295530516595826,2021-11-17 18:08:47 UTC
789265,mainnet,248,107136000,107365338,229339,212613,16726,0.0729313374524176,2021-11-17 18:10:29 UTC
789266,mainnet,248,107136000,107365506,229507,212779,16728,0.07288666576618578,2021-11-17 18:12:20 UTC
789268,mainnet,248,107136000,107365880,229881,213139,16742,0.07282898543159287,2021-11-17 18:13:59 UTC
789270,mainnet,248,107136000,107366003,230004,213261,16743,0.0727943861845881,2021-11-17 18:15:37 UTC
789271,mainnet,248,107136000,107366114,230115,213367,16748,0.07278100080394585,2021-11-17 18:17:18 UTC
789273,mainnet,248,107136000,107366478,230479,213710,16769,0.07275717093531298,2021-11-17 18:19:06 UTC
789274,mainnet,248,107136000,107366557,230558,213783,16775,0.07275826473165103,2021-11-17 18:20:40 UTC
789276,mainnet,248,107136000,107366819,230820,214031,16789,0.07273633134043844,2021-11-17 18:23:04 UTC
789278,mainnet,248,107136000,107367013,231014,214223,16791,0.07268390660306302,2021-11-17 18:24:54 UTC
789279,mainnet,248,107136000,107367182,231183,214379,16804,0.07268700553241371,2021-11-17 18:26:23 UTC
789281,mainnet,248,107136000,107367325,231326,214505,16821,0.0727155615884077,2021-11-17 18:27:48 UTC
789282,mainnet,248,107136000,107367584,231585,214746,16839,0.07271196321005247,2021-11-17 18:29:20 UTC
789284,mainnet,248,107136000,107367861,231862,215015,16847,0.07265959924437812,2021-11-17 18:30:57 UTC
789285,mainnet,248,107136000,107367938,231939,215092,16847,0.07263547743156606,2021-11-17 18:32:30 UTC
789287,mainnet,248,107136000,107368135,232136,215281,16855,0.07260829858358893,2021-11-17 18:34:15 UTC
789288,mainnet,248,107136000,107368457,232458,215588,16870,0.07257224961068236,2021-11-17 18:35:56 UTC
789290,mainnet,248,107136000,107368632,232633,215754,16879,0.07255634411283007,2021-11-17 18:37:33 UTC
789291,mainnet,248,107136000,107368820,232821,215840,16981,0.07293586059676747,2021-11-17 18:39:11 UTC
789293,mainnet,248,107136000,107368833,232834,215941,16893,0.07255383663897884,2021-11-17 18:40:43 UTC
789294,mainnet,248,107136000,107369161,233162,216249,16913,0.0725375490002659,2021-11-17 18:42:13 UTC
789295,mainnet,248,107136000,107369372,233373,216448,16925,0.07252338531021155,2021-11-17 18:43:54 UTC
789297,mainnet,248,107136000,107369573,233574,216640,16934,0.07249950765068029,2021-11-17 18:45:36 UTC
789298,mainnet,248,107136000,107369627,233628,216690,16938,0.07249987159073398,2021-11-17 18:47:11 UTC
789300,mainnet,248,107136000,107369824,233825,216873,16952,0.07249866353041805,2021-11-17 18:48:52 UTC
789301,mainnet,248,107136000,107370175,234176,217197,16979,0.07250529516261274,2021-11-17 18:50:47 UTC
789303,mainnet,248,107136000,107370230,234231,217246,16985,0.07251388586480867,2021-11-17 18:52:20 UTC
789304,mainnet,248,107136000,107370401,234402,217395,17007,0.0725548416822382,2021-11-17 18:53:56 UTC
789306,mainnet,248,107136000,107370778,234779,217752,17027,0.07252352212080297,2021-11-17 18:56:07 UTC
789307,mainnet,248,107136000,107370964,234965,217932,17033,0.07249164769220948,2021-11-17 18:57:46 UTC
789309,mainnet,248,107136000,107371160,235161,218105,17056,0.07252903330058981,2021-11-17 18:59:24 UTC
789310,mainnet,248,107136000,107371341,235342,218276,17066,0.07251574304629008,2021-11-17 19:01:07 UTC
789312,mainnet,248,107136000,107371528,235529,218453,17076,0.07250062624984609,2021-11-17 19:02:47 UTC
789314,mainnet,248,107365256,107371715,6460,6101,359,0.05557275541795666,2021-11-17 19:04:19 UTC
789315,mainnet,248,107136000,107371894,235895,218811,17084,0.07242205218423452,2021-11-17 19:05:56 UTC
789317,mainnet,248,107136000,107372077,236078,218977,17101,0.07243792305932785,2021-11-17 19:07:30 UTC
789318,mainnet,248,107136000,107372270,236271,219155,17116,0.07244223793863826,2021-11-17 19:09:02 UTC
789320,mainnet,248,107136000,107372432,236433,219310,17123,0.07242220840576401,2021-11-17 19:10:37 UTC
789321,mainnet,248,107136000,107372401,236402,219284,17118,0.0724105549022428,2021-11-17 19:12:11 UTC
789322,mainnet,248,107136000,107372776,236777,219630,17147,0.07241835144460822,2021-11-17 19:13:49 UTC
789324,mainnet,248,107136000,107372959,236960,219809,17151,0.07237930452397029,2021-11-17 19:15:22 UTC
789326,mainnet,248,107136000,107373189,237190,220033,17157,0.07233441544753151,2021-11-17 19:17:24 UTC
789327,mainnet,248,107136000,107373364,237365,220197,17168,0.07232742822235798,2021-11-17 19:18:56 UTC
789328,mainnet,248,107136000,107373528,237529,220347,17182,0.07233643049901275,2021-11-17 19:20:32 UTC
789329,mainnet,248,107136000,107373733,237734,220539,17195,0.07232873716001918,2021-11-17 19:22:28 UTC
789330,mainnet,248,107136000,107373934,237935,220727,17208,0.07232227288965473,2021-11-17 19:24:01 UTC
789332,mainnet,248,107136000,107374084,238085,220876,17209,0.0722809080790474,2021-11-17 19:25:35 UTC
789334,mainnet,248,107136000,107374293,238294,221072,17222,0.07227206727823612,2021-11-17 19:27:21 UTC
789335,mainnet,248,107136000,107374509,238510,221255,17255,0.07234497505345688,2021-11-17 19:29:12 UTC
789337,mainnet,248,107136000,107374699,238700,221433,17267,0.07233766233766234,2021-11-17 19:31:02 UTC
789338,mainnet,248,107136000,107374885,238886,221597,17289,0.07237343335314753,2021-11-17 19:32:42 UTC
789340,mainnet,248,107136000,107375076,239077,221781,17296,0.07234489306792373,2021-11-17 19:34:28 UTC
789341,mainnet,248,107136000,107375255,239256,221950,17306,0.07233256428260942,2021-11-17 19:36:17 UTC
789343,mainnet,248,107136000,107375560,239561,222233,17328,0.07233230784643577,2021-11-17 19:38:49 UTC
789345,mainnet,248,107136000,107375776,239777,222443,17334,0.07229217147599645,2021-11-17 19:40:35 UTC
789346,mainnet,248,107136000,107375978,239979,222635,17344,0.07227299055334008,2021-11-17 19:42:16 UTC
789348,mainnet,248,107136000,107376188,240189,222832,17357,0.07226392549200837,2021-11-17 19:44:05 UTC
789349,mainnet,248,107136000,107376385,240386,223008,17378,0.07229206359771367,2021-11-17 19:45:57 UTC
789351,mainnet,248,107136000,107376575,240576,223190,17386,0.07226822293163075,2021-11-17 19:47:34 UTC
789352,mainnet,248,107136000,107376747,240748,223350,17398,0.0722664362736139,2021-11-17 19:49:10 UTC
789353,mainnet,248,107136000,107376940,240941,223536,17405,0.07223760173652471,2021-11-17 19:50:53 UTC
789355,mainnet,248,107365256,107377136,11881,11181,700,0.0589175995286592,2021-11-17 19:52:32 UTC
789356,mainnet,248,107136000,107377300,241301,223874,17427,0.07222100198507259,2021-11-17 19:54:02 UTC
789357,mainnet,248,107136000,107377487,241488,224060,17428,0.07216921751805473,2021-11-17 19:55:37 UTC
789358,mainnet,248,107136000,107377693,241694,224251,17443,0.07216976838481716,2021-11-17 19:57:28 UTC
789360,mainnet,248,107136000,107377894,241895,224442,17453,0.07215113995741954,2021-11-17 19:59:17 UTC
789362,mainnet,248,107136000,107378078,242079,224610,17469,0.07216239326831324,2021-11-17 20:01:04 UTC
789363,mainnet,248,107136000,107378146,242147,224666,17481,0.07219168521600515,2021-11-17 20:03:08 UTC
789364,mainnet,248,107136000,107378311,242312,224809,17503,0.07223331902670936,2021-11-17 20:04:38 UTC
789366,mainnet,248,107136000,107378699,242700,225175,17525,0.07220848784507622,2021-11-17 20:07:04 UTC
789367,mainnet,248,107136000,107378897,242898,225370,17528,0.07216197745555748,2021-11-17 20:08:41 UTC
789369,mainnet,248,107136000,107379078,243079,225546,17533,0.0721288140892467,2021-11-17 20:10:21 UTC
789370,mainnet,248,107136000,107379288,243289,225743,17546,0.07211998898429439,2021-11-17 20:12:08 UTC
789372,mainnet,248,107136000,107379492,243493,225937,17556,0.07210063533653945,2021-11-17 20:13:41 UTC
789373,mainnet,248,107136000,107379668,243669,226107,17562,0.0720731812417665,2021-11-17 20:15:17 UTC
789375,mainnet,248,107136000,107379849,243850,226273,17577,0.07208119745745335,2021-11-17 20:16:53 UTC
789376,mainnet,248,107136000,107380044,244045,226453,17592,0.07208506627876006,2021-11-17 20:18:33 UTC
789378,mainnet,248,107136000,107380226,244227,226616,17611,0.07210914436159802,2021-11-17 20:20:12 UTC
789379,mainnet,248,107136000,107380447,244448,226823,17625,0.07210122398219662,2021-11-17 20:22:12 UTC
789381,mainnet,248,107136000,107380625,244626,226993,17633,0.07208146313147416,2021-11-17 20:23:54 UTC
789382,mainnet,248,107136000,107380852,244853,227196,17657,0.07211265534831103,2021-11-17 20:25:48 UTC
789384,mainnet,248,107136000,107381044,245045,227369,17676,0.07213368973045767,2021-11-17 20:27:25 UTC
789385,mainnet,248,107136000,107381232,245233,227543,17690,0.07213547931966742,2021-11-17 20:29:01 UTC
789386,mainnet,248,107136000,107381460,245461,227761,17700,0.07210921490583025,2021-11-17 20:31:01 UTC
789387,mainnet,248,107136000,107381677,245678,227969,17709,0.07208215631843307,2021-11-17 20:32:53 UTC
789389,mainnet,248,107136000,107381888,245889,228179,17710,0.07202436871921883,2021-11-17 20:34:44 UTC
789390,mainnet,248,107136000,107382072,246073,228337,17736,0.07207617251791135,2021-11-17 20:36:28 UTC
789392,mainnet,248,107136000,107382237,246238,228490,17748,0.0720766088093633,2021-11-17 20:38:05 UTC
789393,mainnet,248,107136000,107382395,246396,228646,17750,0.07203850711862206,2021-11-17 20:39:39 UTC
789395,mainnet,248,107136000,107382581,246582,228828,17754,0.07200038932282161,2021-11-17 20:41:18 UTC
789396,mainnet,248,107136000,107382760,246761,228999,17762,0.07198058039965796,2021-11-17 20:42:56 UTC
789398,mainnet,248,107365256,107382988,17733,16663,1070,0.060339480065414765,2021-11-17 20:44:49 UTC
789399,mainnet,248,107136000,107383043,247044,229250,17794,0.07202765499263289,2021-11-17 20:46:26 UTC
789400,mainnet,248,107136000,107383366,247367,229522,17845,0.07213977612211815,2021-11-17 20:48:15 UTC
789402,mainnet,248,107136000,107383410,247411,229566,17845,0.0721269466596069,2021-11-17 20:50:15 UTC
789404,mainnet,248,107136000,107383615,247616,229761,17855,0.0721076182476092,2021-11-17 20:51:48 UTC
789405,mainnet,248,107136000,107383845,247846,229982,17864,0.07207701556611767,2021-11-17 20:53:51 UTC
789407,mainnet,248,107136000,107384047,248048,230173,17875,0.07206266529058891,2021-11-17 20:55:42 UTC
789408,mainnet,248,107136000,107384364,248365,230464,17901,0.07207537293902119,2021-11-17 20:57:12 UTC
789410,mainnet,248,107136000,107384452,248453,230543,17910,0.07208606859245008,2021-11-17 20:58:39 UTC
789411,mainnet,248,107136000,107384645,248646,230716,17930,0.07211055074282313,2021-11-17 21:00:10 UTC
789413,mainnet,248,107136000,107384823,248824,230870,17954,0.07215541909140598,2021-11-17 21:01:49 UTC
789414,mainnet,248,107136000,107384987,248988,231020,17968,0.0721641203592141,2021-11-17 21:03:19 UTC
789416,mainnet,248,107136000,107385123,249124,231150,17974,0.07214880942823654,2021-11-17 21:04:46 UTC
789417,mainnet,248,107136000,107385287,249288,231301,17987,0.07215349314848689,2021-11-17 21:06:15 UTC
789418,mainnet,248,107136000,107385430,249431,231433,17998,0.07215622757395833,2021-11-17 21:07:45 UTC
789419,mainnet,248,107136000,107385590,249591,231570,18021,0.07220212267269252,2021-11-17 21:09:20 UTC
789420,mainnet,248,107136000,107385772,249773,231730,18043,0.07223759173329383,2021-11-17 21:11:14 UTC
789422,mainnet,248,107136000,107385990,249991,231932,18059,0.07223860058962123,2021-11-17 21:12:45 UTC
789423,mainnet,248,107136000,107386182,250183,232107,18076,0.07225111218587994,2021-11-17 21:14:22 UTC
789425,mainnet,248,107136000,107386439,250440,232352,18088,0.07222488420380131,2021-11-17 21:16:35 UTC
789426,mainnet,248,107136000,107386621,250622,232532,18090,0.07218041512716361,2021-11-17 21:18:07 UTC
789428,mainnet,248,107136000,107386817,250818,232700,18118,0.07223564496965927,2021-11-17 21:19:48 UTC
789429,mainnet,248,107136000,107386994,250995,232865,18130,0.07223251459192415,2021-11-17 21:21:32 UTC
789431,mainnet,248,107136000,107387232,251233,233067,18166,0.07230738000183097,2021-11-17 21:23:11 UTC
789433,mainnet,248,107136000,107387442,251443,233260,18183,0.07231460012806083,2021-11-17 21:25:01 UTC
789434,mainnet,248,107136000,107387661,251662,233462,18200,0.07231922181338461,2021-11-17 21:26:58 UTC
789436,mainnet,248,107136000,107387832,251833,233628,18205,0.072289969940397,2021-11-17 21:28:33 UTC
789437,mainnet,248,107136000,107388009,252010,233758,18252,0.07242569739296059,2021-11-17 21:30:04 UTC
789439,mainnet,248,107136000,107388200,252201,233930,18271,0.07244618379784379,2021-11-17 21:31:53 UTC
789440,mainnet,248,107136000,107388366,252367,234088,18279,0.07243023057689793,2021-11-17 21:33:21 UTC
789441,mainnet,248,107136000,107388534,252535,234248,18287,0.07241372483022156,2021-11-17 21:34:53 UTC
789443,mainnet,248,107136000,107388884,252885,234575,18310,0.0724044526168021,2021-11-17 21:36:25 UTC
789444,mainnet,248,107136000,107389054,253055,234729,18326,0.07241903933927407,2021-11-17 21:37:58 UTC
789446,mainnet,248,107136000,107389262,253263,234925,18338,0.072406944559608,2021-11-17 21:39:30 UTC
789447,mainnet,248,107136000,107389450,253451,235110,18341,0.07236507253867612,2021-11-17 21:41:09 UTC
789448,mainnet,248,107136000,107389688,253689,235334,18355,0.07235236845113505,2021-11-17 21:43:11 UTC
789450,mainnet,248,107136000,107389868,253869,235508,18361,0.0723247028979513,2021-11-17 21:44:48 UTC
789451,mainnet,248,107136000,107390046,254047,235678,18369,0.07230551827024133,2021-11-17 21:46:19 UTC
789452,mainnet,248,107136000,107390232,254233,235843,18390,0.07233522005404491,2021-11-17 21:48:10 UTC
789453,mainnet,248,107136000,107390232,254233,235843,18390,0.07233522005404491,2021-11-17 21:49:37 UTC
789455,mainnet,248,107136000,107390520,254521,236107,18414,0.07234766482922823,2021-11-17 21:51:18 UTC
789457,mainnet,248,107136000,107390685,254686,236268,18418,0.07231649953275798,2021-11-17 21:52:46 UTC
789458,mainnet,248,107136000,107390872,254873,236446,18427,0.07229875271213507,2021-11-17 21:54:20 UTC
789460,mainnet,248,107136000,107391040,255041,236601,18440,0.07230210044659487,2021-11-17 21:55:49 UTC
789461,mainnet,248,107136000,107391225,255226,236780,18446,0.07227320100616709,2021-11-17 21:57:27 UTC
789463,mainnet,248,107136000,107391409,255410,236943,18467,0.07230335538937395,2021-11-17 21:58:55 UTC
789464,mainnet,248,107136000,107391627,255628,237139,18489,0.0723277575226501,2021-11-17 22:00:48 UTC
789465,mainnet,248,107136000,107391832,255833,237311,18522,0.07239879139907675,2021-11-17 22:02:56 UTC
789467,mainnet,248,107136000,107392033,256034,237491,18543,0.07242397494082817,2021-11-17 22:04:28 UTC
789468,mainnet,248,107136000,107392242,256243,237684,18559,0.07242734435672389,2021-11-17 22:06:17 UTC
789470,mainnet,248,107136000,107392406,256407,237844,18563,0.07239661943706685,2021-11-17 22:07:49 UTC
789471,mainnet,248,107136000,107392572,256573,238005,18568,0.0723692672260916,2021-11-17 22:09:21 UTC
789473,mainnet,248,107136000,107392776,256777,238194,18583,0.07237018891878945,2021-11-17 22:11:04 UTC
789474,mainnet,248,107136000,107392954,256955,238359,18596,0.07237064855714036,2021-11-17 22:12:34 UTC
789476,mainnet,248,107136000,107393131,257132,238535,18597,0.07232472037708258,2021-11-17 22:14:06 UTC
789477,mainnet,248,107136000,107393314,257315,238709,18606,0.07230826030351903,2021-11-17 22:15:33 UTC
789478,mainnet,248,107136000,107393462,257463,238853,18610,0.07228223084482042,2021-11-17 22:17:00 UTC
789479,mainnet,248,107136000,107393675,257676,239048,18628,0.07229233611201664,2021-11-17 22:18:30 UTC
789480,mainnet,248,107136000,107393836,257837,239192,18645,0.07231312806152725,2021-11-17 22:19:59 UTC
789482,mainnet,248,107136000,107394018,258019,239355,18664,0.07233575821935594,2021-11-17 22:21:27 UTC
789483,mainnet,248,107136000,107394163,258164,239494,18670,0.07231837126787623,2021-11-17 22:22:55 UTC
789484,mainnet,248,107136000,107394339,258340,239660,18680,0.07230781141131842,2021-11-17 22:24:24 UTC
789486,mainnet,248,107136000,107394518,258519,239832,18687,0.0722848223921646,2021-11-17 22:25:53 UTC
789487,mainnet,248,107136000,107394671,258672,239980,18692,0.07226139667223357,2021-11-17 22:27:21 UTC
789489,mainnet,248,107136000,107394824,258825,240121,18704,0.07226504394861392,2021-11-17 22:28:49 UTC
789490,mainnet,248,107136000,107395071,259072,240349,18723,0.07226948493083003,2021-11-17 22:30:17 UTC
789491,mainnet,248,107136000,107395247,259248,240500,18748,0.07231685490341294,2021-11-17 22:31:51 UTC
789492,mainnet,248,107136000,107395430,259431,240678,18753,0.07228511627369127,2021-11-17 22:33:27 UTC
789493,mainnet,248,107136000,107395662,259663,240889,18774,0.07230140605323053,2021-11-17 22:35:17 UTC
789494,mainnet,248,107136000,107395878,259879,241100,18779,0.07226055202613524,2021-11-17 22:37:06 UTC
789495,mainnet,248,107136000,107396073,260074,241276,18798,0.07227942816275368,2021-11-17 22:38:40 UTC
789496,mainnet,248,107136000,107396259,260260,241456,18804,0.07225082609697994,2021-11-17 22:40:13 UTC
789497,mainnet,248,107136000,107396454,260455,241651,18804,0.07219673264095525,2021-11-17 22:41:50 UTC
789499,mainnet,248,107136000,107396678,260679,241852,18827,0.07222292551375446,2021-11-17 22:43:41 UTC
789500,mainnet,248,107136000,107396891,260892,242045,18847,0.0722406206399583,2021-11-17 22:45:20 UTC
789502,mainnet,248,107136000,107397134,261135,242283,18852,0.0721925440863921,2021-11-17 22:47:20 UTC
789504,mainnet,248,107136000,107397352,261353,242485,18868,0.07219354665911622,2021-11-17 22:49:03 UTC
789505,mainnet,248,107136000,107397523,261524,242650,18874,0.07216928465456325,2021-11-17 22:50:33 UTC
789507,mainnet,248,107136000,107397693,261694,242803,18891,0.07218736386772337,2021-11-17 22:52:00 UTC
789508,mainnet,248,107136000,107397875,261876,242968,18908,0.07220211092272678,2021-11-17 22:53:30 UTC
789510,mainnet,248,107136000,107398074,262075,243150,18925,0.07221215300963464,2021-11-17 22:55:02 UTC
789512,mainnet,248,107136000,107398265,262266,243312,18954,0.07227013795154538,2021-11-17 22:56:32 UTC
789513,mainnet,248,107136000,107398442,262443,243469,18974,0.07229760367013027,2021-11-17 22:58:03 UTC
789515,mainnet,248,107136000,107398613,262614,243628,18986,0.07229622183128089,2021-11-17 22:59:31 UTC
789516,mainnet,248,107136000,107398796,262797,243802,18995,0.07228012496337477,2021-11-17 23:01:03 UTC
789518,mainnet,248,107136000,107398964,262965,243963,19002,0.07226056699560778,2021-11-17 23:02:32 UTC
789519,mainnet,248,107136000,107399158,263159,244139,19020,0.07227569644207495,2021-11-17 23:04:05 UTC
789520,mainnet,248,107136000,107399324,263325,244301,19024,0.07224532421912086,2021-11-17 23:05:33 UTC
789522,mainnet,248,107136000,107399500,263501,244447,19054,0.07231092102117259,2021-11-17 23:07:02 UTC
789523,mainnet,248,107136000,107399679,263680,244613,19067,0.07231113470873786,2021-11-17 23:08:30 UTC
789525,mainnet,248,107136000,107399854,263855,244770,19085,0.07233139413693127,2021-11-17 23:09:58 UTC
789527,mainnet,248,107136000,107400040,264041,244941,19100,0.07233725065425445,2021-11-17 23:11:33 UTC
789528,mainnet,248,107136000,107400205,264206,245102,19104,0.07230721482479581,2021-11-17 23:13:00 UTC
789529,mainnet,248,107136000,107400391,264392,245264,19128,0.07234712094163212,2021-11-17 23:14:31 UTC
789531,mainnet,248,107136000,107400563,264564,245413,19151,0.0723870216658351,2021-11-17 23:16:02 UTC
789532,mainnet,248,107136000,107400760,264761,245590,19171,0.07240870067721454,2021-11-17 23:17:32 UTC
789534,mainnet,248,107136000,107400936,264937,245758,19179,0.07239079479272431,2021-11-17 23:19:00 UTC
789535,mainnet,248,107136000,107401124,265125,245938,19187,0.07236963696369637,2021-11-17 23:20:32 UTC
789537,mainnet,248,107136000,107401297,265298,246098,19200,0.07237144644889898,2021-11-17 23:22:02 UTC
789539,mainnet,248,107136000,107401543,265544,246317,19227,0.07240607959509535,2021-11-17 23:24:05 UTC
789540,mainnet,248,107136000,107401718,265719,246486,19233,0.07238097388594718,2021-11-17 23:25:34 UTC
789542,mainnet,248,107136000,107401912,265913,246676,19237,0.07234320999725474,2021-11-17 23:27:14 UTC
789543,mainnet,248,107136000,107402100,266101,246848,19253,0.07235222716186711,2021-11-17 23:28:45 UTC
789545,mainnet,248,107136000,107402342,266343,247070,19273,0.07236157886634903,2021-11-17 23:30:50 UTC
789547,mainnet,248,107136000,107402513,266514,247222,19292,0.07238644123760853,2021-11-17 23:32:16 UTC
789548,mainnet,248,107136000,107402702,266703,247395,19308,0.07239513616269783,2021-11-17 23:33:47 UTC
789549,mainnet,248,107136000,107402926,266927,247610,19317,0.07236810064174849,2021-11-17 23:35:40 UTC
789551,mainnet,248,107136000,107403128,267129,247795,19334,0.07237701634790682,2021-11-17 23:37:13 UTC
789552,mainnet,248,107136000,107403364,267365,248014,19351,0.07237671348157014,2021-11-17 23:39:03 UTC
789554,mainnet,248,107136000,107403541,267542,248186,19356,0.07234751926800279,2021-11-17 23:40:36 UTC
789555,mainnet,248,107136000,107403736,267737,248368,19369,0.07234338175149493,2021-11-17 23:42:18 UTC
789557,mainnet,248,107136000,107403927,267928,248543,19385,0.0723515272759846,2021-11-17 23:43:51 UTC
789558,mainnet,248,107136000,107404108,268109,248707,19402,0.07236608991119284,2021-11-17 23:45:22 UTC
789560,mainnet,248,107136000,107404293,268294,248884,19410,0.07234600848323108,2021-11-17 23:46:56 UTC
789561,mainnet,248,107136000,107404456,268457,249047,19410,0.07230208189765959,2021-11-17 23:48:24 UTC
789563,mainnet,248,107136000,107404605,268606,249183,19423,0.07231037281371228,2021-11-17 23:49:57 UTC
789564,mainnet,248,107136000,107404776,268777,249337,19440,0.07232761731844614,2021-11-17 23:51:25 UTC
789565,mainnet,248,107136000,107404959,268960,249508,19452,0.07232302201070791,2021-11-17 23:52:54 UTC
789567,mainnet,248,107136000,107405126,269127,249655,19472,0.07235245813314903,2021-11-17 23:54:22 UTC
789568,mainnet,248,107136000,107405300,269301,249818,19483,0.07234655645541606,2021-11-17 23:55:53 UTC
789570,mainnet,248,107136000,107405468,269469,249978,19491,0.07233114013114682,2021-11-17 23:57:20 UTC
789571,mainnet,248,107136000,107405646,269647,250141,19506,0.07233902101636584,2021-11-17 23:58:50 UTC
789573,mainnet,248,107136000,107405812,269813,250305,19508,0.0723019276313595,2021-11-18 00:00:25 UTC
789574,mainnet,248,107136000,107405966,269967,250451,19516,0.07229031696466605,2021-11-18 00:01:53 UTC
789575,mainnet,248,107136000,107406112,270113,250569,19544,0.07235490331824089,2021-11-18 00:03:26 UTC
789577,mainnet,248,107136000,107406273,270274,250713,19561,0.07237470122912304,2021-11-18 00:04:52 UTC
789578,mainnet,248,107136000,107406407,270408,250837,19571,0.07237581728351232,2021-11-18 00:06:21 UTC
789580,mainnet,248,107136000,107406576,270577,250997,19580,0.07236387423912602,2021-11-18 00:08:14 UTC
789581,mainnet,248,107136000,107406736,270737,251139,19598,0.07238759386415598,2021-11-18 00:09:40 UTC
789583,mainnet,248,107136000,107406920,270921,251305,19616,0.07240487079259267,2021-11-18 00:11:25 UTC
789584,mainnet,248,107136000,107407081,271082,251449,19633,0.0724245800163788,2021-11-18 00:12:54 UTC
789586,mainnet,248,107136000,107407238,271239,251593,19646,0.07243058704684799,2021-11-18 00:14:28 UTC
789587,mainnet,248,107136000,107407468,271469,251811,19658,0.07241342473726282,2021-11-18 00:16:30 UTC
789589,mainnet,248,107136000,107407650,271651,251988,19663,0.07238331535683652,2021-11-18 00:18:13 UTC
789591,mainnet,248,107136000,107407815,271816,252151,19665,0.07234673455572888,2021-11-18 00:19:45 UTC
789592,mainnet,248,107136000,107408118,272119,252414,19705,0.07241317217834844,2021-11-18 00:21:17 UTC
789594,mainnet,248,107136000,107408132,272133,252427,19706,0.07241312152513661,2021-11-18 00:22:54 UTC
789595,mainnet,248,107136000,107408482,272483,252751,19732,0.07241552684020655,2021-11-18 00:24:37 UTC
789597,mainnet,248,107136000,107408687,272688,252943,19745,0.07240876019480139,2021-11-18 00:26:20 UTC
789598,mainnet,248,107136000,107408878,272879,253122,19757,0.07240205365748188,2021-11-18 00:27:56 UTC
789600,mainnet,248,107136000,107409085,273086,253323,19763,0.07236914378620654,2021-11-18 00:29:43 UTC
789601,mainnet,248,107136000,107409293,273294,253527,19767,0.07232870095940636,2021-11-18 00:31:27 UTC
789603,mainnet,248,107136000,107409493,273494,253718,19776,0.07230871609614836,2021-11-18 00:33:06 UTC
789604,mainnet,248,107136000,107409697,273698,253908,19790,0.07230597227601225,2021-11-18 00:34:45 UTC
789606,mainnet,248,107136000,107409875,273876,254078,19798,0.0722881888153763,2021-11-18 00:36:22 UTC
789608,mainnet,248,107136000,107410084,274085,254269,19816,0.07229873944214386,2021-11-18 00:37:56 UTC
789609,mainnet,248,107136000,107410271,274272,254447,19825,0.07228225994633065,2021-11-18 00:39:33 UTC
789611,mainnet,248,107136000,107410448,274449,254614,19835,0.0722720796942237,2021-11-18 00:41:05 UTC
789612,mainnet,248,107136000,107410613,274614,254778,19836,0.07223229696956456,2021-11-18 00:42:42 UTC
789614,mainnet,248,107148443,107410794,262352,243438,18914,0.07209398060620845,2021-11-18 00:44:19 UTC
789615,mainnet,248,107136000,107410988,274989,255137,19852,0.07219197858823444,2021-11-18 00:45:57 UTC
789617,mainnet,248,107136000,107411164,275165,255295,19870,0.07221121872331147,2021-11-18 00:47:34 UTC
789618,mainnet,248,107136000,107411343,275344,255465,19879,0.07219696089255621,2021-11-18 00:49:05 UTC
789620,mainnet,248,107136000,107411532,275533,255639,19894,0.07220187781499857,2021-11-18 00:50:42 UTC
789621,mainnet,248,107136000,107411717,275718,255816,19902,0.0721824472830936,2021-11-18 00:52:16 UTC
789622,mainnet,248,107136000,107411905,275906,255992,19914,0.07217675585163062,2021-11-18 00:53:52 UTC
789623,mainnet,248,107136000,107412104,276105,256190,19915,0.07212835696564712,2021-11-18 00:55:31 UTC
789625,mainnet,248,107136000,107412284,276285,256361,19924,0.07211394031525417,2021-11-18 00:57:19 UTC
789626,mainnet,248,107136000,107412532,276533,256588,19945,0.0721252074797583,2021-11-18 00:59:09 UTC
789628,mainnet,248,107136000,107412764,276765,256803,19962,0.07212617202319657,2021-11-18 01:01:00 UTC
789629,mainnet,248,107136000,107413012,277013,257031,19982,0.07213379877478675,2021-11-18 01:03:12 UTC
789631,mainnet,248,107136000,107413226,277227,257234,19993,0.07211779516425168,2021-11-18 01:05:01 UTC
789632,mainnet,248,107136000,107413458,277459,257442,20017,0.07214399244573072,2021-11-18 01:06:51 UTC
789634,mainnet,248,107136000,107413709,277710,257659,20051,0.07220121709697166,2021-11-18 01:08:59 UTC
789636,mainnet,248,107136000,107413951,277952,257887,20065,0.0721887232327884,2021-11-18 01:11:05 UTC
789637,mainnet,248,107136000,107414206,278207,258137,20070,0.07214052845543067,2021-11-18 01:13:22 UTC
789639,mainnet,248,107136000,107414431,278432,258345,20087,0.07214328812780141,2021-11-18 01:15:16 UTC
789641,mainnet,248,107136000,107414640,278641,258540,20101,0.072139419539838,2021-11-18 01:17:06 UTC
789642,mainnet,248,107136000,107414872,278873,258751,20122,0.07215470841565874,2021-11-18 01:19:23 UTC
789644,mainnet,248,107136000,107415084,279085,258945,20140,0.07216439436014117,2021-11-18 01:21:08 UTC
789645,mainnet,248,107136000,107415294,279295,259143,20152,0.07215309976906138,2021-11-18 01:22:49 UTC
789647,mainnet,248,107136000,107415477,279478,259312,20166,0.07215594787425128,2021-11-18 01:24:30 UTC
789648,mainnet,248,107136000,107415523,279524,259354,20170,0.07215838353772842,2021-11-18 01:26:11 UTC
789650,mainnet,248,107136000,107415853,279854,259646,20208,0.07220908044909131,2021-11-18 01:27:49 UTC
789651,mainnet,248,107136000,107415928,279929,259711,20218,0.07222545716949655,2021-11-18 01:29:25 UTC
789653,mainnet,248,107136000,107416162,280163,259944,20219,0.07216870179145711,2021-11-18 01:31:19 UTC
789654,mainnet,248,107136000,107416324,280325,260097,20228,0.07215910104343173,2021-11-18 01:32:49 UTC
789656,mainnet,248,107136000,107416508,280509,260273,20236,0.07214028783390194,2021-11-18 01:34:42 UTC
789658,mainnet,248,107136000,107416746,280747,260475,20272,0.07220736107598656,2021-11-18 01:36:28 UTC
789659,mainnet,248,107136000,107416915,280916,260633,20283,0.07220307850033462,2021-11-18 01:38:06 UTC
789661,mainnet,248,107136000,107417116,281117,260823,20294,0.07219058256882366,2021-11-18 01:39:49 UTC
789662,mainnet,248,107136000,107417309,281310,261012,20298,0.07215527354164444,2021-11-18 01:41:29 UTC
789664,mainnet,248,107136000,107417490,281491,261172,20319,0.07218348011126466,2021-11-18 01:43:12 UTC
789665,mainnet,248,107155541,107417880,262340,243798,18542,0.07067927117481132,2021-11-18 01:45:02 UTC
789667,mainnet,248,107136000,107418092,282093,261744,20349,0.07213578500707214,2021-11-18 01:46:44 UTC
789668,mainnet,248,107136000,107418118,282119,261770,20349,0.07212913699538138,2021-11-18 01:48:17 UTC
789670,mainnet,248,107136000,107418308,282309,261946,20363,0.07213018359315501,2021-11-18 01:50:01 UTC
789672,mainnet,248,107136000,107418548,282549,262168,20381,0.07213262124445671,2021-11-18 01:52:05 UTC
789673,mainnet,248,107136000,107418748,282749,262346,20403,0.0721594063993153,2021-11-18 01:53:53 UTC
789675,mainnet,248,107136000,107418970,282971,262549,20422,0.07216993967579717,2021-11-18 01:55:25 UTC
789676,mainnet,248,107136000,107419151,283152,262726,20426,0.07213793298299147,2021-11-18 01:56:54 UTC
789677,mainnet,248,107136000,107419345,283346,262904,20442,0.07214500998778878,2021-11-18 01:58:28 UTC
789679,mainnet,248,107136000,107419476,283477,263035,20442,0.07211167043534396,2021-11-18 01:59:59 UTC
789680,mainnet,248,107136000,107419716,283717,263258,20459,0.0721105890729142,2021-11-18 02:01:38 UTC
789681,mainnet,248,107136000,107419929,283930,263443,20487,0.07215510865354137,2021-11-18 02:03:11 UTC
789683,mainnet,248,107136000,107420116,284117,263602,20515,0.07220616858547711,2021-11-18 02:04:43 UTC
789684,mainnet,248,107136000,107420290,284291,263766,20525,0.07219715010323928,2021-11-18 02:06:15 UTC
789686,mainnet,248,107136000,107420446,284447,263917,20530,0.07217513280154124,2021-11-18 02:07:46 UTC
789687,mainnet,248,107136000,107420618,284619,264081,20538,0.07215962391829077,2021-11-18 02:09:17 UTC
789689,mainnet,248,107136000,107420804,284805,264250,20555,0.07217218798827268,2021-11-18 02:10:49 UTC
789690,mainnet,248,107136000,107420976,284977,264408,20569,0.07217775469599301,2021-11-18 02:12:21 UTC
789692,mainnet,248,107136000,107421148,285149,264574,20575,0.0721552591802882,2021-11-18 02:13:54 UTC
789693,mainnet,248,107136000,107421353,285354,264757,20597,0.07218051963526007,2021-11-18 02:15:30 UTC
789695,mainnet,248,107136000,107421523,285524,264908,20616,0.07220408792255642,2021-11-18 02:17:02 UTC
789696,mainnet,248,107136000,107421714,285715,265086,20629,0.07220131949670126,2021-11-18 02:18:36 UTC
789698,mainnet,248,107136000,107421906,285907,265242,20665,0.07227874798448447,2021-11-18 02:20:11 UTC
789699,mainnet,248,107136000,107422064,286065,265391,20674,0.07227028822120847,2021-11-18 02:21:44 UTC
789701,mainnet,248,107136000,107422247,286248,265562,20686,0.07226600709873955,2021-11-18 02:23:20 UTC
789702,mainnet,248,107136000,107422434,286435,265740,20695,0.07225024874753434,2021-11-18 02:24:52 UTC
789704,mainnet,248,107136000,107422596,286597,265898,20699,0.07222336591101791,2021-11-18 02:26:23 UTC
789705,mainnet,248,107136000,107422776,286777,266078,20699,0.07217803380326875,2021-11-18 02:28:03 UTC
789707,mainnet,248,107136000,107422962,286963,266252,20711,0.07217306760801916,2021-11-18 02:29:42 UTC
789708,mainnet,248,107136000,107423314,287315,266588,20727,0.07214033377999757,2021-11-18 02:31:19 UTC
789710,mainnet,248,107136000,107423494,287495,266767,20728,0.07209864519382946,2021-11-18 02:32:50 UTC
789711,mainnet,248,107136000,107423678,287679,266939,20740,0.07209424393160432,2021-11-18 02:34:21 UTC
789713,mainnet,248,107136000,107423713,287714,266974,20740,0.07208547376909014,2021-11-18 02:36:04 UTC
789714,mainnet,248,107136000,107424050,288051,267288,20763,0.07208098565878959,2021-11-18 02:37:38 UTC
789716,mainnet,248,107136000,107424112,288113,267342,20771,0.07209324119355948,2021-11-18 02:39:22 UTC
789718,mainnet,248,107136000,107424300,288301,267520,20781,0.07208091543213517,2021-11-18 02:40:58 UTC
789719,mainnet,248,107136000,107424472,288473,267681,20792,0.0720760695108381,2021-11-18 02:42:28 UTC
789721,mainnet,248,107136000,107424664,288665,267857,20808,0.07208355706441723,2021-11-18 02:43:59 UTC
789722,mainnet,248,107136000,107424834,288835,268006,20829,0.07211383661952325,2021-11-18 02:45:33 UTC
789724,mainnet,248,107136000,107424986,288987,268153,20834,0.07209320834501205,2021-11-18 02:47:06 UTC
789725,mainnet,248,107136000,107425315,289316,268442,20874,0.07214948360961716,2021-11-18 02:48:38 UTC
789727,mainnet,248,107136000,107425393,289394,268516,20878,0.07214385923688812,2021-11-18 02:50:09 UTC
789728,mainnet,248,107136000,107425570,289571,268680,20891,0.07214465536949487,2021-11-18 02:51:40 UTC
789730,mainnet,248,107136000,107425729,289730,268819,20911,0.0721740931211818,2021-11-18 02:53:12 UTC
789731,mainnet,248,107136000,107425910,289911,268984,20927,0.07218422205435461,2021-11-18 02:54:45 UTC
789733,mainnet,248,107136000,107426082,290083,269144,20939,0.07218278906381967,2021-11-18 02:56:17 UTC
789734,mainnet,248,107136000,107426265,290266,269313,20953,0.07218551259878869,2021-11-18 02:57:48 UTC
789735,mainnet,248,107136000,107426435,290436,269474,20962,0.07217424837141401,2021-11-18 02:59:20 UTC
789737,mainnet,248,107136000,107426615,290616,269648,20968,0.07215019131775263,2021-11-18 03:00:53 UTC
789738,mainnet,248,107136000,107426811,290812,269830,20982,0.07214970496403175,2021-11-18 03:02:38 UTC
789740,mainnet,248,107136000,107426971,290972,269972,21000,0.0721718928281759,2021-11-18 03:04:10 UTC
789742,mainnet,248,107136000,107427216,291217,270193,21024,0.07219358759962502,2021-11-18 03:06:06 UTC
789743,mainnet,248,107136000,107427377,291378,270354,21024,0.07215369725923028,2021-11-18 03:07:35 UTC
789745,mainnet,248,107136000,107427572,291573,270541,21032,0.07213287924464885,2021-11-18 03:09:12 UTC
789746,mainnet,248,107136000,107427760,291761,270720,21041,0.07211724665051189,2021-11-18 03:10:55 UTC
789748,mainnet,248,107136000,107427941,291942,270896,21046,0.07208966164512129,2021-11-18 03:12:40 UTC
789749,mainnet,248,107136000,107428150,292151,271085,21066,0.07210654764145938,2021-11-18 03:14:11 UTC
789751,mainnet,248,107136000,107428386,292387,271300,21087,0.07212016950138002,2021-11-18 03:16:17 UTC
789752,mainnet,248,107136000,107428573,292574,271470,21104,0.07213217852577468,2021-11-18 03:17:51 UTC
789754,mainnet,248,107136000,107428756,292757,271637,21120,0.07214174212742992,2021-11-18 03:19:37 UTC
789756,mainnet,248,107136000,107428983,292984,271850,21134,0.07213363187068236,2021-11-18 03:21:29 UTC
789757,mainnet,248,107136000,107429151,293152,272011,21141,0.07211617181530401,2021-11-18 03:23:02 UTC
789759,mainnet,248,107136000,107429351,293352,272207,21145,0.07208064032288854,2021-11-18 03:24:49 UTC
789760,mainnet,248,107136000,107429524,293525,272358,21167,0.07211310791244357,2021-11-18 03:26:20 UTC
789762,mainnet,248,107136000,107429810,293811,272634,21177,0.0720769474253857,2021-11-18 03:27:48 UTC
789763,mainnet,248,107136000,107429881,293882,272689,21193,0.07211397771894842,2021-11-18 03:29:19 UTC
789765,mainnet,248,107136000,107430053,294054,272850,21204,0.07210920443183905,2021-11-18 03:30:50 UTC
789766,mainnet,248,107136000,107430215,294216,272996,21220,0.07212388177393479,2021-11-18 03:32:16 UTC
789767,mainnet,248,107136000,107430388,294389,273167,21222,0.07208829134240749,2021-11-18 03:33:50 UTC
789768,mainnet,248,107136000,107430562,294563,273328,21235,0.07208984156190697,2021-11-18 03:35:20 UTC
789770,mainnet,248,107136000,107430718,294719,273473,21246,0.07208900681666265,2021-11-18 03:36:52 UTC
789771,mainnet,248,107136000,107430907,294908,273641,21267,0.07211401521830536,2021-11-18 03:38:23 UTC
789772,mainnet,248,107136000,107431097,295098,273818,21280,0.0721116374899186,2021-11-18 03:39:54 UTC
789773,mainnet,248,107136000,107431282,295283,274002,21281,0.07206984486069297,2021-11-18 03:41:31 UTC
789775,mainnet,248,107136000,107431468,295469,274180,21289,0.07205155193945896,2021-11-18 03:43:03 UTC
789776,mainnet,248,107136000,107431636,295637,274343,21294,0.07202752023596505,2021-11-18 03:44:30 UTC
789777,mainnet,248,107136000,107431835,295836,274526,21310,0.07203315350396841,2021-11-18 03:45:59 UTC
789778,mainnet,248,107136000,107432005,296006,274683,21323,0.07203570197901393,2021-11-18 03:47:32 UTC
789779,mainnet,248,107136000,107432185,296186,274850,21336,0.07203581533225743,2021-11-18 03:49:12 UTC
789780,mainnet,248,107136000,107432360,296361,275021,21340,0.07200677552039574,2021-11-18 03:50:43 UTC
789782,mainnet,248,107136000,107432537,296538,275182,21356,0.07201775151919822,2021-11-18 03:52:13 UTC
789784,mainnet,248,107136000,107432693,296694,275333,21361,0.0719967373792527,2021-11-18 03:53:46 UTC
789785,mainnet,248,107136000,107433023,297024,275639,21385,0.07199754901960784,2021-11-18 03:55:24 UTC
789787,mainnet,248,107365256,107433218,67963,63288,4675,0.06878742845371746,2021-11-18 03:57:15 UTC
789788,mainnet,248,107136000,107433480,297481,276075,21406,0.07195753678386183,2021-11-18 03:59:14 UTC
789790,mainnet,248,107136000,107433655,297656,276247,21409,0.071925309753541,2021-11-18 04:00:55 UTC
789791,mainnet,248,107136000,107433674,297675,276266,21409,0.07192071890484589,2021-11-18 04:02:50 UTC
789793,mainnet,248,107136000,107434039,298040,276578,21462,0.07201046839350422,2021-11-18 04:04:27 UTC
789794,mainnet,248,107136000,107434235,298236,276765,21471,0.0719933207258681,2021-11-18 04:06:07 UTC
789796,mainnet,248,107136000,107434444,298445,276965,21480,0.07197306036288094,2021-11-18 04:07:53 UTC
789798,mainnet,248,107136000,107434632,298633,277147,21486,0.07194784233490606,2021-11-18 04:09:25 UTC
789799,mainnet,248,107136000,107434831,298832,277342,21490,0.07191331584301547,2021-11-18 04:11:07 UTC
789801,mainnet,248,107136000,107435025,299026,277528,21498,0.07189341395062637,2021-11-18 04:12:45 UTC
789802,mainnet,248,107136000,107435095,299096,277597,21499,0.07187993152700137,2021-11-18 04:14:37 UTC
789804,mainnet,248,107136000,107435276,299277,277760,21517,0.07189660414933323,2021-11-18 04:16:06 UTC
789805,mainnet,248,107136000,107435441,299442,277920,21522,0.07187368505420082,2021-11-18 04:17:35 UTC
789807,mainnet,248,107136000,107435628,299629,278092,21537,0.07187889022758144,2021-11-18 04:19:07 UTC
789808,mainnet,248,107136000,107435855,299856,278298,21558,0.07189450936449496,2021-11-18 04:20:53 UTC
789810,mainnet,248,107136000,107436055,300056,278489,21567,0.07187658303783294,2021-11-18 04:22:33 UTC
789811,mainnet,248,107136000,107436230,300231,278656,21575,0.07186133343991793,2021-11-18 04:24:13 UTC
789813,mainnet,248,107136000,107436438,300439,278848,21591,0.07186483778737114,2021-11-18 04:25:46 UTC
789814,mainnet,248,107136000,107436628,300629,279023,21606,0.07186931400496958,2021-11-18 04:27:27 UTC
789816,mainnet,248,107136000,107436803,300804,279184,21620,0.07187404422813526,2021-11-18 04:29:01 UTC
789817,mainnet,248,107136000,107436933,300934,279305,21629,0.07187290236397349,2021-11-18 04:30:34 UTC
789819,mainnet,248,107136000,107437119,301120,279461,21659,0.07192813496280552,2021-11-18 04:32:05 UTC
789820,mainnet,248,107136000,107437297,301298,279621,21677,0.07194538297632244,2021-11-18 04:33:38 UTC
789822,mainnet,248,107136000,107437456,301457,279777,21680,0.07191738788616618,2021-11-18 04:35:07 UTC
789823,mainnet,248,107136000,107437641,301642,279936,21706,0.07195947513940366,2021-11-18 04:36:36 UTC
789825,mainnet,248,107136000,107437820,301821,280105,21716,0.07194993058799752,2021-11-18 04:38:09 UTC
789826,mainnet,248,107136000,107437970,301971,280253,21718,0.07192081358805978,2021-11-18 04:39:39 UTC
789827,mainnet,248,107136000,107438151,302152,280422,21730,0.07191744552410707,2021-11-18 04:41:12 UTC
789829,mainnet,248,107136000,107438313,302314,280574,21740,0.07191198555144651,2021-11-18 04:42:44 UTC
789830,mainnet,248,107136000,107438487,302488,280720,21768,0.0719631853164423,2021-11-18 04:44:13 UTC
789832,mainnet,248,107136000,107438674,302675,280892,21783,0.0719682828115966,2021-11-18 04:45:48 UTC
789833,mainnet,248,107136000,107438866,302867,281074,21793,0.07195567691428911,2021-11-18 04:47:24 UTC
789835,mainnet,248,107136000,107439038,303039,281230,21809,0.07196763452888902,2021-11-18 04:48:57 UTC
789836,mainnet,248,107136000,107439208,303209,281391,21818,0.07195696697657392,2021-11-18 04:50:28 UTC
789838,mainnet,248,107136000,107439386,303387,281565,21822,0.07192793362932492,2021-11-18 04:52:01 UTC
789839,mainnet,248,107136000,107439578,303579,281747,21832,0.07191538281633446,2021-11-18 04:53:35 UTC
789841,mainnet,248,107136000,107439906,303907,282065,21842,0.0718706709618403,2021-11-18 04:55:08 UTC
789842,mainnet,248,107136000,107439935,303936,282092,21844,0.07187039376710887,2021-11-18 04:56:38 UTC
789844,mainnet,248,107136000,107440280,304281,282400,21881,0.07191050377775805,2021-11-18 04:58:07 UTC
789845,mainnet,248,107136000,107440327,304328,282447,21881,0.07189939801792802,2021-11-18 05:00:10 UTC
789847,mainnet,248,107136000,107440698,304699,282781,21918,0.07193328497960282,2021-11-18 05:01:46 UTC
789848,mainnet,248,107136000,107440763,304764,282840,21924,0.0719376304287908,2021-11-18 05:03:18 UTC
789850,mainnet,248,107136000,107440963,304964,283006,21958,0.0720019412127333,2021-11-18 05:05:00 UTC
789851,mainnet,248,107136000,107441122,305123,283156,21967,0.07199391720715909,2021-11-18 05:06:33 UTC
789853,mainnet,248,107136000,107441294,305295,283318,21977,0.07198611179351119,2021-11-18 05:08:05 UTC
789854,mainnet,248,107136000,107441477,305478,283486,21992,0.07199209108348228,2021-11-18 05:09:41 UTC
789856,mainnet,248,107136000,107441702,305703,283701,22002,0.07197181578198447,2021-11-18 05:11:35 UTC
789857,mainnet,248,107136000,107441912,305913,283899,22014,0.07196163615145483,2021-11-18 05:13:28 UTC
789859,mainnet,248,107136000,107442108,306109,284076,22033,0.07197762888382896,2021-11-18 05:14:57 UTC
789861,mainnet,248,107136000,107442341,306342,284300,22042,0.0719522625039988,2021-11-18 05:16:51 UTC
789862,mainnet,248,107136000,107442546,306547,284496,22051,0.07193350448707703,2021-11-18 05:18:44 UTC
789864,mainnet,248,107136000,107442724,306725,284666,22059,0.07191784171489118,2021-11-18 05:20:15 UTC
789865,mainnet,248,107136000,107442898,306899,284830,22069,0.07190965105783988,2021-11-18 05:21:57 UTC
789867,mainnet,248,107136000,107443104,307105,285020,22085,0.07191351492160662,2021-11-18 05:23:29 UTC
789868,mainnet,248,107136000,107443305,307306,285207,22099,0.07191203556064639,2021-11-18 05:25:11 UTC
789870,mainnet,248,107136000,107443542,307543,285426,22117,0.07191514682499683,2021-11-18 05:27:08 UTC
789871,mainnet,248,107136000,107443734,307735,285604,22131,0.07191577168667847,2021-11-18 05:28:44 UTC
789873,mainnet,248,107136000,107443915,307916,285781,22135,0.07188648852284389,2021-11-18 05:30:16 UTC
789874,mainnet,248,107136000,107444105,308106,285954,22152,0.07189733403439076,2021-11-18 05:31:47 UTC
789875,mainnet,248,107136000,107444319,308320,286164,22156,0.0718604047742605,2021-11-18 05:33:33 UTC
789877,mainnet,248,107136000,107444515,308516,286337,22179,0.07188930233764214,2021-11-18 05:35:07 UTC
789878,mainnet,248,107136000,107444709,308710,286527,22183,0.07185708269897315,2021-11-18 05:36:48 UTC
789880,mainnet,248,107136000,107444876,308877,286679,22198,0.07186679487304008,2021-11-18 05:38:51 UTC
789881,mainnet,248,107136000,107445152,309153,286929,22224,0.07188673569397677,2021-11-18 05:40:37 UTC
789883,mainnet,248,107136000,107445363,309364,287136,22228,0.07185063549734294,2021-11-18 05:42:21 UTC
789885,mainnet,248,107136000,107445584,309585,287351,22234,0.07181872506742898,2021-11-18 05:44:35 UTC
789886,mainnet,248,107136000,107445804,309805,287551,22254,0.0718322815964881,2021-11-18 05:46:07 UTC
789888,mainnet,248,107136000,107446068,310069,287785,22284,0.0718678745698538,2021-11-18 05:48:22 UTC
789889,mainnet,248,107136000,107446264,310265,287966,22299,0.07187082010539378,2021-11-18 05:49:57 UTC
789891,mainnet,248,107136000,107446454,310455,288142,22313,0.07187192990932663,2021-11-18 05:51:31 UTC
789893,mainnet,248,107136000,107446651,310652,288325,22327,0.07187141882234784,2021-11-18 05:53:14 UTC
789894,mainnet,248,107136000,107446841,310842,288514,22328,0.07183070498838638,2021-11-18 05:54:45 UTC
789896,mainnet,248,107136000,107447027,311028,288686,22342,0.07183276103759147,2021-11-18 05:56:20 UTC
789897,mainnet,248,107136000,107447207,311208,288853,22355,0.07183298629855274,2021-11-18 05:57:51 UTC
789898,mainnet,248,107136000,107447392,311393,289021,22372,0.0718449033857537,2021-11-18 05:59:19 UTC
789900,mainnet,248,107136000,107447546,311547,289172,22375,0.07181901928119995,2021-11-18 06:00:55 UTC
789901,mainnet,248,107136000,107447759,311760,289354,22406,0.07186938670772389,2021-11-18 06:02:29 UTC
789903,mainnet,248,107136000,107447909,311910,289499,22411,0.07185085441313199,2021-11-18 06:03:55 UTC
789904,mainnet,248,107136000,107448104,312105,289677,22428,0.0718604315855241,2021-11-18 06:05:27 UTC
789905,mainnet,248,107136000,107448284,312285,289844,22441,0.07186064012040284,2021-11-18 06:06:57 UTC
789907,mainnet,248,107136000,107448450,312451,289997,22454,0.07186406828590723,2021-11-18 06:08:24 UTC
789908,mainnet,248,107136000,107448628,312629,290167,22462,0.07184874083978134,2021-11-18 06:09:53 UTC
789910,mainnet,248,107136000,107448788,312789,290317,22472,0.07184395870698777,2021-11-18 06:11:28 UTC
789911,mainnet,248,107136000,107448942,312943,290454,22489,0.07186292711452245,2021-11-18 06:12:59 UTC
789913,mainnet,248,107136000,107449228,313229,290719,22510,0.07186435483304547,2021-11-18 06:14:31 UTC
789914,mainnet,248,107136000,107449405,313406,290878,22528,0.07188120201910621,2021-11-18 06:16:01 UTC
789915,mainnet,248,107136000,107449587,313588,291051,22537,0.07186818373152033,2021-11-18 06:17:37 UTC
789917,mainnet,248,107136000,107449776,313777,291219,22558,0.07189182126159661,2021-11-18 06:19:07 UTC
789918,mainnet,248,107136000,107449956,313957,291383,22574,0.07190156613803801,2021-11-18 06:20:40 UTC
789919,mainnet,248,107136000,107450116,314117,291529,22588,0.0719095114240872,2021-11-18 06:22:09 UTC
789920,mainnet,248,107136000,107450283,314284,291696,22588,0.0718713011161879,2021-11-18 06:23:38 UTC
789922,mainnet,248,107136000,107450452,314453,291860,22593,0.07184857514477522,2021-11-18 06:25:07 UTC
789923,mainnet,248,107136000,107450630,314631,292022,22609,0.07185878060330991,2021-11-18 06:26:34 UTC
789925,mainnet,248,107136000,107450856,314857,292227,22630,0.07187389830939125,2021-11-18 06:28:31 UTC
789926,mainnet,248,107136000,107451056,315057,292419,22638,0.07185366457498167,2021-11-18 06:30:03 UTC
789928,mainnet,248,107136000,107451268,315269,292605,22664,0.0718878164361228,2021-11-18 06:31:46 UTC
789929,mainnet,248,107136000,107451442,315443,292773,22670,0.07186718361161921,2021-11-18 06:33:12 UTC
789931,mainnet,248,107136000,107451619,315620,292942,22678,0.07185222736201761,2021-11-18 06:35:04 UTC
789933,mainnet,248,107136000,107451849,315850,293166,22684,0.07181890137723602,2021-11-18 06:36:47 UTC
789934,mainnet,248,107136000,107452036,316037,293345,22692,0.0718017194189288,2021-11-18 06:38:26 UTC
789936,mainnet,248,107136000,107452242,316243,293545,22698,0.07177392068757253,2021-11-18 06:39:57 UTC
789937,mainnet,248,107136000,107452458,316459,293751,22708,0.0717565308618178,2021-11-18 06:41:58 UTC
789939,mainnet,248,107136000,107452670,316671,293958,22713,0.07172428166772454,2021-11-18 06:43:44 UTC
789940,mainnet,248,107136000,107452880,316881,294145,22736,0.07174933176807698,2021-11-18 06:45:25 UTC
789942,mainnet,248,107136000,107453061,317062,294321,22741,0.07172414228132037,2021-11-18 06:47:00 UTC
789943,mainnet,248,107136000,107453237,317238,294482,22756,0.07173163366305424,2021-11-18 06:48:29 UTC
789945,mainnet,248,107136000,107453416,317417,294651,22766,0.07172268656058119,2021-11-18 06:50:04 UTC
789947,mainnet,248,107136000,107453617,317618,294846,22772,0.07169618850317047,2021-11-18 06:51:47 UTC
789948,mainnet,248,107136000,107453775,317776,294988,22788,0.07171089069029757,2021-11-18 06:53:18 UTC
789950,mainnet,248,107136000,107453977,317978,295160,22818,0.0717596814873985,2021-11-18 06:54:49 UTC
789951,mainnet,248,107136000,107454135,318136,295310,22826,0.0717491890260769,2021-11-18 06:56:18 UTC
789952,mainnet,248,107136000,107454312,318313,295471,22842,0.07175955741675646,2021-11-18 06:57:49 UTC
789953,mainnet,248,107136000,107454500,318501,295635,22866,0.07179255324159108,2021-11-18 06:59:20 UTC
789955,mainnet,248,107136000,107454692,318693,295813,22880,0.07179323047572429,2021-11-18 07:00:59 UTC
789956,mainnet,248,107136000,107454840,318841,295945,22896,0.07181008715943056,2021-11-18 07:02:35 UTC
789958,mainnet,248,107136000,107455093,319094,296173,22921,0.0718314979285101,2021-11-18 07:04:08 UTC
789959,mainnet,248,107136000,107455280,319281,296336,22945,0.07186459576360635,2021-11-18 07:05:39 UTC
789961,mainnet,248,107136000,107455436,319437,296486,22951,0.07184828307303162,2021-11-18 07:07:06 UTC
789962,mainnet,248,107136000,107455600,319601,296645,22956,0.0718270593646453,2021-11-18 07:08:36 UTC
789964,mainnet,248,107136000,107455789,319790,296825,22965,0.07181275211857782,2021-11-18 07:10:18 UTC
789966,mainnet,248,107136000,107456030,320031,297043,22988,0.0718305414163003,2021-11-18 07:12:21 UTC
789967,mainnet,248,107136000,107456184,320185,297191,22994,0.07181473210800006,2021-11-18 07:13:48 UTC
789969,mainnet,248,107136000,107456359,320360,297351,23009,0.07182232488450493,2021-11-18 07:15:17 UTC
789970,mainnet,248,107136000,107456541,320542,297517,23025,0.07183146046383937,2021-11-18 07:16:57 UTC
789972,mainnet,248,107136000,107456707,320708,297674,23034,0.07182234306596655,2021-11-18 07:18:25 UTC
789973,mainnet,248,107136000,107456884,320885,297850,23035,0.07178584227994453,2021-11-18 07:20:11 UTC
789975,mainnet,248,107136000,107457084,321085,298036,23049,0.0717847299001822,2021-11-18 07:21:37 UTC
789976,mainnet,248,107136000,107457283,321284,298218,23066,0.07179317986578852,2021-11-18 07:23:07 UTC
789978,mainnet,248,107136000,107457489,321490,298419,23071,0.07176272978941803,2021-11-18 07:24:53 UTC
789979,mainnet,248,107136000,107457672,321673,298602,23071,0.07172190392106269,2021-11-18 07:26:35 UTC
789981,mainnet,248,107136000,107457860,321861,298772,23089,0.07173593569895079,2021-11-18 07:28:18 UTC
789982,mainnet,248,107136000,107458062,322063,298970,23093,0.07170336238562021,2021-11-18 07:29:48 UTC
789984,mainnet,248,107136000,107458272,322273,299172,23101,0.071681462610892,2021-11-18 07:31:41 UTC
789985,mainnet,248,107136000,107458478,322479,299365,23114,0.07167598510290593,2021-11-18 07:33:16 UTC
789987,mainnet,248,107136000,107458668,322669,299542,23127,0.07167406847264535,2021-11-18 07:34:44 UTC
789988,mainnet,248,107136000,107458833,322834,299702,23132,0.07165292379365247,2021-11-18 07:36:14 UTC
789989,mainnet,248,107136000,107458996,322997,299853,23144,0.07165391629024419,2021-11-18 07:37:43 UTC
789991,mainnet,248,107136000,107459163,323164,300015,23149,0.07163236004010348,2021-11-18 07:39:15 UTC
789992,mainnet,248,107136000,107459374,323375,300194,23181,0.07168457672980286,2021-11-18 07:40:49 UTC
789993,mainnet,248,107136000,107459532,323533,300348,23185,0.07166193247674889,2021-11-18 07:42:14 UTC
789994,mainnet,248,107136000,107459699,323700,300499,23201,0.07167438986716095,2021-11-18 07:43:41 UTC
789996,mainnet,248,107136000,107459859,323860,300654,23206,0.07165441857592787,2021-11-18 07:45:11 UTC
789997,mainnet,248,107136000,107460201,324202,300973,23229,0.0716497739063917,2021-11-18 07:46:43 UTC
789999,mainnet,248,107136000,107460275,324276,301041,23235,0.0716519261369944,2021-11-18 07:48:14 UTC
790000,mainnet,248,107136000,107460433,324434,301189,23245,0.07164785441723125,2021-11-18 07:49:43 UTC
790002,mainnet,248,107136000,107460636,324637,301380,23257,0.07164001638753438,2021-11-18 07:51:23 UTC
790003,mainnet,248,107136000,107460900,324901,301624,23277,0.0716433621318494,2021-11-18 07:53:28 UTC
790005,mainnet,248,107136000,107461066,325067,301787,23280,0.0716160053158272,2021-11-18 07:55:02 UTC
790006,mainnet,248,107136000,107461279,325280,301982,23298,0.07162444663059518,2021-11-18 07:56:34 UTC
790008,mainnet,248,107136000,107461470,325471,302165,23306,0.07160699417152373,2021-11-18 07:58:08 UTC
790010,mainnet,248,107136000,107461653,325654,302345,23309,0.07157596713075841,2021-11-18 07:59:40 UTC
790011,mainnet,248,107136000,107461844,325845,302522,23323,0.07157697678343998,2021-11-18 08:01:18 UTC
790013,mainnet,248,107136000,107462062,326063,302722,23341,0.07158432572846352,2021-11-18 08:03:17 UTC
790014,mainnet,248,107136000,107462234,326235,302881,23354,0.07158643309270925,2021-11-18 08:04:47 UTC
790016,mainnet,248,107136000,107462432,326433,303062,23371,0.07159508995720408,2021-11-18 08:06:22 UTC
790017,mainnet,248,107136000,107462607,326608,303230,23378,0.07157816097584872,2021-11-18 08:07:49 UTC
790019,mainnet,248,107136000,107462778,326779,303391,23388,0.0715713066017094,2021-11-18 08:09:25 UTC
790020,mainnet,248,107136000,107462971,326972,303580,23392,0.07154129405576012,2021-11-18 08:10:58 UTC
790022,mainnet,248,107136000,107463167,327168,303748,23420,0.07158401799687011,2021-11-18 08:12:41 UTC
790023,mainnet,248,107136000,107463371,327372,303941,23431,0.07157301174199382,2021-11-18 08:14:12 UTC
790025,mainnet,248,107136000,107463578,327579,304131,23448,0.07157968001611825,2021-11-18 08:15:55 UTC
790026,mainnet,248,107136000,107463743,327744,304296,23448,0.07154364381956649,2021-11-18 08:17:29 UTC
790028,mainnet,248,107136000,107463928,327929,304467,23462,0.07154597489090626,2021-11-18 08:19:03 UTC
790029,mainnet,248,107136000,107464113,328114,304644,23470,0.0715300170062844,2021-11-18 08:20:36 UTC
790031,mainnet,248,107136000,107464302,328303,304825,23478,0.07151320578855508,2021-11-18 08:22:07 UTC
790032,mainnet,248,107136000,107464496,328497,305006,23491,0.07151054651945071,2021-11-18 08:23:40 UTC
790034,mainnet,248,107136000,107464687,328688,305185,23503,0.07150550065715816,2021-11-18 08:25:14 UTC
790035,mainnet,248,107136000,107464864,328865,305355,23510,0.07148830067048789,2021-11-18 08:26:47 UTC
790036,mainnet,248,107136000,107465054,329055,305532,23523,0.07148652960751242,2021-11-18 08:28:20 UTC
790037,mainnet,248,107136000,107465245,329246,305717,23529,0.07146328277336703,2021-11-18 08:29:51 UTC
790039,mainnet,248,107136000,107465413,329414,305873,23541,0.0714632650707013,2021-11-18 08:31:22 UTC
790040,mainnet,248,107136000,107465595,329596,306034,23562,0.07148751805240355,2021-11-18 08:32:55 UTC
790042,mainnet,248,107136000,107465774,329775,306195,23580,0.07150329770297931,2021-11-18 08:34:39 UTC
790043,mainnet,248,107136000,107465994,329995,306405,23590,0.07148593160502432,2021-11-18 08:36:22 UTC
790045,mainnet,248,107136000,107466188,330189,306593,23596,0.07146210200824377,2021-11-18 08:38:29 UTC
790046,mainnet,248,107136000,107466413,330414,306800,23614,0.07146791600840158,2021-11-18 08:40:04 UTC
790048,mainnet,248,107136000,107466589,330590,306966,23624,0.07146011676094256,2021-11-18 08:41:41 UTC
790049,mainnet,248,107136000,107466832,330833,307191,23642,0.0714620367375685,2021-11-18 08:43:17 UTC
790051,mainnet,248,107136000,107467023,331024,307366,23658,0.071469138189376,2021-11-18 08:44:51 UTC
790052,mainnet,248,107136000,107467212,331213,307545,23668,0.0714585478227002,2021-11-18 08:46:27 UTC
790054,mainnet,248,107136000,107467404,331405,307732,23673,0.0714322354822649,2021-11-18 08:48:00 UTC
790055,mainnet,248,107136000,107467583,331584,307906,23678,0.07140875313646014,2021-11-18 08:49:33 UTC
790057,mainnet,248,107136000,107467758,331759,308068,23691,0.07141027070855652,2021-11-18 08:51:17 UTC
790059,mainnet,248,107136000,107467950,331951,308256,23695,0.07138101707782173,2021-11-18 08:52:49 UTC
790060,mainnet,248,107136000,107468137,332138,308425,23713,0.07139502255086741,2021-11-18 08:54:22 UTC
790062,mainnet,248,107136000,107468348,332349,308624,23725,0.07138580227411546,2021-11-18 08:56:05 UTC
790063,mainnet,248,107136000,107468508,332509,308771,23738,0.0713905488272498,2021-11-18 08:58:06 UTC
790064,mainnet,248,107136000,107468762,332763,308987,23776,0.07145025138011137,2021-11-18 08:59:42 UTC
790066,mainnet,248,107136000,107468958,332959,309173,23786,0.07143822512681741,2021-11-18 09:01:24 UTC
790067,mainnet,248,107136000,107469131,333132,309327,23805,0.07145816072908036,2021-11-18 09:02:56 UTC
790068,mainnet,248,107136000,107469288,333289,309466,23823,0.0714785066413833,2021-11-18 09:04:28 UTC
790070,mainnet,248,107136000,107469480,333481,309646,23835,0.07147333731157098,2021-11-18 09:06:28 UTC
790071,mainnet,248,107136000,107469665,333666,309809,23857,0.07149964335593079,2021-11-18 09:08:00 UTC
790073,mainnet,248,107136000,107469830,333831,309963,23868,0.07149725459888387,2021-11-18 09:09:33 UTC
790074,mainnet,248,107136000,107469991,333992,310123,23869,0.07146578361158351,2021-11-18 09:11:03 UTC
790075,mainnet,248,107136000,107470170,334171,310277,23894,0.07150231468320112,2021-11-18 09:12:37 UTC
790076,mainnet,248,107136000,107470323,334324,310413,23911,0.07152044124860914,2021-11-18 09:14:04 UTC
790077,mainnet,248,107136000,107470485,334486,310565,23921,0.07151569871384751,2021-11-18 09:15:37 UTC
790078,mainnet,248,107136000,107470653,334654,310724,23930,0.07150669049226963,2021-11-18 09:17:05 UTC
790079,mainnet,248,107136000,107470828,334829,310886,23943,0.07150814296252714,2021-11-18 09:18:43 UTC
790080,mainnet,248,107136000,107471000,335001,311046,23955,0.07150724923209184,2021-11-18 09:20:17 UTC
790082,mainnet,248,107136000,107471160,335161,311188,23973,0.07152681845441444,2021-11-18 09:21:48 UTC
790083,mainnet,248,107136000,107471337,335338,311355,23983,0.07151888542306568,2021-11-18 09:23:22 UTC
790085,mainnet,248,107136000,107471517,335518,311518,24000,0.07153118461602656,2021-11-18 09:24:55 UTC
790086,mainnet,248,107136000,107471668,335669,311656,24013,0.0715377350902228,2021-11-18 09:26:27 UTC
790088,mainnet,248,107136000,107471827,335828,311793,24035,0.07156937479900426,2021-11-18 09:27:58 UTC
790089,mainnet,248,107136000,107471994,335995,311940,24055,0.07159332728165597,2021-11-18 09:29:28 UTC
790090,mainnet,248,107136000,107472153,336154,312097,24057,0.07156541347120665,2021-11-18 09:31:04 UTC
790092,mainnet,248,107136000,107472329,336330,312271,24059,0.07153391014777154,2021-11-18 09:32:50 UTC
790093,mainnet,248,107136000,107472555,336556,312474,24082,0.07155421386039768,2021-11-18 09:34:36 UTC
790095,mainnet,248,107136000,107472747,336748,312647,24101,0.07156983857365151,2021-11-18 09:36:23 UTC
790096,mainnet,248,107136000,107472936,336937,312805,24132,0.07162169782481592,2021-11-18 09:38:03 UTC
790098,mainnet,248,107136000,107473115,337116,312958,24158,0.07166079331743376,2021-11-18 09:39:55 UTC
790099,mainnet,248,107136000,107473310,337311,313126,24185,0.07169941092937972,2021-11-18 09:41:29 UTC
790101,mainnet,248,107136000,107473510,337511,313308,24203,0.07171025536945462,2021-11-18 09:43:12 UTC
790102,mainnet,248,107136000,107473684,337685,313476,24209,0.07169107304144395,2021-11-18 09:44:53 UTC
790104,mainnet,248,107136000,107473910,337911,313690,24221,0.07167863727431187,2021-11-18 09:46:50 UTC
790105,mainnet,248,107136000,107474091,338092,313857,24235,0.07168167244418679,2021-11-18 09:48:21 UTC
790107,mainnet,248,107136000,107474288,338289,314049,24240,0.07165470943483235,2021-11-18 09:50:07 UTC
790109,mainnet,248,107136000,107474500,338501,314247,24254,0.07165119157698205,2021-11-18 09:51:54 UTC
790110,mainnet,248,107136000,107474735,338736,314473,24263,0.07162805252467999,2021-11-18 09:54:05 UTC
790112,mainnet,248,107136000,107474913,338914,314638,24276,0.07162879078468284,2021-11-18 09:55:39 UTC
790113,mainnet,248,107136000,107475112,339113,314828,24285,0.07161329704257872,2021-11-18 09:57:18 UTC
790115,mainnet,248,107136000,107475247,339248,314946,24302,0.07163491015422346,2021-11-18 09:58:49 UTC
790116,mainnet,248,107136000,107475495,339496,315175,24321,0.07163854655135848,2021-11-18 10:00:26 UTC
790117,mainnet,248,107136000,107475650,339651,315303,24348,0.07168534760680817,2021-11-18 10:01:57 UTC
790119,mainnet,248,107136000,107475825,339826,315462,24364,0.07169551476343776,2021-11-18 10:03:30 UTC
790120,mainnet,248,107136000,107475977,339978,315612,24366,0.0716693433104495,2021-11-18 10:05:03 UTC
790121,mainnet,248,107136000,107476150,340151,315769,24382,0.07167993038385893,2021-11-18 10:06:34 UTC
790123,mainnet,248,107136000,107476327,340328,315939,24389,0.07166321901224701,2021-11-18 10:08:06 UTC
790124,mainnet,248,107136000,107476498,340499,316100,24399,0.0716565981104203,2021-11-18 10:09:38 UTC
790126,mainnet,248,107136000,107476675,340676,316254,24422,0.07168688137702685,2021-11-18 10:11:13 UTC
790127,mainnet,248,107136000,107476849,340850,316410,24440,0.07170309520316855,2021-11-18 10:12:46 UTC
790129,mainnet,248,107136000,107477021,341022,316569,24453,0.07170505128701374,2021-11-18 10:14:18 UTC
790131,mainnet,248,107136000,107477256,341257,316783,24474,0.07171721019642088,2021-11-18 10:16:27 UTC
790132,mainnet,248,107136000,107477458,341459,316976,24483,0.07170114127904083,2021-11-18 10:18:09 UTC
790134,mainnet,248,107136000,107477647,341648,317148,24500,0.07171123495527561,2021-11-18 10:19:50 UTC
790135,mainnet,248,107136000,107477832,341833,317314,24519,0.07172800753584353,2021-11-18 10:21:23 UTC
790137,mainnet,248,107136000,107478020,342021,317490,24531,0.07172366609067864,2021-11-18 10:23:04 UTC
790138,mainnet,248,107136000,107478204,342205,317668,24537,0.07170263438582136,2021-11-18 10:24:46 UTC
790140,mainnet,248,107136000,107478379,342380,317833,24547,0.07169519247619605,2021-11-18 10:26:24 UTC
790141,mainnet,248,107136000,107478546,342547,317983,24564,0.0717098675510222,2021-11-18 10:27:55 UTC
790143,mainnet,248,107136000,107478824,342825,318242,24583,0.07170713921096769,2021-11-18 10:30:26 UTC
790145,mainnet,248,107136000,107479036,343037,318444,24593,0.07169197491815751,2021-11-18 10:32:09 UTC
790146,mainnet,248,107136000,107479231,343232,318626,24606,0.07168911989558083,2021-11-18 10:33:43 UTC
790148,mainnet,248,107136000,107479422,343423,318809,24614,0.07167254377254872,2021-11-18 10:35:33 UTC
790149,mainnet,248,107136000,107479582,343583,318963,24620,0.07165663027565392,2021-11-18 10:37:03 UTC
790151,mainnet,248,107136000,107479772,343773,319138,24635,0.07166065979585366,2021-11-18 10:38:33 UTC
790152,mainnet,248,107136000,107479954,343955,319310,24645,0.07165181491764912,2021-11-18 10:40:02 UTC
790154,mainnet,248,107136000,107480146,344147,319488,24659,0.07165252057986848,2021-11-18 10:41:36 UTC
790155,mainnet,248,107136000,107480319,344320,319657,24663,0.07162813661710037,2021-11-18 10:43:06 UTC
790157,mainnet,248,107136000,107480505,344506,319838,24668,0.07160397786976135,2021-11-18 10:44:36 UTC
790158,mainnet,248,107136000,107480681,344682,319997,24685,0.07161673658618668,2021-11-18 10:46:11 UTC
790160,mainnet,248,107136000,107480863,344864,320170,24694,0.07160503850793357,2021-11-18 10:47:41 UTC
790161,mainnet,248,107136000,107481056,345057,320353,24704,0.07159396853273517,2021-11-18 10:49:21 UTC
790163,mainnet,248,107136000,107481240,345241,320528,24713,0.07158188048348835,2021-11-18 10:50:53 UTC
790164,mainnet,248,107136000,107481430,345431,320698,24733,0.07160040644875533,2021-11-18 10:52:54 UTC
790166,mainnet,248,107136000,107481689,345690,320938,24752,0.07160172408805578,2021-11-18 10:54:37 UTC
790167,mainnet,248,107136000,107481847,345848,321084,24764,0.07160371030047882,2021-11-18 10:56:07 UTC
790169,mainnet,248,107136000,107482072,346073,321272,24801,0.07166407087521996,2021-11-18 10:57:39 UTC
790170,mainnet,248,107136000,107482278,346279,321463,24816,0.07166475587604215,2021-11-18 10:59:30 UTC
790172,mainnet,248,107136000,107482486,346487,321668,24819,0.07163039305947987,2021-11-18 11:01:13 UTC
790174,mainnet,248,107136000,107482760,346761,321914,24847,0.07165454015878371,2021-11-18 11:03:24 UTC
790175,mainnet,248,107136000,107482927,346928,322058,24870,0.07168634414057096,2021-11-18 11:04:58 UTC
790177,mainnet,248,107136000,107483122,347123,322219,24904,0.0717440215716043,2021-11-18 11:06:29 UTC
790178,mainnet,248,107136000,107483357,347358,322444,24914,0.07172427294030942,2021-11-18 11:08:42 UTC
790180,mainnet,248,107136000,107483586,347587,322669,24918,0.0716885269011787,2021-11-18 11:10:38 UTC
790181,mainnet,248,107136000,107483800,347801,322875,24926,0.07166741901259628,2021-11-18 11:12:12 UTC
790183,mainnet,248,107136000,107483986,347987,323045,24942,0.0716750913108823,2021-11-18 11:13:46 UTC
790184,mainnet,248,107136000,107484163,348164,323205,24959,0.07168748061258487,2021-11-18 11:15:20 UTC
790186,mainnet,248,107136000,107484362,348363,323398,24965,0.07166375303921484,2021-11-18 11:17:01 UTC
790188,mainnet,248,107136000,107484544,348545,323567,24978,0.07166363023425956,2021-11-18 11:18:40 UTC
790189,mainnet,248,107136000,107484740,348741,323744,24997,0.07167783541367376,2021-11-18 11:20:12 UTC
790191,mainnet,248,107136000,107484938,348939,323924,25015,0.07168874789003235,2021-11-18 11:21:46 UTC
790192,mainnet,248,107136000,107485111,349112,324089,25023,0.07167613831664336,2021-11-18 11:23:16 UTC
790193,mainnet,248,107136000,107485313,349314,324274,25040,0.07168335652163955,2021-11-18 11:24:48 UTC
790194,mainnet,248,107136000,107485494,349495,324451,25044,0.07165767750611597,2021-11-18 11:26:22 UTC
790196,mainnet,248,107136000,107485693,349694,324629,25065,0.07167695184933114,2021-11-18 11:27:55 UTC
790197,mainnet,248,107136000,107485872,349873,324803,25070,0.07165457180176807,2021-11-18 11:29:28 UTC
790199,mainnet,248,107136000,107486059,350060,324974,25086,0.07166200079986287,2021-11-18 11:30:59 UTC
790200,mainnet,248,107136000,107486238,350239,325143,25096,0.07165392774648169,2021-11-18 11:32:27 UTC
790201,mainnet,248,107136000,107486428,350429,325328,25101,0.0716293457447871,2021-11-18 11:34:02 UTC
790202,mainnet,248,107136000,107486615,350616,325506,25110,0.07161681155452118,2021-11-18 11:35:31 UTC
790204,mainnet,248,107136000,107486861,350862,325745,25117,0.0715865496976019,2021-11-18 11:37:43 UTC
790206,mainnet,248,107136000,107487062,351063,325938,25125,0.07156835097973868,2021-11-18 11:39:12 UTC
790207,mainnet,248,107136000,107487276,351277,326147,25130,0.07153898490365153,2021-11-18 11:41:15 UTC
790209,mainnet,248,107136000,107487494,351495,326354,25141,0.07152591075264228,2021-11-18 11:42:49 UTC
790210,mainnet,248,107136000,107487670,351671,326514,25157,0.07153561140952766,2021-11-18 11:44:23 UTC
790212,mainnet,248,107136000,107487856,351857,326693,25164,0.07151769042537168,2021-11-18 11:46:04 UTC
790213,mainnet,248,107136000,107488029,352030,326862,25168,0.07149390676930943,2021-11-18 11:47:38 UTC
790215,mainnet,248,107136000,107488205,352206,327032,25174,0.07147521620869604,2021-11-18 11:49:13 UTC
790217,mainnet,248,107136000,107488398,352399,327211,25188,0.07147579873949698,2021-11-18 11:50:55 UTC
790218,mainnet,248,107136000,107488626,352627,327424,25203,0.07147212210068997,2021-11-18 11:52:47 UTC
790220,mainnet,248,107136000,107488784,352785,327577,25208,0.0714542851878623,2021-11-18 11:54:18 UTC
790221,mainnet,248,107136000,107488973,352974,327731,25243,0.07151518242136815,2021-11-18 11:56:09 UTC
790223,mainnet,248,107136000,107489142,353143,327870,25273,0.07156590956071619,2021-11-18 11:57:41 UTC
790225,mainnet,248,107136000,107489323,353324,328024,25300,0.07160566505530334,2021-11-18 11:59:39 UTC
790226,mainnet,248,107136000,107489443,353444,328120,25324,0.07164925702515816,2021-11-18 12:01:18 UTC
790228,mainnet,248,107136000,107489583,353584,328219,25365,0.07173684329607674,2021-11-18 12:02:46 UTC
790229,mainnet,248,107136000,107489722,353723,328313,25410,0.07183587157182315,2021-11-18 12:04:14 UTC
790231,mainnet,248,107136000,107489880,353881,328438,25443,0.07189705013832333,2021-11-18 12:06:04 UTC
790232,mainnet,248,107136000,107489996,353997,328532,25465,0.07193563787263733,2021-11-18 12:07:29 UTC
790234,mainnet,248,107136000,107490123,354124,328623,25501,0.07201149879703155,2021-11-18 12:09:00 UTC
790235,mainnet,248,107136000,107490274,354275,328734,25541,0.07209371251146708,2021-11-18 12:10:34 UTC
790236,mainnet,248,107136000,107490411,354412,328853,25559,0.07211663261966299,2021-11-18 12:12:08 UTC
790237,mainnet,248,107136000,107490536,354537,328954,25583,0.07215890019941501,2021-11-18 12:13:37 UTC
790239,mainnet,248,107136000,107490646,354647,329052,25595,0.07217035531105578,2021-11-18 12:15:09 UTC
790240,mainnet,248,107136000,107490783,354784,329161,25623,0.07222140795526293,2021-11-18 12:16:39 UTC
790242,mainnet,248,107136000,107490926,354927,329290,25637,0.07223175469885357,2021-11-18 12:18:12 UTC
790243,mainnet,248,107136000,107490967,354968,329327,25641,0.07223468030921097,2021-11-18 12:19:47 UTC
790245,mainnet,248,107136000,107491218,355219,329536,25683,0.07230187574425917,2021-11-18 12:21:15 UTC
790246,mainnet,248,107136000,107491235,355236,329552,25684,0.07230123073111959,2021-11-18 12:22:41 UTC
790247,mainnet,248,107136000,107491504,355505,329775,25730,0.07237591595054922,2021-11-18 12:24:11 UTC
790248,mainnet,248,107136000,107491645,355646,329895,25751,0.07240626915528363,2021-11-18 12:25:41 UTC
790249,mainnet,248,107136000,107491835,355836,330074,25762,0.07239852066682405,2021-11-18 12:27:26 UTC
790251,mainnet,248,107136000,107491992,355993,330218,25775,0.07240310904989705,2021-11-18 12:28:57 UTC
790252,mainnet,248,107136000,107492166,356167,330361,25806,0.07245477542838051,2021-11-18 12:30:29 UTC
790253,mainnet,248,107136000,107492351,356352,330535,25817,0.07244802891522989,2021-11-18 12:32:12 UTC
790255,mainnet,248,107136000,107492541,356542,330713,25829,0.07244307823482227,2021-11-18 12:33:54 UTC
790256,mainnet,248,107136000,107492692,356693,330851,25842,0.07244885657974785,2021-11-18 12:35:22 UTC
790258,mainnet,248,107136000,107492865,356866,331002,25864,0.07247538291683714,2021-11-18 12:36:52 UTC
790259,mainnet,248,107136000,107493082,357083,331202,25881,0.07247894747159624,2021-11-18 12:38:51 UTC
790261,mainnet,248,107136000,107493271,357272,331363,25909,0.07251897713786695,2021-11-18 12:40:25 UTC
790263,mainnet,248,107136000,107493583,357584,331647,25937,0.072534005995794,2021-11-18 12:43:07 UTC
790264,mainnet,248,107136000,107493766,357767,331811,25956,0.07255001159972832,2021-11-18 12:44:38 UTC
790266,mainnet,248,107136000,107493936,357937,331975,25962,0.07253231713960837,2021-11-18 12:46:08 UTC
790267,mainnet,248,107136000,107494114,358115,332147,25968,0.07251301956075562,2021-11-18 12:47:42 UTC
790269,mainnet,248,107136000,107494323,358324,332343,25981,0.07250700483361427,2021-11-18 12:49:27 UTC
790270,mainnet,248,107136000,107494515,358516,332524,25992,0.0724988563969251,2021-11-18 12:51:10 UTC
790272,mainnet,248,107136000,107494680,358681,332682,25999,0.07248502150936348,2021-11-18 12:53:11 UTC
790273,mainnet,248,107136000,107494941,358942,332915,26027,0.07251032200188332,2021-11-18 12:54:59 UTC
790275,mainnet,248,107136000,107495107,359108,333067,26041,0.07251578912193546,2021-11-18 12:56:36 UTC
790276,mainnet,248,107136000,107495275,359276,333224,26052,0.07251249735579332,2021-11-18 12:58:04 UTC
790278,mainnet,248,107136000,107495468,359469,333407,26062,0.07250138398582354,2021-11-18 12:59:47 UTC
790279,mainnet,248,107136000,107495648,359649,333583,26066,0.07247621986992873,2021-11-18 13:01:28 UTC
790281,mainnet,248,107136000,107495861,359862,333772,26090,0.07250001389421501,2021-11-18 13:03:16 UTC
790282,mainnet,248,107136000,107496061,360062,333947,26115,0.0725291755308808,2021-11-18 13:04:54 UTC
790284,mainnet,248,107136000,107496264,360265,334135,26130,0.07252994323622888,2021-11-18 13:06:42 UTC
790285,mainnet,248,107136000,107496458,360459,334315,26144,0.07252974679505853,2021-11-18 13:08:29 UTC
790287,mainnet,248,107136000,107496645,360646,334491,26155,0.07252263992945991,2021-11-18 13:10:09 UTC
790289,mainnet,248,107136000,107496795,360796,334641,26155,0.07249248883025311,2021-11-18 13:12:18 UTC
790290,mainnet,248,107136000,107497068,361069,334882,26187,0.0725263038366628,2021-11-18 13:14:07 UTC
790292,mainnet,248,107136000,107497264,361265,335048,26217,0.07256999709354629,2021-11-18 13:16:00 UTC
790293,mainnet,248,107136000,107497446,361447,335220,26227,0.07256112237755466,2021-11-18 13:17:42 UTC
790295,mainnet,248,107136000,107497647,361648,335398,26250,0.07258439145246207,2021-11-18 13:19:34 UTC
790296,mainnet,248,107136000,107497838,361839,335568,26271,0.07260411398439638,2021-11-18 13:21:48 UTC
790298,mainnet,248,107136000,107498059,362060,335769,26291,0.07261503618184831,2021-11-18 13:23:25 UTC
790299,mainnet,248,107136000,107498228,362229,335917,26312,0.0726391315990713,2021-11-18 13:25:06 UTC
790301,mainnet,248,107136000,107498435,362436,336102,26334,0.07265834519749693,2021-11-18 13:27:05 UTC
790302,mainnet,248,107136000,107498626,362627,336264,26363,0.07270004715589297,2021-11-18 13:28:46 UTC
790304,mainnet,248,107136000,107498799,362800,336418,26382,0.07271775082690188,2021-11-18 13:30:21 UTC
790305,mainnet,248,107136000,107498998,362999,336595,26404,0.07273849239254103,2021-11-18 13:32:24 UTC
790307,mainnet,248,107136000,107499142,363143,336736,26407,0.07271791002442564,2021-11-18 13:33:57 UTC
790308,mainnet,248,107136000,107499329,363330,336909,26421,0.07271901577078689,2021-11-18 13:35:41 UTC
790310,mainnet,248,107136000,107499497,363498,337063,26435,0.07272392145211252,2021-11-18 13:37:12 UTC
790311,mainnet,248,107136000,107499612,363613,337147,26466,0.07278617651184088,2021-11-18 13:38:46 UTC
790312,mainnet,248,107136000,107499864,363865,337374,26491,0.07280447418685501,2021-11-18 13:40:22 UTC
790314,mainnet,248,107136000,107500078,364079,337553,26526,0.07285781382612015,2021-11-18 13:42:29 UTC
790315,mainnet,248,107136000,107500259,364260,337715,26545,0.07287377148190853,2021-11-18 13:44:13 UTC
790317,mainnet,248,107136000,107500433,364434,337884,26550,0.07285269760779729,2021-11-18 13:46:01 UTC
790318,mainnet,248,107136000,107500617,364618,338058,26560,0.07284335935143081,2021-11-18 13:47:44 UTC
790320,mainnet,248,107136000,107500796,364797,338217,26580,0.07286244130297125,2021-11-18 13:49:27 UTC
790321,mainnet,248,107136000,107500897,364898,338316,26582,0.07284775471501626,2021-11-18 13:51:01 UTC
790323,mainnet,248,107136000,107501176,365177,338534,26643,0.07295914036207099,2021-11-18 13:52:58 UTC
790325,mainnet,248,107136000,107501377,365378,338718,26660,0.07296553158646661,2021-11-18 13:55:11 UTC
790326,mainnet,248,107136000,107501594,365595,338901,26694,0.07301522176178558,2021-11-18 13:56:47 UTC
790327,mainnet,248,107136000,107501636,365637,338943,26694,0.07300683464747823,2021-11-18 13:58:30 UTC
790329,mainnet,248,107136000,107502013,366014,339246,26768,0.07313381455354166,2021-11-18 14:00:12 UTC
790330,mainnet,248,107136000,107502213,366214,339398,26816,0.0732249449775268,2021-11-18 14:01:52 UTC
790332,mainnet,248,107136000,107502423,366424,339595,26829,0.07321845730628998,2021-11-18 14:03:49 UTC
790333,mainnet,248,107136000,107502575,366576,339731,26845,0.07323174457684081,2021-11-18 14:05:25 UTC
790334,mainnet,248,107136000,107502724,366725,339873,26852,0.07322107846478969,2021-11-18 14:07:01 UTC
790335,mainnet,248,107136000,107502887,366888,340006,26882,0.07327031682693357,2021-11-18 14:08:35 UTC
790336,mainnet,248,107136000,107503076,367077,340174,26903,0.07328980023264874,2021-11-18 14:10:13 UTC
790338,mainnet,248,107136000,107503246,367247,340344,26903,0.07325587411197368,2021-11-18 14:11:49 UTC
790339,mainnet,248,107136000,107503418,367419,340513,26906,0.07322974587596177,2021-11-18 14:13:29 UTC
790340,mainnet,248,107136000,107503602,367603,340681,26922,0.07323661667614247,2021-11-18 14:15:06 UTC
790342,mainnet,248,107136000,107503767,367768,340836,26932,0.07323094994670554,2021-11-18 14:16:41 UTC
790343,mainnet,248,107136000,107503949,367950,340991,26959,0.07326810707976628,2021-11-18 14:18:19 UTC
790345,mainnet,248,107136000,107504137,368138,341153,26985,0.07330131635419326,2021-11-18 14:19:57 UTC
790346,mainnet,248,107136000,107504335,368336,341325,27011,0.07333250076017549,2021-11-18 14:21:37 UTC
790348,mainnet,248,107136000,107504487,368488,341455,27033,0.0733619547990708,2021-11-18 14:23:12 UTC
790349,mainnet,248,107136000,107504664,368665,341622,27043,0.073353857838417,2021-11-18 14:24:49 UTC
790351,mainnet,248,107136000,107504818,368819,341764,27055,0.07335576529408734,2021-11-18 14:26:25 UTC
790352,mainnet,248,107136000,107505006,369007,341934,27073,0.07336717189646809,2021-11-18 14:28:00 UTC
790353,mainnet,248,107136000,107505317,369318,342212,27106,0.07339474382510465,2021-11-18 14:29:37 UTC
790354,mainnet,248,107136000,107505508,369509,342386,27123,0.07340281292201273,2021-11-18 14:31:18 UTC
790356,mainnet,248,107136000,107505692,369693,342556,27137,0.0734041488478278,2021-11-18 14:32:57 UTC
790357,mainnet,248,107136000,107505817,369818,342677,27141,0.07339015407578862,2021-11-18 14:34:37 UTC
790358,mainnet,248,107136000,107506062,370063,342897,27166,0.07340912223053912,2021-11-18 14:36:18 UTC
790359,mainnet,248,107136000,107506129,370130,342956,27174,0.07341744792370249,2021-11-18 14:37:56 UTC
790360,mainnet,248,107136000,107506279,370280,343093,27187,0.07342281516690072,2021-11-18 14:39:31 UTC
790361,mainnet,248,107136000,107506448,370449,343248,27201,0.07342711142424463,2021-11-18 14:41:06 UTC
790362,mainnet,248,107136000,107506620,370621,343398,27223,0.07345239476446289,2021-11-18 14:42:40 UTC
790363,mainnet,248,107136000,107506794,370795,343546,27249,0.07348804595531223,2021-11-18 14:44:16 UTC
790364,mainnet,248,107136000,107506975,370976,343701,27275,0.07352227637367377,2021-11-18 14:45:50 UTC
790365,mainnet,248,107136000,107507118,371119,343836,27283,0.07351550311355656,2021-11-18 14:47:24 UTC
790366,mainnet,248,107136000,107507290,371291,343980,27311,0.07355685971380939,2021-11-18 14:48:57 UTC
790367,mainnet,248,107136000,107507470,371471,344140,27331,0.07357505700310388,2021-11-18 14:50:31 UTC
790368,mainnet,248,107136000,107507657,371658,344293,27365,0.07362951961211651,2021-11-18 14:52:04 UTC
790369,mainnet,248,107136000,107507805,371806,344410,27396,0.07368358767744469,2021-11-18 14:53:33 UTC
790370,mainnet,248,107136000,107507991,371992,344560,27432,0.07374352136605088,2021-11-18 14:55:08 UTC
790371,mainnet,248,107136000,107508137,372138,344691,27447,0.07375489737677958,2021-11-18 14:56:39 UTC
790372,mainnet,248,107136000,107508279,372280,344806,27474,0.0737992908563447,2021-11-18 14:58:10 UTC
790373,mainnet,248,107136000,107508432,372433,344947,27486,0.07380119377176567,2021-11-18 14:59:43 UTC
790374,mainnet,248,107136000,107508566,372567,345071,27496,0.07380149073857857,2021-11-18 15:01:21 UTC
790375,mainnet,248,107136000,107508731,372732,345210,27522,0.0738385757058691,2021-11-18 15:02:56 UTC
790376,mainnet,248,107136000,107508911,372912,345356,27556,0.07389410906594586,2021-11-18 15:04:32 UTC
790377,mainnet,248,107136000,107509071,373072,345496,27576,0.07391602693313891,2021-11-18 15:06:25 UTC
790378,mainnet,248,107136000,107509224,373225,345623,27602,0.07395538884051175,2021-11-18 15:07:58 UTC
790379,mainnet,248,107136000,107509379,373380,345761,27619,0.07397021800846323,2021-11-18 15:09:31 UTC
790380,mainnet,248,107136000,107509527,373528,345892,27636,0.07398642136600202,2021-11-18 15:11:03 UTC
790381,mainnet,248,107136000,107509699,373700,346039,27661,0.07401926679154402,2021-11-18 15:12:36 UTC
790382,mainnet,248,107136000,107509868,373869,346173,27696,0.07407942354140086,2021-11-18 15:14:20 UTC
790383,mainnet,248,107136000,107510032,374033,346299,27734,0.07414853769587175,2021-11-18 15:16:03 UTC
790384,mainnet,248,107136000,107510157,374158,346414,27744,0.07415049257265648,2021-11-18 15:17:36 UTC
790385,mainnet,248,107136000,107510316,374317,346537,27780,0.07421517056398722,2021-11-18 15:19:08 UTC
790386,mainnet,248,107136000,107510445,374446,346646,27800,0.07424301501418094,2021-11-18 15:20:41 UTC
790387,mainnet,248,107136000,107510601,374602,346757,27845,0.07433222460104325,2021-11-18 15:22:12 UTC
790388,mainnet,248,107136000,107510757,374758,346884,27874,0.07437866569893105,2021-11-18 15:23:45 UTC
790389,mainnet,248,107136000,107510881,374882,346989,27893,0.07440474602674975,2021-11-18 15:25:17 UTC
790390,mainnet,248,107136000,107511017,375018,347096,27922,0.0744550928222112,2021-11-18 15:26:47 UTC
790391,mainnet,248,107136000,107511167,375168,347218,27950,0.07449995735243944,2021-11-18 15:28:19 UTC
790392,mainnet,248,107136000,107511292,375293,347332,27961,0.07450445385338922,2021-11-18 15:29:52 UTC
790393,mainnet,248,107136000,107511434,375435,347442,27993,0.07456150864996604,2021-11-18 15:31:25 UTC
790394,mainnet,248,107136000,107511561,375562,347563,27999,0.0745522709965332,2021-11-18 15:32:57 UTC
790395,mainnet,248,107136000,107511701,375702,347685,28017,0.07457240046632703,2021-11-18 15:34:27 UTC
790396,mainnet,248,107136000,107511835,375836,347804,28032,0.07458572356027629,2021-11-18 15:36:00 UTC
790397,mainnet,248,107136000,107512007,376008,347944,28064,0.07463670985723708,2021-11-18 15:37:42 UTC
790398,mainnet,248,107136000,107512139,376140,348057,28083,0.07466103046737917,2021-11-18 15:39:13 UTC
790399,mainnet,248,107136000,107512311,376312,348192,28120,0.07472522800229597,2021-11-18 15:40:47 UTC
790400,mainnet,248,107136000,107512482,376483,348340,28143,0.07475237925749635,2021-11-18 15:42:38 UTC
790401,mainnet,248,107136000,107512620,376621,348474,28147,0.07473560953850157,2021-11-18 15:44:09 UTC
790402,mainnet,248,107136000,107512785,376786,348611,28175,0.07477719448174826,2021-11-18 15:46:11 UTC
790403,mainnet,248,107136000,107512958,376959,348741,28218,0.07485694730726684,2021-11-18 15:47:52 UTC
790404,mainnet,248,107136000,107513172,377173,348919,28254,0.07490992197214541,2021-11-18 15:49:51 UTC
790405,mainnet,248,107136000,107513368,377369,349065,28304,0.07500351115221442,2021-11-18 15:51:32 UTC
790406,mainnet,248,107136000,107513479,377480,349162,28318,0.07501854402882271,2021-11-18 15:53:01 UTC
790407,mainnet,248,107136000,107513694,377695,349339,28356,0.07507645057519957,2021-11-18 15:54:42 UTC
790408,mainnet,248,107136000,107513848,377849,349463,28386,0.07512524844580772,2021-11-18 15:56:15 UTC
790409,mainnet,248,107136000,107514010,378011,349589,28422,0.07518828817150823,2021-11-18 15:57:42 UTC
790410,mainnet,248,107136000,107514161,378162,349708,28454,0.07524288532427902,2021-11-18 15:59:12 UTC
790411,mainnet,248,107136000,107514310,378311,349839,28472,0.07526083037500893,2021-11-18 16:00:56 UTC
790412,mainnet,248,107136000,107514489,378490,349988,28502,0.07530449945837407,2021-11-18 16:02:48 UTC
790413,mainnet,248,107136000,107514639,378640,350114,28526,0.07533805197549123,2021-11-18 16:04:19 UTC
790414,mainnet,248,107136000,107514719,378720,350177,28543,0.07536702577101817,2021-11-18 16:05:51 UTC
790415,mainnet,248,107136000,107514947,378948,350367,28581,0.07542195763007062,2021-11-18 16:07:21 UTC
790416,mainnet,248,107136000,107515106,379107,350498,28609,0.07546418293516079,2021-11-18 16:08:50 UTC
790418,mainnet,248,107136000,107515217,379218,350596,28622,0.07547637506658439,2021-11-18 16:10:24 UTC
790419,mainnet,248,107136000,107515382,379383,350723,28660,0.07554371176357401,2021-11-18 16:11:55 UTC
790421,mainnet,248,107136000,107515521,379522,350847,28675,0.07555556726619274,2021-11-18 16:13:31 UTC
790422,mainnet,248,107136000,107515712,379713,350996,28717,0.07562817180344102,2021-11-18 16:15:02 UTC
790424,mainnet,248,107136000,107515864,379865,351121,28744,0.07566898766667106,2021-11-18 16:16:32 UTC
790425,mainnet,248,107136000,107515997,379998,351245,28753,0.07566618771677745,2021-11-18 16:18:04 UTC
790426,mainnet,248,107136000,107516157,380158,351390,28768,0.0756737987889246,2021-11-18 16:19:38 UTC
790427,mainnet,248,107136000,107516303,380304,351521,28783,0.07568418949051285,2021-11-18 16:21:12 UTC
790428,mainnet,248,107136000,107516450,380451,351651,28800,0.07569963017576507,2021-11-18 16:22:51 UTC
790430,mainnet,248,107136000,107516613,380614,351795,28819,0.07571713074138103,2021-11-18 16:24:25 UTC
790431,mainnet,248,107136000,107516746,380747,351913,28834,0.07573007797829004,2021-11-18 16:26:03 UTC
790433,mainnet,248,107136000,107516890,380891,352038,28853,0.07575133043311603,2021-11-18 16:27:37 UTC
790434,mainnet,248,107136000,107517032,381033,352150,28883,0.0758018334369989,2021-11-18 16:29:11 UTC
790436,mainnet,248,107136000,107517162,381163,352269,28894,0.07580483939941705,2021-11-18 16:30:46 UTC
790437,mainnet,248,107136000,107517323,381324,352398,28926,0.07585675173867892,2021-11-18 16:32:18 UTC
790438,mainnet,248,107136000,107517456,381457,352517,28940,0.0758670046689404,2021-11-18 16:33:50 UTC
790439,mainnet,248,107136000,107517615,381616,352640,28976,0.07592973040962643,2021-11-18 16:35:25 UTC
790440,mainnet,248,107136000,107517751,381752,352743,29009,0.07598912382908275,2021-11-18 16:36:57 UTC
790441,mainnet,248,107136000,107517884,381885,352855,29030,0.07601764929232623,2021-11-18 16:38:29 UTC
790442,mainnet,248,107136000,107518029,382030,352981,29049,0.07603853100541842,2021-11-18 16:40:04 UTC
790443,mainnet,248,107136000,107518191,382192,353108,29084,0.07609787750659354,2021-11-18 16:41:45 UTC
790445,mainnet,248,107136000,107518337,382338,353232,29106,0.07612635939927499,2021-11-18 16:43:20 UTC
790446,mainnet,248,107136000,107518491,382492,353352,29140,0.07618459993934514,2021-11-18 16:45:14 UTC
790448,mainnet,248,107136000,107518671,382672,353506,29166,0.07621670778107623,2021-11-18 16:46:54 UTC
790449,mainnet,248,107136000,107518819,382820,353630,29190,0.07624993469515699,2021-11-18 16:48:24 UTC
790451,mainnet,248,107136000,107518964,382965,353748,29217,0.07629156711448827,2021-11-18 16:50:09 UTC
790452,mainnet,248,107136000,107519116,383117,353868,29249,0.07634482416598584,2021-11-18 16:51:46 UTC
790454,mainnet,248,107136000,107519268,383269,354001,29268,0.07636412023930973,2021-11-18 16:53:19 UTC
790455,mainnet,248,107136000,107519436,383437,354146,29291,0.07639064566017364,2021-11-18 16:55:05 UTC
790457,mainnet,248,107136000,107519605,383606,354297,29309,0.07640391443303807,2021-11-18 16:56:53 UTC
790458,mainnet,248,107136000,107519730,383731,354404,29327,0.0764259337921617,2021-11-18 16:58:29 UTC
790460,mainnet,248,107136000,107519936,383937,354570,29367,0.07648911149485463,2021-11-18 17:00:47 UTC
790462,mainnet,248,107136000,107520055,384056,354675,29381,0.07650186431145457,2021-11-18 17:02:34 UTC
790463,mainnet,248,107136000,107520305,384306,354858,29448,0.07662643830697413,2021-11-18 17:04:51 UTC
790465,mainnet,248,107136000,107520439,384440,354976,29464,0.07664134845489544,2021-11-18 17:06:22 UTC
790466,mainnet,248,107136000,107520574,384575,355091,29484,0.07666644997724761,2021-11-18 17:07:58 UTC
790468,mainnet,248,107136000,107520733,384734,355205,29529,0.07675172976654,2021-11-18 17:09:34 UTC
790469,mainnet,248,107136000,107520865,384866,355311,29555,0.07679296170615227,2021-11-18 17:11:09 UTC
790471,mainnet,248,107136000,107521004,385005,355436,29569,0.07680159997922105,2021-11-18 17:12:42 UTC
790472,mainnet,248,107136000,107521154,385155,355551,29604,0.07686256182575846,2021-11-18 17:14:31 UTC
790474,mainnet,248,107136000,107521331,385332,355709,29623,0.07687656358672522,2021-11-18 17:16:49 UTC
790476,mainnet,248,107136000,107521528,385529,355867,29662,0.07693844042860588,2021-11-18 17:19:04 UTC
790477,mainnet,248,107136000,107521712,385713,356021,29692,0.07697951585764545,2021-11-18 17:20:49 UTC
790479,mainnet,248,107136000,107521862,385863,356151,29712,0.07700142278477076,2021-11-18 17:22:26 UTC
790480,mainnet,248,107136000,107522038,386039,356303,29736,0.07702848675910984,2021-11-18 17:24:24 UTC
790482,mainnet,248,107136000,107522195,386196,356442,29754,0.07704378087810335,2021-11-18 17:26:12 UTC
790484,mainnet,248,107136000,107522343,386344,356567,29777,0.07707379951545773,2021-11-18 17:27:54 UTC
790485,mainnet,248,107136000,107522502,386503,356700,29803,0.07710936266988871,2021-11-18 17:29:39 UTC
790486,mainnet,248,107136000,107522635,386636,356820,29816,0.07711646096069688,2021-11-18 17:31:14 UTC
790488,mainnet,248,107136000,107522786,386787,356940,29847,0.07716650249362052,2021-11-18 17:32:52 UTC
790489,mainnet,248,107136000,107522991,386992,357107,29885,0.07722381858022904,2021-11-18 17:35:00 UTC
790491,mainnet,248,107136000,107523165,387166,357267,29899,0.07722527288036656,2021-11-18 17:36:48 UTC
790492,mainnet,248,107136000,107523325,387326,357402,29924,0.07725791710342192,2021-11-18 17:38:31 UTC
790494,mainnet,248,107136000,107523501,387502,357550,29952,0.07729508492859391,2021-11-18 17:40:23 UTC
790495,mainnet,248,107136000,107523644,387645,357671,29974,0.07732332417546982,2021-11-18 17:41:59 UTC
790496,mainnet,248,107136000,107523812,387813,357809,30004,0.07736718469984245,2021-11-18 17:43:36 UTC
790498,mainnet,248,107136000,107523940,387941,357927,30014,0.0773674347387876,2021-11-18 17:45:14 UTC
790499,mainnet,248,107136000,107524116,388117,358068,30049,0.077422529804157,2021-11-18 17:47:13 UTC
790501,mainnet,248,107136000,107524322,388323,358244,30079,0.07745871349366378,2021-11-18 17:48:47 UTC
790502,mainnet,248,107136000,107524459,388460,358366,30094,0.07747000978221696,2021-11-18 17:50:24 UTC
790504,mainnet,248,107136000,107524643,388644,358525,30119,0.07749765852554008,2021-11-18 17:52:12 UTC
790505,mainnet,248,107136000,107524828,388829,358682,30147,0.07753279719362496,2021-11-18 17:53:53 UTC
790507,mainnet,248,107136000,107525040,389041,358855,30186,0.07759079377237875,2021-11-18 17:55:29 UTC
790509,mainnet,248,107136000,107525281,389282,359075,30207,0.07759670367497085,2021-11-18 17:57:48 UTC
790510,mainnet,248,107136000,107525468,389469,359239,30230,0.07761850108737794,2021-11-18 17:59:26 UTC
790512,mainnet,248,107136000,107525635,389636,359406,30230,0.07758523339732468,2021-11-18 18:01:17 UTC
790513,mainnet,248,107136000,107525817,389818,359567,30251,0.07760288134462749,2021-11-18 18:02:54 UTC
790515,mainnet,248,107136000,107526012,390013,359747,30266,0.07760254145374641,2021-11-18 18:04:45 UTC
790517,mainnet,248,107136000,107526212,390213,359928,30285,0.07761145835735868,2021-11-18 18:06:30 UTC
790518,mainnet,248,107136000,107526451,390452,360146,30306,0.07761773534262854,2021-11-18 18:08:38 UTC
790520,mainnet,248,107136000,107526699,390700,360356,30344,0.07766572818018941,2021-11-18 18:10:46 UTC
790521,mainnet,248,107136000,107526908,390909,360547,30362,0.07767025062098852,2021-11-18 18:12:35 UTC
790523,mainnet,248,107136000,107527078,391079,360702,30377,0.07767484319025056,2021-11-18 18:14:12 UTC
790524,mainnet,248,107136000,107527263,391264,360870,30394,0.07768156538807557,2021-11-18 18:15:49 UTC
790527,mainnet,248,107136000,107527452,391453,361045,30408,0.0776798236314449,2021-11-18 18:17:28 UTC
790528,mainnet,248,107136000,107527634,391635,361219,30416,0.07766415156970138,2021-11-18 18:19:01 UTC
790529,mainnet,248,107136000,107527829,391830,361398,30432,0.07766633489013093,2021-11-18 18:20:37 UTC
790530,mainnet,248,107136000,107528003,392004,361556,30448,0.07767267680942032,2021-11-18 18:22:14 UTC
790531,mainnet,248,107136000,107528196,392197,361723,30474,0.07770074732851093,2021-11-18 18:23:49 UTC
790532,mainnet,248,107136000,107528368,392369,361870,30499,0.0777304017391792,2021-11-18 18:25:27 UTC
790533,mainnet,248,107136000,107528536,392537,362026,30511,0.077727704649498,2021-11-18 18:27:00 UTC
790534,mainnet,248,107136000,107528679,392680,362165,30515,0.07770958541305897,2021-11-18 18:28:34 UTC
790535,mainnet,248,107136000,107528902,392903,362358,30545,0.07774183449859126,2021-11-18 18:30:08 UTC
790536,mainnet,248,107136000,107529064,393065,362514,30551,0.0777250581964815,2021-11-18 18:31:43 UTC
790537,mainnet,248,107136000,107529219,393220,362655,30565,0.07773002390519303,2021-11-18 18:33:15 UTC
790538,mainnet,248,107136000,107529382,393383,362814,30569,0.07770798433079212,2021-11-18 18:34:49 UTC
790539,mainnet,248,107136000,107529549,393550,362964,30586,0.07771820607292593,2021-11-18 18:36:21 UTC
790540,mainnet,248,107136000,107529732,393733,363134,30599,0.0777151013504075,2021-11-18 18:37:54 UTC
790541,mainnet,248,107136000,107529915,393916,363302,30614,0.07771707673717239,2021-11-18 18:39:28 UTC
790542,mainnet,248,107136000,107530085,394086,363459,30627,0.07771653902955193,2021-11-18 18:41:02 UTC
790543,mainnet,248,107136000,107530340,394341,363696,30645,0.07771192952292559,2021-11-18 18:43:18 UTC
790544,mainnet,248,107136000,107530519,394520,363854,30666,0.07772989962486059,2021-11-18 18:44:52 UTC
790545,mainnet,248,107136000,107530698,394699,364016,30683,0.07773771912267323,2021-11-18 18:46:26 UTC
790546,mainnet,248,107136000,107530880,394881,364168,30713,0.07777786219139438,2021-11-18 18:48:12 UTC
790547,mainnet,248,107136000,107531072,395073,364348,30725,0.07777043736220901,2021-11-18 18:49:56 UTC
790548,mainnet,248,107136000,107531271,395272,364539,30733,0.07775152300188225,2021-11-18 18:51:29 UTC
790550,mainnet,248,107136000,107531446,395447,364697,30750,0.07776010438819868,2021-11-18 18:53:04 UTC
790552,mainnet,248,107136000,107531661,395662,364903,30759,0.07774059677199226,2021-11-18 18:54:50 UTC
790555,mainnet,248,107136000,107531828,395829,365057,30772,0.07774064052911737,2021-11-18 18:56:24 UTC
790557,mainnet,248,107136000,107532031,396032,365240,30792,0.07775129282482224,2021-11-18 18:58:09 UTC
790560,mainnet,248,107136000,107532236,396237,365437,30800,0.07773125679833029,2021-11-18 18:59:53 UTC
790562,mainnet,248,107136000,107532402,396403,365598,30805,0.07771131903643515,2021-11-18 19:01:37 UTC
790564,mainnet,248,107136000,107532576,396577,365756,30821,0.07771756808892094,2021-11-18 19:03:12 UTC
790566,mainnet,248,107136000,107532736,396737,365903,30834,0.07771899268281002,2021-11-18 19:04:44 UTC
790568,mainnet,248,107136000,107532903,396904,366060,30844,0.07771148690867313,2021-11-18 19:06:19 UTC
790569,mainnet,248,107136000,107533223,397224,366349,30875,0.07772692485851812,2021-11-18 19:07:57 UTC
790571,mainnet,248,107365256,107533410,168155,153954,14201,0.08445184502393625,2021-11-18 19:09:32 UTC
790574,mainnet,248,107265276,107533571,268296,246890,21406,0.07978501356710499,2021-11-18 19:11:07 UTC
790575,mainnet,248,107136000,107533756,397757,366842,30915,0.07772333359312344,2021-11-18 19:12:49 UTC
790578,mainnet,248,107136000,107533952,397953,367009,30944,0.07775792618726332,2021-11-18 19:14:27 UTC
790579,mainnet,248,107136000,107534131,398132,367179,30953,0.07774557182040127,2021-11-18 19:16:09 UTC
790582,mainnet,248,107136000,107534320,398321,367357,30964,0.07773629811132228,2021-11-18 19:17:51 UTC
790584,mainnet,248,107136000,107534501,398502,367502,31000,0.07779132852532736,2021-11-18 19:19:26 UTC
790585,mainnet,248,107136000,107534683,398684,367669,31015,0.07779344041897844,2021-11-18 19:21:06 UTC
790586,mainnet,248,107136000,107534877,398878,367853,31025,0.07778067479279378,2021-11-18 19:22:45 UTC
790587,mainnet,248,107136000,107535048,399049,368024,31025,0.07774734431109964,2021-11-18 19:24:23 UTC
790589,mainnet,248,107136000,107535033,399034,368009,31025,0.07775026689455034,2021-11-18 19:25:57 UTC
790591,mainnet,248,107136000,107535367,399368,368317,31051,0.07775034554596262,2021-11-18 19:27:33 UTC
790593,mainnet,248,107136000,107535447,399448,368369,31079,0.07780487072159581,2021-11-18 19:29:09 UTC
790595,mainnet,248,107136000,107535632,399633,368532,31101,0.0778239034313983,2021-11-18 19:30:53 UTC
790597,mainnet,248,107136000,107535820,399821,368695,31126,0.07784983780241658,2021-11-18 19:32:31 UTC
790599,mainnet,248,107136000,107536043,400044,368892,31152,0.07787143414224436,2021-11-18 19:34:31 UTC
790601,mainnet,248,107136000,107536214,400215,369044,31171,0.07788563647039716,2021-11-18 19:36:10 UTC
790603,mainnet,248,107136000,107536317,400318,369145,31173,0.07787059287866147,2021-11-18 19:37:53 UTC
790605,mainnet,248,107136000,107536736,400737,369492,31245,0.07796884240786352,2021-11-18 19:40:18 UTC
790607,mainnet,248,107136000,107536908,400909,369654,31255,0.077960335138398,2021-11-18 19:41:57 UTC
790609,mainnet,248,107136000,107537092,401093,369827,31266,0.07795199617046421,2021-11-18 19:43:32 UTC
790611,mainnet,248,107136000,107537257,401258,369984,31274,0.07793987908029248,2021-11-18 19:45:11 UTC
790613,mainnet,248,107136000,107537440,401441,370152,31289,0.07794171497181404,2021-11-18 19:46:50 UTC
790615,mainnet,248,107136000,107537589,401590,370289,31301,0.07794267785552429,2021-11-18 19:48:25 UTC
790617,mainnet,248,107136000,107537786,401787,370458,31329,0.07797415048271845,2021-11-18 19:50:03 UTC
790619,mainnet,248,107136000,107537957,401958,370603,31355,0.07800566228312411,2021-11-18 19:51:42 UTC
790621,mainnet,248,107136000,107538236,402237,370851,31386,0.07802862491516195,2021-11-18 19:53:55 UTC
790623,mainnet,248,107136000,107538435,402436,371039,31397,0.07801737419117574,2021-11-18 19:55:36 UTC
790625,mainnet,248,107136000,107538624,402625,371202,31423,0.07804532753803167,2021-11-18 19:57:13 UTC
790626,mainnet,248,107136000,107538811,402812,371377,31435,0.07803888662701211,2021-11-18 19:58:50 UTC
790627,mainnet,248,107136000,107539018,403019,371567,31452,0.07804098566072568,2021-11-18 20:00:36 UTC
790629,mainnet,248,107136000,107539205,403206,371745,31461,0.07802711269177542,2021-11-18 20:02:17 UTC
790631,mainnet,248,107136000,107539398,403399,371925,31474,0.07802200798712937,2021-11-18 20:04:01 UTC
790633,mainnet,248,107136000,107539594,403595,372118,31477,0.07799155093596304,2021-11-18 20:06:03 UTC
790634,mainnet,248,107136000,107539771,403772,372283,31489,0.077987081818452,2021-11-18 20:07:42 UTC
790636,mainnet,248,107136000,107539949,403950,372438,31512,0.07800965466023023,2021-11-18 20:09:55 UTC
790638,mainnet,248,107136000,107540176,404177,372645,31532,0.0780153249690111,2021-11-18 20:11:36 UTC
790640,mainnet,248,107136000,107540355,404356,372808,31548,0.07802035829813332,2021-11-18 20:13:25 UTC
790642,mainnet,248,107136000,107540542,404543,372971,31572,0.07804361959050089,2021-11-18 20:15:06 UTC
790644,mainnet,248,107136000,107540857,404858,373266,31592,0.07803229774390033,2021-11-18 20:16:44 UTC
790645,mainnet,248,107136000,107541059,405060,373443,31617,0.07805510294771145,2021-11-18 20:18:26 UTC
790647,mainnet,248,107136000,107541266,405267,373623,31644,0.07808185714602965,2021-11-18 20:20:12 UTC
790649,mainnet,248,107136000,107541473,405474,373812,31662,0.07808638778318708,2021-11-18 20:21:56 UTC
790651,mainnet,248,107136000,107541668,405669,373986,31683,0.07810061897754081,2021-11-18 20:23:38 UTC
790653,mainnet,248,107365256,107541884,176629,161638,14991,0.08487281250530773,2021-11-18 20:25:40 UTC
790655,mainnet,248,107136000,107542103,406104,374384,31720,0.0781080708389969,2021-11-18 20:27:26 UTC
790657,mainnet,248,107136000,107542291,406292,374561,31731,0.07809900268772213,2021-11-18 20:29:06 UTC
790658,mainnet,248,107136000,107542483,406484,374741,31743,0.078091634603084,2021-11-18 20:30:52 UTC
790659,mainnet,248,107136000,107542703,406704,374949,31755,0.07807889767496755,2021-11-18 20:32:33 UTC
790661,mainnet,248,107136000,107542863,406864,375104,31760,0.07806048212670573,2021-11-18 20:34:17 UTC
790663,mainnet,248,107275116,107543102,267987,246534,21453,0.08005239060103662,2021-11-18 20:35:56 UTC
790664,mainnet,248,107136000,107543305,407306,375507,31799,0.07807152362106132,2021-11-18 20:37:42 UTC
790665,mainnet,248,107136000,107543488,407489,375682,31807,0.07805609476574828,2021-11-18 20:39:19 UTC
790667,mainnet,248,107136000,107543734,407735,375894,31841,0.07809238843856917,2021-11-18 20:41:28 UTC
790669,mainnet,248,107136000,107543906,407907,376056,31851,0.07808397502371864,2021-11-18 20:43:09 UTC
790671,mainnet,248,107136000,107544082,408083,376223,31860,0.07807235292820333,2021-11-18 20:44:54 UTC
790672,mainnet,248,107136000,107544262,408263,376390,31873,0.07806977365080843,2021-11-18 20:46:31 UTC
790674,mainnet,248,107136000,107544472,408473,376573,31900,0.07809573704993965,2021-11-18 20:48:14 UTC
790675,mainnet,248,107136000,107544650,408651,376743,31908,0.07808129675444328,2021-11-18 20:49:51 UTC
790677,mainnet,248,107136000,107544841,408842,376928,31914,0.07805949486598734,2021-11-18 20:51:35 UTC
790679,mainnet,248,107136000,107545027,409028,377109,31919,0.07803622245909815,2021-11-18 20:53:15 UTC
790680,mainnet,248,107136000,107545185,409186,377261,31925,0.0780207533982101,2021-11-18 20:54:57 UTC
790682,mainnet,248,107136000,107545392,409393,377442,31951,0.07804481268609868,2021-11-18 20:56:38 UTC
790684,mainnet,248,107136000,107545593,409594,377635,31959,0.078026045303398,2021-11-18 20:58:25 UTC
790686,mainnet,248,107136000,107545795,409796,377833,31963,0.0779973450204492,2021-11-18 21:00:12 UTC
790688,mainnet,248,107136000,107546016,410017,378047,31970,0.07797237675511015,2021-11-18 21:02:14 UTC
790690,mainnet,248,107136000,107546192,410193,378215,31978,0.0779584244489789,2021-11-18 21:03:57 UTC
790691,mainnet,248,107136000,107546375,410376,378395,31981,0.07793097062206367,2021-11-18 21:05:37 UTC
790693,mainnet,248,107136000,107546555,410556,378566,31990,0.07791872485117743,2021-11-18 21:07:21 UTC
790695,mainnet,248,107136000,107546764,410765,378765,32000,0.07790342409893734,2021-11-18 21:09:18 UTC
790697,mainnet,248,107136000,107546951,410952,378946,32006,0.07788257509392825,2021-11-18 21:10:53 UTC
790699,mainnet,248,107136000,107547156,411157,379134,32023,0.07788509012372402,2021-11-18 21:12:34 UTC
790700,mainnet,248,107136000,107547347,411348,379308,32040,0.07789025350797865,2021-11-18 21:14:15 UTC
790702,mainnet,248,107136000,107547584,411585,379532,32053,0.07787698774250762,2021-11-18 21:16:08 UTC
790704,mainnet,248,107136000,107547765,411766,379707,32059,0.07785732673411598,2021-11-18 21:17:46 UTC
790706,mainnet,248,107136000,107547951,411952,379880,32072,0.07785373053171243,2021-11-18 21:19:26 UTC
790708,mainnet,248,107136000,107548156,412157,380072,32085,0.07784654876661078,2021-11-18 21:21:25 UTC
790709,mainnet,248,107136000,107548398,412399,380292,32107,0.07785421400148886,2021-11-18 21:23:10 UTC
790711,mainnet,248,107136000,107548576,412577,380449,32128,0.07787152458813748,2021-11-18 21:24:50 UTC
790713,mainnet,248,107136000,107548773,412774,380638,32136,0.07785374078793722,2021-11-18 21:26:28 UTC
790715,mainnet,248,107136000,107548956,412957,380812,32145,0.07784103429654904,2021-11-18 21:28:07 UTC
790716,mainnet,248,107136000,107549134,413135,380973,32162,0.07784864511600324,2021-11-18 21:29:49 UTC
790718,mainnet,248,107136000,107549336,413337,381148,32189,0.07787592206843326,2021-11-18 21:31:30 UTC
790720,mainnet,248,107136000,107549522,413523,381320,32203,0.07787474940934362,2021-11-18 21:33:06 UTC
790721,mainnet,248,107136000,107549712,413713,381507,32206,0.07784623640059656,2021-11-18 21:34:48 UTC
790723,mainnet,248,107136000,107549902,413903,381693,32210,0.07782016559435423,2021-11-18 21:36:28 UTC
790725,mainnet,248,107136000,107550093,414094,381872,32222,0.07781325013161262,2021-11-18 21:38:04 UTC
790726,mainnet,248,107136000,107550293,414294,382067,32227,0.07778775458973579,2021-11-18 21:39:43 UTC
790728,mainnet,248,107136000,107550455,414456,382210,32246,0.07780319261875808,2021-11-18 21:41:17 UTC
790729,mainnet,248,107282367,107550637,268271,246800,21471,0.08003474098952179,2021-11-18 21:42:54 UTC
790731,mainnet,248,107136000,107550823,414824,382560,32264,0.07777756349680828,2021-11-18 21:44:28 UTC
790732,mainnet,248,107136000,107550995,414996,382715,32281,0.07778629191606666,2021-11-18 21:46:06 UTC
790734,mainnet,248,107136000,107551155,415156,382863,32293,0.07778521808669513,2021-11-18 21:47:44 UTC
790736,mainnet,248,107136000,107551324,415325,383022,32303,0.0777776440137242,2021-11-18 21:49:21 UTC
790737,mainnet,248,107136000,107551525,415526,383205,32321,0.07778333967068246,2021-11-18 21:51:09 UTC
790739,mainnet,248,107136000,107551708,415709,383375,32334,0.07778037040333502,2021-11-18 21:52:55 UTC
790741,mainnet,248,107136000,107551918,415919,383559,32360,0.07780361079921812,2021-11-18 21:54:59 UTC
790743,mainnet,248,107136000,107552094,416095,383722,32373,0.07780194426753506,2021-11-18 21:56:35 UTC
790744,mainnet,248,107136000,107552271,416272,383886,32386,0.07780009224737672,2021-11-18 21:58:12 UTC
790746,mainnet,248,107136000,107552439,416440,384041,32399,0.07779992315819806,2021-11-18 21:59:49 UTC
790748,mainnet,248,107136000,107552639,416640,384224,32416,0.07780337941628264,2021-11-18 22:01:41 UTC
790750,mainnet,248,107136000,107552860,416861,384440,32421,0.07777412614756478,2021-11-18 22:03:32 UTC
790751,mainnet,248,107365256,107553072,187817,172100,15717,0.08368252075158265,2021-11-18 22:05:20 UTC
790753,mainnet,248,107136000,107553279,417280,384824,32456,0.07777990797546012,2021-11-18 22:07:09 UTC
790755,mainnet,248,107136000,107553495,417496,385013,32483,0.07780433824515684,2021-11-18 22:08:58 UTC
790757,mainnet,248,107136000,107553676,417677,385180,32497,0.07780414052006694,2021-11-18 22:10:52 UTC
790758,mainnet,248,107136000,107553861,417862,385346,32516,0.07781516385792439,2021-11-18 22:12:42 UTC
790760,mainnet,248,107136000,107554042,418043,385504,32539,0.07783649050456531,2021-11-18 22:14:24 UTC
790762,mainnet,248,107136000,107554257,418258,385701,32557,0.0778395153230781,2021-11-18 22:16:33 UTC
790763,mainnet,248,107136000,107554452,418453,385880,32573,0.07784147801545216,2021-11-18 22:18:18 UTC
790765,mainnet,248,107136000,107554624,418625,386047,32578,0.07782143923559272,2021-11-18 22:19:55 UTC
790766,mainnet,248,107136000,107554808,418809,386218,32591,0.07781828948279526,2021-11-18 22:21:33 UTC
790768,mainnet,248,107136000,107554987,418988,386389,32599,0.07780413758866603,2021-11-18 22:23:09 UTC
790769,mainnet,248,107136000,107555157,419158,386547,32611,0.07780121099919363,2021-11-18 22:24:51 UTC
790770,mainnet,248,107136000,107555359,419360,386740,32620,0.07778519648988935,2021-11-18 22:26:35 UTC
790772,mainnet,248,107136000,107555542,419543,386907,32636,0.0777894041850299,2021-11-18 22:28:11 UTC
790773,mainnet,248,107136000,107555721,419722,387060,32662,0.07781817488718723,2021-11-18 22:29:46 UTC
790774,mainnet,248,107136000,107555912,419913,387247,32666,0.0777923045964283,2021-11-18 22:31:20 UTC
790775,mainnet,248,107288095,107556110,268016,246450,21566,0.08046534535251627,2021-11-18 22:33:00 UTC
790776,mainnet,248,107136000,107556286,420287,387619,32668,0.07772783835807437,2021-11-18 22:34:39 UTC
790778,mainnet,248,107136000,107556464,420465,387786,32679,0.07772109450251508,2021-11-18 22:36:19 UTC
790779,mainnet,248,107136000,107556678,420679,387986,32693,0.0777148372036636,2021-11-18 22:37:57 UTC
790781,mainnet,248,107136000,107556858,420859,388165,32694,0.0776839749179654,2021-11-18 22:39:39 UTC
790783,mainnet,248,107136000,107557081,421082,388379,32703,0.07766420792149747,2021-11-18 22:41:28 UTC
790784,mainnet,248,107136000,107557285,421286,388574,32712,0.07764796361616574,2021-11-18 22:43:20 UTC
790786,mainnet,248,107136000,107557475,421476,388747,32729,0.07765329461226736,2021-11-18 22:45:01 UTC
790788,mainnet,248,107136000,107557687,421688,388956,32732,0.07762136935364534,2021-11-18 22:46:56 UTC
790789,mainnet,248,107136000,107557908,421909,389152,32757,0.07763996501615278,2021-11-18 22:48:49 UTC
790791,mainnet,248,107136000,107558091,422092,389319,32773,0.07764421026695602,2021-11-18 22:50:33 UTC
790793,mainnet,248,107136000,107558326,422327,389508,32819,0.07770992619463117,2021-11-18 22:52:23 UTC
790794,mainnet,248,107136000,107558536,422537,389707,32830,0.07769733774793687,2021-11-18 22:54:20 UTC
790796,mainnet,248,107136000,107558706,422707,389866,32841,0.07769211297660081,2021-11-18 22:55:57 UTC
790798,mainnet,248,107136000,107558916,422917,390060,32857,0.07769136733685333,2021-11-18 22:57:32 UTC
790800,mainnet,248,107136000,107559176,423177,390318,32859,0.07764835990613857,2021-11-18 22:59:58 UTC
790801,mainnet,248,107136000,107559360,423361,390487,32874,0.077650043343624,2021-11-18 23:01:33 UTC
790803,mainnet,248,107136000,107559525,423526,390649,32877,0.0776268753276068,2021-11-18 23:03:06 UTC
790804,mainnet,248,107136000,107559693,423694,390801,32893,0.07763385839780597,2021-11-18 23:04:38 UTC
790806,mainnet,248,107136000,107559856,423857,390959,32898,0.07761579966828434,2021-11-18 23:06:10 UTC
790808,mainnet,248,107136000,107560042,424043,391130,32913,0.07761712845159571,2021-11-18 23:07:45 UTC
790809,mainnet,248,107136000,107560221,424222,391294,32928,0.07761973683590195,2021-11-18 23:09:26 UTC
790811,mainnet,248,107136000,107560404,424405,391465,32940,0.07761454271273902,2021-11-18 23:11:01 UTC
790812,mainnet,248,107136000,107560573,424574,391620,32954,0.07761662277953903,2021-11-18 23:12:37 UTC
790814,mainnet,248,107136000,107560756,424757,391795,32962,0.07760201715333709,2021-11-18 23:14:13 UTC
790816,mainnet,248,107136000,107560937,424938,391964,32974,0.0775972024154112,2021-11-18 23:15:50 UTC
790817,mainnet,248,107136000,107561126,425127,392135,32992,0.07760504508064649,2021-11-18 23:17:27 UTC
790819,mainnet,248,107136000,107561316,425317,392316,33001,0.07759153760606795,2021-11-18 23:19:03 UTC
790820,mainnet,248,107136000,107561488,425489,392476,33013,0.07758837478759732,2021-11-18 23:20:39 UTC
790822,mainnet,248,107136000,107561664,425665,392638,33027,0.0775891839827094,2021-11-18 23:22:14 UTC
790823,mainnet,248,107136000,107561838,425839,392801,33038,0.07758331200289312,2021-11-18 23:23:49 UTC
790825,mainnet,248,107136000,107562019,426020,392964,33056,0.07759260128632459,2021-11-18 23:25:25 UTC
790826,mainnet,248,107136000,107562199,426200,393132,33068,0.07758798686062882,2021-11-18 23:26:59 UTC
790827,mainnet,248,107136000,107562353,426354,393274,33080,0.07758810753505303,2021-11-18 23:28:35 UTC
790829,mainnet,248,107136000,107562548,426549,393450,33099,0.07759718109759957,2021-11-18 23:30:12 UTC
790830,mainnet,248,107136000,107562727,426728,393608,33120,0.0776138430100673,2021-11-18 23:31:50 UTC
790831,mainnet,248,107136000,107562884,426885,393744,33141,0.07763449172493762,2021-11-18 23:33:26 UTC
790833,mainnet,248,107136000,107563048,427049,393898,33151,0.077628094199963,2021-11-18 23:35:02 UTC
790835,mainnet,248,107136000,107563246,427247,394083,33164,0.07762254620863342,2021-11-18 23:36:40 UTC
790836,mainnet,248,107136000,107563417,427418,394249,33169,0.07760318938369465,2021-11-18 23:38:19 UTC
790838,mainnet,248,107136000,107563629,427630,394439,33191,0.07761616350583449,2021-11-18 23:40:05 UTC
790840,mainnet,248,107136000,107563888,427889,394686,33203,0.07759722731829984,2021-11-18 23:42:24 UTC
790841,mainnet,248,107136000,107564090,428091,394871,33220,0.07760032329574787,2021-11-18 23:44:19 UTC
790843,mainnet,248,107136000,107564284,428285,395035,33250,0.07763521953839149,2021-11-18 23:45:54 UTC
790845,mainnet,248,107136000,107564488,428489,395222,33267,0.07763793236232436,2021-11-18 23:47:43 UTC
790846,mainnet,248,107136000,107564678,428679,395410,33269,0.07760818701172673,2021-11-18 23:49:29 UTC
790848,mainnet,248,107136000,107564903,428904,395613,33291,0.07761876783615915,2021-11-18 23:51:28 UTC
790850,mainnet,248,107136000,107565133,429134,395830,33304,0.07760746060671025,2021-11-18 23:53:27 UTC
790851,mainnet,248,107136000,107565318,429319,396004,33315,0.07759964036066422,2021-11-18 23:55:05 UTC
790853,mainnet,248,107136000,107565555,429556,396218,33338,0.07761036977716526,2021-11-18 23:57:12 UTC
790855,mainnet,248,107136000,107565756,429757,396400,33357,0.07761828195933981,2021-11-18 23:58:57 UTC
790857,mainnet,248,107136000,107565961,429962,396596,33366,0.07760220670663918,2021-11-19 00:00:46 UTC
790858,mainnet,248,107136000,107566129,430130,396751,33379,0.07760212028921488,2021-11-19 00:02:21 UTC
790859,mainnet,248,107136000,107566326,430327,396937,33390,0.07759215666225916,2021-11-19 00:04:09 UTC
790861,mainnet,248,107136000,107566489,430490,397079,33411,0.0776115589212293,2021-11-19 00:05:43 UTC
790863,mainnet,248,107136000,107566666,430667,397235,33432,0.07762842288821759,2021-11-19 00:07:18 UTC
790864,mainnet,248,107136000,107566833,430834,397388,33446,0.07763082765055683,2021-11-19 00:08:51 UTC
790865,mainnet,248,107136000,107567007,431008,397534,33474,0.07766445170391269,2021-11-19 00:10:28 UTC
790867,mainnet,248,107136000,107567178,431179,397672,33507,0.07771018532906288,2021-11-19 00:12:06 UTC
790868,mainnet,248,107136000,107567339,431340,397809,33531,0.07773682014188343,2021-11-19 00:13:42 UTC
790870,mainnet,248,107136000,107567486,431487,397943,33544,0.0777404649502766,2021-11-19 00:15:18 UTC
790871,mainnet,248,107136000,107567632,431633,398071,33562,0.07775587130733748,2021-11-19 00:16:55 UTC
790873,mainnet,248,107136000,107567806,431807,398231,33576,0.07775696086446028,2021-11-19 00:18:32 UTC
790875,mainnet,248,107136000,107567965,431966,398366,33600,0.07778389965876945,2021-11-19 00:20:07 UTC
790876,mainnet,248,107136000,107567965,431966,398366,33600,0.07778389965876945,2021-11-19 00:21:49 UTC
790881,mainnet,249,107568000,107569195,1196,880,316,0.26421404682274247,2021-11-19 00:32:04 UTC
790882,mainnet,249,107568000,107569363,1364,1021,343,0.25146627565982405,2021-11-19 00:33:27 UTC
790884,mainnet,249,107568000,107569503,1504,1149,355,0.2360372340425532,2021-11-19 00:34:50 UTC
790885,mainnet,249,107568000,107569663,1664,1301,363,0.21814903846153846,2021-11-19 00:36:21 UTC
790887,mainnet,249,107568000,107569829,1830,1447,383,0.20928961748633879,2021-11-19 00:38:03 UTC
790889,mainnet,249,107568000,107569999,2000,1611,389,0.1945,2021-11-19 00:39:37 UTC
790890,mainnet,249,107568000,107570179,2180,1777,403,0.1848623853211009,2021-11-19 00:41:23 UTC
790892,mainnet,249,107568000,107570317,2318,1909,409,0.17644521138912855,2021-11-19 00:42:48 UTC
790893,mainnet,249,107568000,107570490,2491,2055,436,0.17503010839020475,2021-11-19 00:44:20 UTC
790895,mainnet,249,107568000,107570630,2631,2189,442,0.16799695933105283,2021-11-19 00:45:52 UTC
790896,mainnet,249,107568000,107570800,2801,2342,459,0.1638700464119957,2021-11-19 00:47:13 UTC
790898,mainnet,249,107568000,107571049,3050,2578,472,0.15475409836065573,2021-11-19 00:49:12 UTC
790900,mainnet,249,107568000,107571226,3227,2737,490,0.15184381778741865,2021-11-19 00:50:42 UTC
790901,mainnet,249,107568000,107571376,3377,2878,499,0.1477642878294344,2021-11-19 00:52:04 UTC
790903,mainnet,249,107568000,107571539,3540,3015,525,0.1483050847457627,2021-11-19 00:53:27 UTC
790904,mainnet,249,107568000,107571678,3679,3151,528,0.14351726012503396,2021-11-19 00:54:51 UTC
790906,mainnet,249,107568000,107571852,3853,3298,555,0.1440436023877498,2021-11-19 00:56:11 UTC
790907,mainnet,249,107568000,107572011,4012,3439,573,0.14282153539381853,2021-11-19 00:57:36 UTC
790909,mainnet,249,107568000,107572147,4148,3561,587,0.14151398264223722,2021-11-19 00:59:00 UTC
790910,mainnet,249,107568000,107572290,4291,3696,595,0.13866231647634583,2021-11-19 01:00:24 UTC
790911,mainnet,249,107568000,107572493,4494,3879,615,0.13684913217623498,2021-11-19 01:02:01 UTC
790912,mainnet,249,107568000,107572656,4657,4036,621,0.1333476487008804,2021-11-19 01:03:28 UTC
790914,mainnet,249,107568000,107572816,4817,4188,629,0.13057919867137222,2021-11-19 01:04:54 UTC
790915,mainnet,249,107568000,107572963,4964,4316,648,0.1305398871877518,2021-11-19 01:06:21 UTC
790917,mainnet,249,107568000,107573162,5163,4506,657,0.1272515979081929,2021-11-19 01:07:51 UTC
790918,mainnet,249,107568000,107573333,5334,4649,685,0.1284214473190851,2021-11-19 01:09:21 UTC
790919,mainnet,249,107568000,107573530,5531,4828,703,0.1271017899114084,2021-11-19 01:10:52 UTC
790921,mainnet,249,107568000,107573704,5705,4998,707,0.12392638036809817,2021-11-19 01:12:18 UTC
790922,mainnet,249,107568000,107573805,5806,5087,719,0.12383740957630038,2021-11-19 01:13:44 UTC
790924,mainnet,249,107568000,107574053,6054,5252,802,0.13247439709283118,2021-11-19 01:15:14 UTC
790925,mainnet,249,107568000,107574188,6189,5373,816,0.13184682501211828,2021-11-19 01:16:45 UTC
790926,mainnet,249,107568000,107574374,6375,5539,836,0.1311372549019608,2021-11-19 01:18:13 UTC
790927,mainnet,249,107568000,107574542,6543,5693,850,0.12990982729634723,2021-11-19 01:19:46 UTC
790929,mainnet,249,107568000,107574716,6717,5856,861,0.12818222420723538,2021-11-19 01:21:15 UTC
790930,mainnet,249,107568000,107574847,6848,5987,861,0.1257301401869159,2021-11-19 01:22:42 UTC
790932,mainnet,249,107568000,107575037,7038,6153,885,0.1257459505541347,2021-11-19 01:24:11 UTC
790933,mainnet,249,107568000,107575237,7238,6336,902,0.12462006079027356,2021-11-19 01:25:45 UTC
790935,mainnet,249,107568000,107575396,7397,6490,907,0.12261727727457077,2021-11-19 01:27:12 UTC
790936,mainnet,249,107568000,107575562,7563,6639,924,0.12217374057913527,2021-11-19 01:28:36 UTC
790937,mainnet,249,107568000,107575717,7718,6781,937,0.12140450894013993,2021-11-19 01:30:01 UTC
790939,mainnet,249,107568000,107575888,7889,6925,964,0.12219546203574598,2021-11-19 01:31:27 UTC
790940,mainnet,249,107568000,107576062,8063,7090,973,0.12067468684112613,2021-11-19 01:32:53 UTC
790942,mainnet,249,107568000,107576256,8257,7276,981,0.11880828388034395,2021-11-19 01:34:38 UTC
790944,mainnet,249,107568000,107576439,8440,7454,986,0.11682464454976303,2021-11-19 01:36:02 UTC
790945,mainnet,249,107568000,107576613,8614,7602,1012,0.11748316693754353,2021-11-19 01:37:30 UTC
790947,mainnet,249,107568000,107576815,8816,7790,1026,0.11637931034482758,2021-11-19 01:39:14 UTC
790948,mainnet,249,107568000,107576978,8979,7939,1040,0.1158258157924045,2021-11-19 01:40:48 UTC
790950,mainnet,249,107568000,107577166,9167,8116,1051,0.11465037634995091,2021-11-19 01:42:16 UTC
790951,mainnet,249,107568000,107577336,9337,8284,1053,0.1127771232729999,2021-11-19 01:43:49 UTC
790953,mainnet,249,107568000,107577497,9498,8436,1062,0.11181301326595072,2021-11-19 01:45:24 UTC
790955,mainnet,249,107568000,107577654,9655,8577,1078,0.11165199378560331,2021-11-19 01:46:50 UTC
790956,mainnet,249,107568000,107577742,9743,8660,1083,0.11115672790721544,2021-11-19 01:48:25 UTC
790958,mainnet,249,107568000,107578015,10016,8886,1130,0.11281948881789138,2021-11-19 01:50:02 UTC
790959,mainnet,249,107568000,107578168,10169,9029,1140,0.11210541842855738,2021-11-19 01:51:32 UTC
790961,mainnet,249,107568000,107578326,10327,9185,1142,0.11058390626513025,2021-11-19 01:52:59 UTC
790962,mainnet,249,107568000,107578491,10492,9335,1157,0.11027449485322151,2021-11-19 01:54:26 UTC
790964,mainnet,249,107568000,107578611,10612,9451,1161,0.10940444779494911,2021-11-19 01:56:02 UTC
790966,mainnet,249,107568000,107578820,10821,9625,1196,0.11052582940578505,2021-11-19 01:57:31 UTC
790967,mainnet,249,107568000,107578979,10980,9762,1218,0.11092896174863388,2021-11-19 01:59:00 UTC
790969,mainnet,249,107568000,107579158,11159,9932,1227,0.10995608925530961,2021-11-19 02:00:32 UTC
790970,mainnet,249,107568000,107579301,11302,10062,1240,0.10971509467350911,2021-11-19 02:01:58 UTC
790971,mainnet,249,107568000,107579490,11491,10236,1255,0.10921590810199286,2021-11-19 02:03:26 UTC
790972,mainnet,249,107568000,107579639,11640,10376,1264,0.10859106529209622,2021-11-19 02:04:54 UTC
790973,mainnet,249,107568000,107579814,11815,10542,1273,0.10774439272111723,2021-11-19 02:06:23 UTC
790975,mainnet,249,107568000,107579954,11955,10663,1292,0.10807193642827269,2021-11-19 02:07:49 UTC
790976,mainnet,249,107568000,107580117,12118,10803,1315,0.10851625680805413,2021-11-19 02:09:16 UTC
790978,mainnet,249,107568000,107580267,12268,10945,1323,0.10784153896315618,2021-11-19 02:10:47 UTC
790979,mainnet,249,107568000,107580526,12527,11183,1344,0.10728825736409356,2021-11-19 02:12:47 UTC
790981,mainnet,249,107568000,107580680,12681,11323,1358,0.10708934626606735,2021-11-19 02:14:13 UTC
790982,mainnet,249,107568000,107580831,12832,11473,1359,0.1059071072319202,2021-11-19 02:15:39 UTC
790984,mainnet,249,107568000,107581054,13055,11681,1374,0.10524703178858674,2021-11-19 02:17:35 UTC
790986,mainnet,249,107568000,107581228,13229,11836,1393,0.10529896439640185,2021-11-19 02:19:05 UTC
790987,mainnet,249,107568000,107581398,13399,12003,1396,0.10418687961788194,2021-11-19 02:20:48 UTC
790989,mainnet,249,107568000,107581575,13576,12170,1406,0.10356511490866234,2021-11-19 02:22:15 UTC
790991,mainnet,249,107568000,107581783,13784,12361,1423,0.10323563551944283,2021-11-19 02:24:03 UTC
790992,mainnet,249,107568000,107581954,13955,12525,1430,0.10247223217484773,2021-11-19 02:25:34 UTC
790994,mainnet,249,107568000,107582128,14129,12694,1435,0.10156415882228041,2021-11-19 02:27:03 UTC
790995,mainnet,249,107568000,107582288,14289,12838,1451,0.10154664427181748,2021-11-19 02:28:31 UTC
790997,mainnet,249,107568000,107582455,14456,12986,1470,0.10168788046485888,2021-11-19 02:30:10 UTC
790998,mainnet,249,107568000,107582630,14631,13150,1481,0.10122342970405304,2021-11-19 02:31:39 UTC
791000,mainnet,249,107568000,107582815,14816,13321,1495,0.10090442764578833,2021-11-19 02:33:06 UTC
791001,mainnet,249,107568000,107582989,14990,13489,1501,0.10013342228152101,2021-11-19 02:34:37 UTC
791003,mainnet,249,107568000,107583163,15164,13659,1505,0.09924821946715906,2021-11-19 02:36:02 UTC
791004,mainnet,249,107568000,107583352,15353,13844,1509,0.09828697974337262,2021-11-19 02:37:32 UTC
791006,mainnet,249,107568000,107583534,15535,14024,1511,0.09726424203411652,2021-11-19 02:39:03 UTC
791008,mainnet,249,107568000,107583701,15702,14170,1532,0.09756718889313463,2021-11-19 02:40:32 UTC
791009,mainnet,249,107568000,107583877,15878,14328,1550,0.09761934752487719,2021-11-19 02:42:01 UTC
791011,mainnet,249,107568000,107584056,16057,14501,1556,0.09690477673288908,2021-11-19 02:43:33 UTC
791012,mainnet,249,107568000,107584210,16211,14647,1564,0.0964777003269385,2021-11-19 02:45:02 UTC
791014,mainnet,249,107568000,107584354,16355,14787,1568,0.09587282176704372,2021-11-19 02:46:33 UTC
791015,mainnet,249,107568000,107584536,16537,14944,1593,0.09632944306706175,2021-11-19 02:48:04 UTC
791017,mainnet,249,107568000,107584691,16692,15093,1599,0.09579439252336448,2021-11-19 02:49:35 UTC
791018,mainnet,249,107568000,107584850,16851,15243,1608,0.0954246038810753,2021-11-19 02:51:03 UTC
791020,mainnet,249,107568000,107585000,17001,15389,1612,0.09481795188518323,2021-11-19 02:52:30 UTC
791021,mainnet,249,107568000,107585156,17157,15526,1631,0.09506323949408405,2021-11-19 02:54:00 UTC
791023,mainnet,249,107568000,107585307,17308,15672,1636,0.0945227640397504,2021-11-19 02:55:29 UTC
791024,mainnet,249,107568000,107585458,17459,15808,1651,0.09456440804169769,2021-11-19 02:56:55 UTC
791026,mainnet,249,107568000,107585608,17609,15942,1667,0.09466749957408144,2021-11-19 02:58:22 UTC
791027,mainnet,249,107568000,107585751,17752,16072,1680,0.0946372239747634,2021-11-19 02:59:48 UTC
791029,mainnet,249,107568000,107585921,17922,16230,1692,0.09440910612654838,2021-11-19 03:01:19 UTC
791030,mainnet,249,107568000,107586085,18086,16389,1697,0.09382948136680305,2021-11-19 03:02:50 UTC
791032,mainnet,249,107568000,107586248,18249,16534,1715,0.09397775220560031,2021-11-19 03:04:16 UTC
791034,mainnet,249,107568000,107586411,18412,16692,1720,0.0934173365196611,2021-11-19 03:05:46 UTC
791035,mainnet,249,107568000,107586568,18569,16839,1730,0.09316602940384512,2021-11-19 03:07:11 UTC
791036,mainnet,249,107568000,107586664,18665,16925,1740,0.09322260916153229,2021-11-19 03:08:37 UTC
791037,mainnet,249,107568000,107586904,18905,17137,1768,0.09352023274266068,2021-11-19 03:10:03 UTC
791039,mainnet,249,107568000,107587038,19039,17259,1780,0.09349230526813383,2021-11-19 03:11:32 UTC
791040,mainnet,249,107568000,107587194,19195,17397,1798,0.09367022662151601,2021-11-19 03:12:59 UTC
791042,mainnet,249,107568000,107587355,19356,17543,1813,0.09366604670386443,2021-11-19 03:14:29 UTC
791044,mainnet,249,107568000,107587516,19517,17695,1822,0.09335451145155506,2021-11-19 03:15:56 UTC
791045,mainnet,249,107568000,107587711,19712,17880,1832,0.0929383116883117,2021-11-19 03:17:37 UTC
791047,mainnet,249,107568000,107587912,19913,18060,1853,0.09305478832923215,2021-11-19 03:19:16 UTC
791048,mainnet,249,107568000,107588101,20102,18244,1858,0.09242861406825191,2021-11-19 03:20:53 UTC
791050,mainnet,249,107568000,107588292,20293,18431,1862,0.09175577785443256,2021-11-19 03:22:40 UTC
791052,mainnet,249,107568000,107588484,20485,18608,1877,0.09162802050280693,2021-11-19 03:24:10 UTC
791053,mainnet,249,107568000,107588656,20657,18779,1878,0.09091349179454906,2021-11-19 03:25:41 UTC
791055,mainnet,249,107568000,107588819,20820,18928,1892,0.09087415946205571,2021-11-19 03:27:13 UTC
791056,mainnet,249,107568000,107589008,21009,19093,1916,0.09119900994811747,2021-11-19 03:28:51 UTC
791058,mainnet,249,107568000,107589214,21215,19286,1929,0.09092623144001885,2021-11-19 03:30:38 UTC
791060,mainnet,249,107568000,107589402,21403,19463,1940,0.09064149885530066,2021-11-19 03:32:17 UTC
791061,mainnet,249,107568000,107589601,21602,19649,1953,0.09040829552819184,2021-11-19 03:33:59 UTC
791063,mainnet,249,107568000,107589799,21800,19833,1967,0.09022935779816514,2021-11-19 03:35:37 UTC
791064,mainnet,249,107568000,107589964,21965,19980,1985,0.09037104484407012,2021-11-19 03:37:05 UTC
791066,mainnet,249,107568000,107590160,22161,20162,1999,0.09020351067190109,2021-11-19 03:38:44 UTC
791068,mainnet,249,107568000,107590333,22334,20321,2013,0.09013163786155637,2021-11-19 03:40:21 UTC
791069,mainnet,249,107568000,107590535,22536,20506,2030,0.09007809726659567,2021-11-19 03:42:02 UTC
791071,mainnet,249,107568000,107590686,22687,20641,2046,0.09018380570370697,2021-11-19 03:43:30 UTC
791072,mainnet,249,107568000,107590859,22860,20808,2052,0.08976377952755905,2021-11-19 03:44:57 UTC
791074,mainnet,249,107568000,107591018,23019,20953,2066,0.08975194404622269,2021-11-19 03:46:29 UTC
791075,mainnet,249,107568000,107591192,23193,21118,2075,0.08946664942008364,2021-11-19 03:48:00 UTC
791077,mainnet,249,107568000,107591363,23364,21281,2083,0.0891542544084917,2021-11-19 03:49:34 UTC
791078,mainnet,249,107568000,107591560,23561,21448,2113,0.08968210177836256,2021-11-19 03:51:05 UTC
791080,mainnet,249,107568000,107591729,23730,21607,2123,0.08946481247366203,2021-11-19 03:52:37 UTC
791082,mainnet,249,107568000,107591894,23895,21764,2131,0.08918183720443608,2021-11-19 03:54:06 UTC
791083,mainnet,249,107568000,107592081,24082,21941,2141,0.08890457603189104,2021-11-19 03:55:36 UTC
791084,mainnet,249,107568000,107592234,24235,22086,2149,0.08867340623065814,2021-11-19 03:57:03 UTC
791085,mainnet,249,107568000,107592423,24424,22257,2167,0.08872420569931215,2021-11-19 03:58:35 UTC
791086,mainnet,249,107568000,107592592,24593,22414,2179,0.08860244785101451,2021-11-19 04:00:06 UTC
791088,mainnet,249,107568000,107592757,24758,22573,2185,0.08825430163987398,2021-11-19 04:01:38 UTC
791089,mainnet,249,107568000,107592920,24921,22722,2199,0.08823883471770795,2021-11-19 04:03:08 UTC
791091,mainnet,249,107568000,107593088,25089,22887,2202,0.08776754753079039,2021-11-19 04:04:47 UTC
791093,mainnet,249,107568000,107593286,25287,23082,2205,0.08719895598528889,2021-11-19 04:06:33 UTC
791094,mainnet,249,107568000,107593445,25446,23235,2211,0.08688988446121197,2021-11-19 04:08:02 UTC
791096,mainnet,249,107568000,107593592,25593,23368,2225,0.08693783456413863,2021-11-19 04:09:32 UTC
791097,mainnet,249,107568000,107593759,25760,23525,2235,0.08676242236024845,2021-11-19 04:11:03 UTC
791099,mainnet,249,107568000,107593917,25918,23677,2241,0.08646500501581912,2021-11-19 04:12:31 UTC
791100,mainnet,249,107568000,107594096,26097,23848,2249,0.08617848794880638,2021-11-19 04:14:05 UTC
791102,mainnet,249,107568000,107594266,26267,24002,2265,0.08622987017931244,2021-11-19 04:15:35 UTC
791103,mainnet,249,107568000,107594418,26419,24139,2280,0.0863015254173133,2021-11-19 04:17:05 UTC
791105,mainnet,249,107568000,107594579,26580,24289,2291,0.08619262603461249,2021-11-19 04:18:34 UTC
791107,mainnet,249,107568000,107594799,26800,24504,2296,0.08567164179104478,2021-11-19 04:20:26 UTC
791108,mainnet,249,107568000,107594977,26978,24674,2304,0.0854029208985099,2021-11-19 04:22:00 UTC
791110,mainnet,249,107568000,107595164,27165,24843,2322,0.08547763666482606,2021-11-19 04:23:41 UTC
791111,mainnet,249,107568000,107595391,27392,25062,2330,0.08506133177570094,2021-11-19 04:25:34 UTC
791113,mainnet,249,107568000,107595575,27576,25241,2335,0.08467507977951842,2021-11-19 04:27:25 UTC
791115,mainnet,249,107568000,107595776,27777,25440,2337,0.08413435576196134,2021-11-19 04:28:56 UTC
791116,mainnet,249,107568000,107595974,27975,25626,2349,0.08396782841823057,2021-11-19 04:30:29 UTC
791118,mainnet,249,107568000,107596151,28152,25795,2357,0.08372406933788008,2021-11-19 04:32:01 UTC
791119,mainnet,249,107568000,107596326,28327,25964,2363,0.08341864652098704,2021-11-19 04:33:37 UTC
791121,mainnet,249,107568000,107596522,28523,26143,2380,0.08344143322932371,2021-11-19 04:35:07 UTC
791122,mainnet,249,107568000,107596707,28708,26328,2380,0.08290372021736102,2021-11-19 04:36:39 UTC
791124,mainnet,249,107568000,107596883,28884,26495,2389,0.08271015094862208,2021-11-19 04:38:11 UTC
791125,mainnet,249,107568000,107597057,29058,26668,2390,0.08224929451441944,2021-11-19 04:39:44 UTC
791127,mainnet,249,107568000,107597230,29231,26835,2396,0.0819677739386268,2021-11-19 04:41:14 UTC
791128,mainnet,249,107568000,107597381,29382,26985,2397,0.08158055952624056,2021-11-19 04:42:44 UTC
791130,mainnet,249,107568000,107597562,29563,27148,2415,0.08168995027568245,2021-11-19 04:44:12 UTC
791132,mainnet,249,107568000,107597750,29751,27320,2431,0.08171153910792915,2021-11-19 04:45:43 UTC
791133,mainnet,249,107568000,107597926,29927,27490,2437,0.08143148327597154,2021-11-19 04:47:16 UTC
791135,mainnet,249,107568000,107598090,30091,27643,2448,0.08135322854009505,2021-11-19 04:48:47 UTC
791136,mainnet,249,107568000,107598270,30271,27814,2457,0.08116679330051865,2021-11-19 04:50:17 UTC
791137,mainnet,249,107568000,107598439,30440,27978,2462,0.08088042049934296,2021-11-19 04:51:46 UTC
791139,mainnet,249,107568000,107598620,30621,28148,2473,0.08076156885797328,2021-11-19 04:53:18 UTC
791140,mainnet,249,107568000,107598794,30795,28321,2474,0.08033771716187693,2021-11-19 04:54:48 UTC
791141,mainnet,249,107568000,107598951,30952,28460,2492,0.08051176014474025,2021-11-19 04:56:20 UTC
791142,mainnet,249,107568000,107599160,31161,28652,2509,0.08051731330830204,2021-11-19 04:57:50 UTC
791143,mainnet,249,107568000,107599338,31339,28815,2524,0.08053862599317145,2021-11-19 04:59:23 UTC
791145,mainnet,249,107568000,107599528,31529,28989,2540,0.08056075359193124,2021-11-19 05:00:54 UTC
791146,mainnet,249,107568000,107599699,31700,29158,2542,0.08018927444794953,2021-11-19 05:02:32 UTC
791148,mainnet,249,107568000,107599889,31890,29336,2554,0.08008780181875196,2021-11-19 05:04:03 UTC
791149,mainnet,249,107568000,107600079,32080,29526,2554,0.07961346633416459,2021-11-19 05:05:38 UTC
791151,mainnet,249,107568000,107600244,32245,29689,2556,0.07926810358195069,2021-11-19 05:07:11 UTC
791152,mainnet,249,107568000,107600431,32432,29871,2561,0.07896521953626048,2021-11-19 05:08:44 UTC
791154,mainnet,249,107568000,107600619,32620,30058,2562,0.07854077253218884,2021-11-19 05:10:18 UTC
791155,mainnet,249,107568000,107600811,32812,30238,2574,0.07844690966719493,2021-11-19 05:11:52 UTC
791157,mainnet,249,107568000,107600987,32988,30407,2581,0.07824057232933188,2021-11-19 05:13:23 UTC
791158,mainnet,249,107568000,107601178,33179,30582,2597,0.07827240121763766,2021-11-19 05:14:52 UTC
791160,mainnet,249,107568000,107601358,33359,30760,2599,0.07791000929284451,2021-11-19 05:16:23 UTC
791161,mainnet,249,107568000,107601540,33541,30937,2604,0.0776363256909454,2021-11-19 05:17:55 UTC
791163,mainnet,249,107568000,107601719,33720,31101,2619,0.07766903914590748,2021-11-19 05:19:39 UTC
791165,mainnet,249,107568000,107601926,33927,31305,2622,0.07728357944999557,2021-11-19 05:21:18 UTC
791166,mainnet,249,107568000,107602139,34140,31508,2632,0.07709431751611014,2021-11-19 05:23:10 UTC
791168,mainnet,249,107568000,107602397,34398,31740,2658,0.07727193441479156,2021-11-19 05:25:11 UTC
791169,mainnet,249,107568000,107602578,34579,31919,2660,0.07692530148355939,2021-11-19 05:26:45 UTC
791171,mainnet,249,107568000,107602766,34767,32103,2664,0.07662438519285529,2021-11-19 05:28:15 UTC
791173,mainnet,249,107568000,107602927,34928,32249,2679,0.07670064131928539,2021-11-19 05:30:05 UTC
791174,mainnet,249,107568000,107603173,35174,32478,2696,0.07664752373912549,2021-11-19 05:31:50 UTC
791176,mainnet,249,107568000,107603416,35417,32710,2707,0.07643222181438292,2021-11-19 05:34:01 UTC
791177,mainnet,249,107568000,107603614,35615,32895,2720,0.07637231503579953,2021-11-19 05:35:45 UTC
791179,mainnet,249,107568000,107603839,35840,33102,2738,0.07639508928571428,2021-11-19 05:37:39 UTC
791181,mainnet,249,107568000,107604013,36014,33265,2749,0.07633142666740712,2021-11-19 05:39:11 UTC
791182,mainnet,249,107568000,107604219,36220,33457,2763,0.0762838210933186,2021-11-19 05:41:02 UTC
791184,mainnet,249,107568000,107604405,36406,33637,2769,0.07605889139152887,2021-11-19 05:42:42 UTC
791185,mainnet,249,107568000,107604599,36600,33821,2779,0.07592896174863388,2021-11-19 05:44:16 UTC
791187,mainnet,249,107568000,107604787,36788,34007,2781,0.07559530281613569,2021-11-19 05:45:48 UTC
791188,mainnet,249,107568000,107604960,36961,34177,2784,0.0753226373745299,2021-11-19 05:47:19 UTC
791189,mainnet,249,107568000,107605144,37145,34358,2787,0.07503028671422803,2021-11-19 05:48:51 UTC
791191,mainnet,249,107568000,107605334,37335,34547,2788,0.07467523771260212,2021-11-19 05:50:24 UTC
791192,mainnet,249,107568000,107605539,37540,34739,2801,0.07461374533830581,2021-11-19 05:52:07 UTC
791193,mainnet,249,107568000,107605725,37726,34912,2814,0.07459046811217727,2021-11-19 05:53:43 UTC
791195,mainnet,249,107568000,107605910,37911,35088,2823,0.0744638759199177,2021-11-19 05:55:11 UTC
791196,mainnet,249,107568000,107606128,38129,35287,2842,0.07453644207820818,2021-11-19 05:56:56 UTC
791198,mainnet,249,107568000,107606333,38334,35486,2848,0.07429436009808525,2021-11-19 05:58:37 UTC
791200,mainnet,249,107568000,107606514,38515,35662,2853,0.07407503570037648,2021-11-19 06:00:08 UTC
791201,mainnet,249,107568000,107606784,38785,35924,2861,0.07376563104292896,2021-11-19 06:02:21 UTC
791203,mainnet,249,107568000,107606974,38975,36097,2878,0.07384220654265555,2021-11-19 06:03:52 UTC
791205,mainnet,249,107568000,107607242,39243,36363,2880,0.07338888464184695,2021-11-19 06:06:02 UTC
791206,mainnet,249,107568000,107607421,39422,36532,2890,0.07330931966922023,2021-11-19 06:07:30 UTC
791207,mainnet,249,107568000,107607608,39609,36718,2891,0.07298846221818274,2021-11-19 06:09:02 UTC
791209,mainnet,249,107568000,107607792,39793,36901,2892,0.07267609881134873,2021-11-19 06:10:33 UTC
791210,mainnet,249,107568000,107608012,40013,37110,2903,0.07255142078824382,2021-11-19 06:12:22 UTC
791212,mainnet,249,107568000,107608209,40210,37295,2915,0.07249440437702064,2021-11-19 06:13:52 UTC
791213,mainnet,249,107568000,107608390,40391,37471,2920,0.07229333267312026,2021-11-19 06:15:30 UTC
791214,mainnet,249,107568000,107608614,40615,37686,2929,0.07211621322171612,2021-11-19 06:17:12 UTC
791216,mainnet,249,107568000,107608796,40797,37856,2941,0.07208863396818393,2021-11-19 06:18:53 UTC
791217,mainnet,249,107568000,107609008,41009,38059,2950,0.07193542880831037,2021-11-19 06:20:23 UTC
791219,mainnet,249,107568000,107609192,41193,38228,2965,0.07197824873158061,2021-11-19 06:21:53 UTC
791220,mainnet,249,107568000,107609370,41371,38397,2974,0.07188610379251166,2021-11-19 06:23:23 UTC
791222,mainnet,249,107568000,107609544,41545,38557,2988,0.07192201227584546,2021-11-19 06:24:52 UTC
791223,mainnet,249,107568000,107609728,41729,38732,2997,0.07182055644755446,2021-11-19 06:26:24 UTC
791225,mainnet,249,107568000,107609907,41908,38906,3002,0.07163310107855302,2021-11-19 06:27:55 UTC
791226,mainnet,249,107568000,107610086,42087,39076,3011,0.07154228146458526,2021-11-19 06:29:25 UTC
791228,mainnet,249,107568000,107610282,42283,39262,3021,0.0714471537024336,2021-11-19 06:31:00 UTC
791229,mainnet,249,107568000,107610458,42459,39429,3030,0.0713629619162015,2021-11-19 06:32:29 UTC
791231,mainnet,249,107568000,107610642,42643,39611,3032,0.07110193935698708,2021-11-19 06:33:58 UTC
791232,mainnet,249,107568000,107610825,42826,39785,3041,0.07100826600663149,2021-11-19 06:35:28 UTC
791234,mainnet,249,107568000,107611009,43010,39964,3046,0.07082073936293885,2021-11-19 06:36:58 UTC
791235,mainnet,249,107568000,107611198,43199,40152,3047,0.07053404013981805,2021-11-19 06:38:31 UTC
791237,mainnet,249,107568000,107611396,43397,40342,3055,0.07039657119155703,2021-11-19 06:40:07 UTC
791239,mainnet,249,107568000,107611587,43588,40510,3078,0.07061576580710287,2021-11-19 06:41:41 UTC
791240,mainnet,249,107568000,107611759,43760,40674,3086,0.07052102376599634,2021-11-19 06:43:13 UTC
791241,mainnet,249,107568000,107611820,43821,40735,3086,0.07042285662125465,2021-11-19 06:44:43 UTC
791242,mainnet,249,107568000,107612100,44101,40985,3116,0.07065599419514297,2021-11-19 06:46:17 UTC
791244,mainnet,249,107568000,107612263,44264,41129,3135,0.07082504970178927,2021-11-19 06:47:53 UTC
791246,mainnet,249,107568000,107612434,44435,41285,3150,0.07089006413862946,2021-11-19 06:49:24 UTC
791247,mainnet,249,107568000,107612706,44707,41535,3172,0.07095085780750218,2021-11-19 06:51:39 UTC
791249,mainnet,249,107568000,107612969,44970,41786,3184,0.0708027573938181,2021-11-19 06:53:52 UTC
791250,mainnet,249,107568000,107613300,45301,42092,3209,0.07083728836008035,2021-11-19 06:56:25 UTC
791251,mainnet,249,107568000,107613590,45591,42377,3214,0.0704963698975675,2021-11-19 06:58:44 UTC
791253,mainnet,249,107568000,107613879,45880,42649,3231,0.07042284219703575,2021-11-19 07:01:12 UTC
791255,mainnet,249,107568000,107614196,46197,42947,3250,0.0703508885858389,2021-11-19 07:04:11 UTC
791256,mainnet,249,107568000,107614506,46507,43239,3268,0.07026899176468059,2021-11-19 07:06:23 UTC
791258,mainnet,249,107568000,107614807,46808,43515,3293,0.07035122201333105,2021-11-19 07:08:54 UTC
791259,mainnet,249,107568000,107615059,47060,43766,3294,0.06999575010624734,2021-11-19 07:11:07 UTC
791261,mainnet,249,107568000,107615316,47317,44014,3303,0.06980577805017224,2021-11-19 07:13:16 UTC
791262,mainnet,249,107568000,107615565,47566,44260,3306,0.06950342681747466,2021-11-19 07:15:27 UTC
791263,mainnet,249,107568000,107615836,47837,44514,3323,0.06946505842757698,2021-11-19 07:17:49 UTC
791264,mainnet,249,107568000,107616088,48089,44752,3337,0.06939216868722577,2021-11-19 07:20:01 UTC
791266,mainnet,249,107568000,107616353,48354,44998,3356,0.06940480622078836,2021-11-19 07:22:13 UTC
791267,mainnet,249,107568000,107616617,48618,45253,3365,0.06921304866510346,2021-11-19 07:24:32 UTC
791269,mainnet,249,107568000,107616881,48882,45503,3379,0.06912564952334192,2021-11-19 07:26:45 UTC
791270,mainnet,249,107568000,107617132,49133,45748,3385,0.06889463293509454,2021-11-19 07:28:58 UTC
791272,mainnet,249,107568000,107617432,49433,46025,3408,0.06894180001213764,2021-11-19 07:31:45 UTC
791274,mainnet,249,107568000,107617762,49763,46350,3413,0.06858509334244318,2021-11-19 07:34:37 UTC
791275,mainnet,249,107568000,107618101,50102,46671,3431,0.06848030018761726,2021-11-19 07:37:05 UTC
791277,mainnet,249,107568000,107618371,50372,46929,3443,0.06835146509965855,2021-11-19 07:39:26 UTC
791278,mainnet,249,107568000,107618655,50656,47205,3451,0.06812618445988629,2021-11-19 07:41:55 UTC
791280,mainnet,249,107568000,107618916,50917,47450,3467,0.06809120725887229,2021-11-19 07:44:17 UTC
791281,mainnet,249,107568000,107619201,51202,47714,3488,0.06812233897113394,2021-11-19 07:46:33 UTC
791283,mainnet,249,107568000,107619467,51468,47976,3492,0.06784798321287014,2021-11-19 07:48:48 UTC
791284,mainnet,249,107568000,107619715,51716,48217,3499,0.06765797818856834,2021-11-19 07:51:01 UTC
791286,mainnet,249,107568000,107619975,51976,48465,3511,0.06755040788056026,2021-11-19 07:53:16 UTC
791287,mainnet,249,107568000,107620250,52251,48737,3514,0.06725230139136093,2021-11-19 07:55:34 UTC
791289,mainnet,249,107568000,107620517,52518,48994,3524,0.06710080353402643,2021-11-19 07:57:50 UTC
791290,mainnet,249,107568000,107620778,52779,49238,3541,0.06709107789082779,2021-11-19 08:00:06 UTC
791292,mainnet,249,107568000,107621046,53047,49485,3562,0.06714800082945313,2021-11-19 08:02:28 UTC
791293,mainnet,249,107568000,107621309,53310,49731,3579,0.06713562183455261,2021-11-19 08:04:43 UTC
791295,mainnet,249,107568000,107621593,53594,49995,3599,0.06715303951934919,2021-11-19 08:07:20 UTC
791296,mainnet,249,107568000,107621860,53861,50250,3611,0.06704294387404616,2021-11-19 08:09:36 UTC
791298,mainnet,249,107568000,107622118,54119,50498,3621,0.066908109905948,2021-11-19 08:11:48 UTC
791299,mainnet,249,107568000,107622391,54392,50757,3635,0.06682968083541697,2021-11-19 08:14:14 UTC
791301,mainnet,249,107568000,107622650,54651,51007,3644,0.0666776454227736,2021-11-19 08:16:41 UTC
791302,mainnet,249,107568000,107622888,54889,51228,3661,0.06669824555011022,2021-11-19 08:18:55 UTC
791304,mainnet,249,107568000,107623154,55155,51482,3673,0.0665941437766295,2021-11-19 08:21:25 UTC
791305,mainnet,249,107568000,107623386,55387,51698,3689,0.0666040767689169,2021-11-19 08:23:39 UTC
791307,mainnet,249,107568000,107623695,55696,51982,3714,0.0666834243033611,2021-11-19 08:26:32 UTC
791309,mainnet,249,107568000,107623953,55954,52221,3733,0.06671551631697466,2021-11-19 08:28:50 UTC
791310,mainnet,249,107568000,107624221,56222,52472,3750,0.0666998683789264,2021-11-19 08:31:13 UTC
791312,mainnet,249,107568000,107624477,56478,52724,3754,0.06646835936116718,2021-11-19 08:33:26 UTC
791313,mainnet,249,107568000,107624751,56752,52977,3775,0.06651747956019172,2021-11-19 08:35:47 UTC
791314,mainnet,249,107568000,107625005,57006,53223,3783,0.06636143563835385,2021-11-19 08:38:01 UTC
791316,mainnet,249,107568000,107625259,57260,53465,3795,0.06627663290254977,2021-11-19 08:40:17 UTC
791317,mainnet,249,107568000,107625526,57527,53708,3819,0.06638621864515792,2021-11-19 08:42:32 UTC
791318,mainnet,249,107568000,107625774,57775,53930,3845,0.06655127650367806,2021-11-19 08:44:48 UTC
791320,mainnet,249,107568000,107626027,58028,54166,3862,0.06655407734197284,2021-11-19 08:47:05 UTC
791321,mainnet,249,107568000,107626302,58303,54426,3877,0.06649743580947808,2021-11-19 08:49:25 UTC
791323,mainnet,249,107568000,107626562,58563,54666,3897,0.0665437221453819,2021-11-19 08:51:38 UTC
791324,mainnet,249,107568000,107626844,58845,54942,3903,0.0663267907213867,2021-11-19 08:53:57 UTC
791326,mainnet,249,107568000,107627104,59105,55193,3912,0.06618729379917097,2021-11-19 08:56:13 UTC
791327,mainnet,249,107568000,107627372,59373,55447,3926,0.06612433260909842,2021-11-19 08:58:30 UTC
791328,mainnet,249,107568000,107627644,59645,55703,3942,0.06609103864531814,2021-11-19 09:00:49 UTC
791330,mainnet,249,107568000,107627902,59903,55937,3966,0.06620703470610821,2021-11-19 09:03:05 UTC
791331,mainnet,249,107568000,107628115,60116,56112,4004,0.06660456450861667,2021-11-19 09:05:21 UTC
791333,mainnet,249,107568000,107628324,60325,56299,4026,0.06673849979278906,2021-11-19 09:07:38 UTC
791334,mainnet,249,107568000,107628582,60583,56530,4053,0.06689995543304227,2021-11-19 09:10:01 UTC
791336,mainnet,249,107568000,107628860,60861,56790,4071,0.0668901266821117,2021-11-19 09:12:52 UTC
791338,mainnet,249,107568000,107629215,61216,57128,4088,0.06677992681651855,2021-11-19 09:15:18 UTC
791339,mainnet,249,107568000,107629468,61469,57366,4103,0.06674909303876751,2021-11-19 09:17:35 UTC
791341,mainnet,249,107568000,107629734,61735,57614,4121,0.06675305742285575,2021-11-19 09:19:52 UTC
791342,mainnet,249,107568000,107629993,61994,57857,4137,0.0667322644126851,2021-11-19 09:22:13 UTC
791344,mainnet,249,107568000,107630249,62250,58099,4151,0.06668273092369478,2021-11-19 09:24:33 UTC
791345,mainnet,249,107568000,107630517,62518,58353,4165,0.06662081320579673,2021-11-19 09:26:46 UTC
791347,mainnet,249,107568000,107630779,62780,58602,4178,0.06654985664224275,2021-11-19 09:29:01 UTC
791348,mainnet,249,107568000,107631068,63069,58874,4195,0.06651445242512169,2021-11-19 09:31:22 UTC
791350,mainnet,249,107568000,107631343,63344,59139,4205,0.0663835564536499,2021-11-19 09:33:41 UTC
791351,mainnet,249,107568000,107631612,63613,59394,4219,0.06632292141543396,2021-11-19 09:35:56 UTC
791353,mainnet,249,107568000,107631871,63872,59641,4231,0.06624185871743488,2021-11-19 09:38:06 UTC
791354,mainnet,249,107568000,107632145,64146,59906,4240,0.06609921117450815,2021-11-19 09:40:24 UTC
791356,mainnet,249,107568000,107632413,64414,60170,4244,0.06588629800974943,2021-11-19 09:42:45 UTC
791357,mainnet,249,107568000,107632688,64689,60425,4264,0.06591537973998671,2021-11-19 09:45:06 UTC
791359,mainnet,249,107568000,107632952,64953,60667,4286,0.06598617461857036,2021-11-19 09:47:24 UTC
791361,mainnet,249,107568000,107633230,65231,60939,4292,0.06579693703913783,2021-11-19 09:49:53 UTC
791362,mainnet,249,107568000,107633515,65516,61219,4297,0.06558703217534648,2021-11-19 09:52:10 UTC
791364,mainnet,249,107568000,107633784,65785,61467,4318,0.06563806338831041,2021-11-19 09:54:23 UTC
791365,mainnet,249,107568000,107634044,66045,61695,4350,0.06586418351124233,2021-11-19 09:56:37 UTC
791367,mainnet,249,107568000,107634327,66328,61946,4382,0.06606561331564346,2021-11-19 09:59:12 UTC
791368,mainnet,249,107568000,107634604,66605,62209,4396,0.06600105097214924,2021-11-19 10:01:42 UTC
791369,mainnet,249,107568000,107634852,66853,62444,4409,0.06595066788326627,2021-11-19 10:03:57 UTC
791371,mainnet,249,107568000,107635111,67112,62688,4424,0.06591965669328884,2021-11-19 10:06:12 UTC
791372,mainnet,249,107568000,107635378,67379,62945,4434,0.06580685376749432,2021-11-19 10:08:29 UTC
791374,mainnet,249,107568000,107635621,67622,63171,4451,0.06582177397888261,2021-11-19 10:10:43 UTC
791375,mainnet,249,107568000,107635855,67856,63388,4468,0.06584531950011789,2021-11-19 10:13:03 UTC
791377,mainnet,249,107568000,107636122,68123,63639,4484,0.0658221158786313,2021-11-19 10:15:19 UTC
791378,mainnet,249,107568000,107636350,68351,63848,4503,0.06588052844874252,2021-11-19 10:17:34 UTC
791380,mainnet,249,107568000,107636628,68629,64107,4522,0.06589051275699777,2021-11-19 10:19:46 UTC
791381,mainnet,249,107568000,107636900,68901,64369,4532,0.06577553301113191,2021-11-19 10:22:08 UTC
791382,mainnet,249,107568000,107637203,69204,64662,4542,0.06563204439049766,2021-11-19 10:24:45 UTC
791384,mainnet,249,107568000,107637460,69461,64913,4548,0.06547559061919639,2021-11-19 10:26:59 UTC
791385,mainnet,249,107568000,107637749,69750,65192,4558,0.06534767025089605,2021-11-19 10:29:33 UTC
791387,mainnet,249,107568000,107638015,70016,65445,4571,0.06528507769652651,2021-11-19 10:31:51 UTC
791388,mainnet,249,107568000,107638252,70253,65672,4581,0.06520717976456522,2021-11-19 10:34:10 UTC
791390,mainnet,249,107568000,107638546,70547,65940,4607,0.06530398174266801,2021-11-19 10:36:29 UTC
791392,mainnet,249,107568000,107638858,70859,66238,4621,0.06521401656811414,2021-11-19 10:39:09 UTC
791393,mainnet,249,107568000,107639119,71120,66485,4635,0.06517154105736783,2021-11-19 10:41:25 UTC
791395,mainnet,249,107568000,107639388,71389,66733,4656,0.06522013195310201,2021-11-19 10:43:39 UTC
791396,mainnet,249,107568000,107639647,71648,66991,4657,0.06499832514515409,2021-11-19 10:45:59 UTC
791398,mainnet,249,107568000,107639924,71925,67239,4686,0.0651511991657977,2021-11-19 10:48:11 UTC
791399,mainnet,249,107568000,107640162,72163,67475,4688,0.06496403974335878,2021-11-19 10:50:26 UTC
791401,mainnet,249,107568000,107640456,72457,67746,4711,0.06501787266930731,2021-11-19 10:52:45 UTC
791402,mainnet,249,107568000,107640745,72746,68025,4721,0.06489703901245429,2021-11-19 10:55:06 UTC
791404,mainnet,249,107568000,107641005,73006,68268,4738,0.06489877544311426,2021-11-19 10:57:22 UTC
791405,mainnet,249,107568000,107641290,73291,68541,4750,0.06481014039923047,2021-11-19 10:59:39 UTC
791407,mainnet,249,107568000,107641686,73687,68908,4779,0.06485540190264226,2021-11-19 11:03:08 UTC
791408,mainnet,249,107568000,107641948,73949,69148,4801,0.06492312269266656,2021-11-19 11:05:36 UTC
791410,mainnet,249,107568000,107642243,74244,69421,4823,0.06496147836862239,2021-11-19 11:07:47 UTC
791411,mainnet,249,107568000,107642517,74518,69686,4832,0.0648433935424998,2021-11-19 11:10:12 UTC
791413,mainnet,249,107568000,107642792,74793,69956,4837,0.06467182757744709,2021-11-19 11:12:29 UTC
791414,mainnet,249,107568000,107643020,75021,70177,4844,0.06456858746217725,2021-11-19 11:14:48 UTC
791416,mainnet,249,107568000,107643316,75317,70446,4871,0.064673314125629,2021-11-19 11:17:13 UTC
791417,mainnet,249,107568000,107643622,75623,70740,4883,0.06457030268569086,2021-11-19 11:19:41 UTC
791419,mainnet,249,107568000,107643892,75893,70991,4902,0.06459093724058872,2021-11-19 11:21:58 UTC
791420,mainnet,249,107568000,107644156,76157,71225,4932,0.06476095434431503,2021-11-19 11:24:13 UTC
791421,mainnet,249,107568000,107644406,76407,71453,4954,0.06483699137513578,2021-11-19 11:26:28 UTC
791423,mainnet,249,107568000,107644669,76670,71689,4981,0.06496674057649668,2021-11-19 11:28:42 UTC
791424,mainnet,249,107568000,107644959,76960,71968,4992,0.06486486486486487,2021-11-19 11:31:08 UTC
791426,mainnet,249,107568000,107645220,77221,72213,5008,0.06485282500874115,2021-11-19 11:33:23 UTC
791427,mainnet,249,107568000,107645488,77489,72460,5029,0.06489953412742454,2021-11-19 11:35:42 UTC
791429,mainnet,249,107568000,107645763,77764,72722,5042,0.06483719973252405,2021-11-19 11:37:57 UTC
791431,mainnet,249,107568000,107646032,78033,72986,5047,0.06467776453551702,2021-11-19 11:40:10 UTC
791432,mainnet,249,107568000,107646291,78292,73241,5051,0.06451489296479845,2021-11-19 11:42:26 UTC
791433,mainnet,249,107568000,107646578,78579,73511,5068,0.06449560315096908,2021-11-19 11:44:45 UTC
791435,mainnet,249,107568000,107646851,78852,73764,5088,0.06452594734439203,2021-11-19 11:47:06 UTC
791436,mainnet,249,107568000,107647116,79117,74010,5107,0.06454997029715484,2021-11-19 11:49:17 UTC
791438,mainnet,249,107568000,107647387,79388,74279,5109,0.0643548143296216,2021-11-19 11:51:34 UTC
791439,mainnet,249,107568000,107647672,79673,74547,5126,0.06433798149937871,2021-11-19 11:53:50 UTC
791441,mainnet,249,107568000,107647940,79941,74783,5158,0.06452258540673747,2021-11-19 11:55:59 UTC
791442,mainnet,249,107568000,107648191,80192,75018,5174,0.06452015163607343,2021-11-19 11:58:11 UTC
791444,mainnet,249,107568000,107648482,80483,75288,5195,0.0645477927015643,2021-11-19 12:00:32 UTC
791445,mainnet,249,107568000,107648734,80735,75529,5206,0.064482566421007,2021-11-19 12:02:49 UTC
791447,mainnet,249,107568000,107649003,81004,75771,5233,0.0646017480618241,2021-11-19 12:05:07 UTC
791448,mainnet,249,107568000,107649262,81263,76018,5245,0.06454351919077563,2021-11-19 12:07:20 UTC
791450,mainnet,249,107568000,107649509,81510,76255,5255,0.06447061710219605,2021-11-19 12:09:26 UTC
791451,mainnet,249,107568000,107649748,81749,76488,5261,0.06435552728473742,2021-11-19 12:11:39 UTC
791453,mainnet,249,107568000,107650009,82010,76724,5286,0.06445555420070723,2021-11-19 12:13:53 UTC
791454,mainnet,249,107568000,107650277,82278,76974,5304,0.06446437686866477,2021-11-19 12:16:11 UTC
791456,mainnet,249,107568000,107650538,82539,77216,5323,0.06449072559638475,2021-11-19 12:18:31 UTC
791457,mainnet,249,107568000,107650807,82808,77465,5343,0.0645227514249831,2021-11-19 12:20:47 UTC
791459,mainnet,249,107568000,107651088,83089,77735,5354,0.06443692907605097,2021-11-19 12:23:10 UTC
791460,mainnet,249,107568000,107651318,83319,77952,5367,0.0644150793936557,2021-11-19 12:25:18 UTC
791461,mainnet,249,107568000,107651614,83615,78216,5399,0.06456975423070023,2021-11-19 12:27:53 UTC
791463,mainnet,249,107568000,107651865,83866,78450,5416,0.06457920969165097,2021-11-19 12:30:09 UTC
791464,mainnet,249,107568000,107652122,84123,78695,5428,0.06452456521997552,2021-11-19 12:32:26 UTC
791466,mainnet,249,107568000,107652399,84400,78966,5434,0.06438388625592417,2021-11-19 12:34:43 UTC
791467,mainnet,249,107568000,107652662,84663,79211,5452,0.06439648961175484,2021-11-19 12:37:00 UTC
791469,mainnet,249,107568000,107652949,84950,79484,5466,0.06434373160682755,2021-11-19 12:39:37 UTC
791471,mainnet,249,107568000,107653157,85158,79677,5481,0.06436271401395054,2021-11-19 12:41:39 UTC
791472,mainnet,249,107568000,107653400,85401,79892,5509,0.06450744136485521,2021-11-19 12:43:42 UTC
791474,mainnet,249,107568000,107653651,85652,80121,5531,0.06457525802082847,2021-11-19 12:45:49 UTC
791475,mainnet,249,107568000,107653880,85881,80324,5557,0.06470581385871148,2021-11-19 12:47:47 UTC
791476,mainnet,249,107568000,107654080,86081,80517,5564,0.06463679557625956,2021-11-19 12:49:44 UTC
791478,mainnet,249,107568000,107654317,86318,80733,5585,0.0647026112745893,2021-11-19 12:51:45 UTC
791479,mainnet,249,107568000,107654570,86571,80961,5610,0.0648023010014901,2021-11-19 12:54:03 UTC
791481,mainnet,249,107568000,107654787,86788,81174,5614,0.06468636216988524,2021-11-19 12:55:59 UTC
791482,mainnet,249,107568000,107655055,87056,81434,5622,0.06457912148502114,2021-11-19 12:58:11 UTC
791484,mainnet,249,107568000,107655279,87280,81656,5624,0.06443629697525206,2021-11-19 13:00:11 UTC
791486,mainnet,249,107568000,107655564,87565,81924,5641,0.0644207160395135,2021-11-19 13:02:42 UTC
791487,mainnet,249,107568000,107655821,87822,82148,5674,0.06460795700393979,2021-11-19 13:05:00 UTC
791489,mainnet,249,107568000,107656038,88039,82346,5693,0.06466452367700679,2021-11-19 13:07:06 UTC
791490,mainnet,249,107568000,107656283,88284,82564,5720,0.0647909020887137,2021-11-19 13:09:12 UTC
791491,mainnet,249,107568000,107656557,88558,82813,5745,0.06487273877007159,2021-11-19 13:11:26 UTC
791493,mainnet,249,107568000,107656827,88828,83068,5760,0.06484441842662224,2021-11-19 13:13:48 UTC
791495,mainnet,249,107568000,107657107,89108,83331,5777,0.06483144049916954,2021-11-19 13:16:12 UTC
791496,mainnet,249,107568000,107657354,89355,83563,5792,0.06482009960270829,2021-11-19 13:18:36 UTC
791498,mainnet,249,107568000,107657600,89601,83796,5805,0.06478722335688218,2021-11-19 13:20:45 UTC
791499,mainnet,249,107568000,107657856,89857,84043,5814,0.06470280556884828,2021-11-19 13:23:02 UTC
791501,mainnet,249,107568000,107658084,90085,84241,5844,0.06487206527168785,2021-11-19 13:25:04 UTC
791502,mainnet,249,107568000,107658285,90286,84414,5872,0.06503776886782003,2021-11-19 13:27:11 UTC
791504,mainnet,249,107568000,107658492,90493,84586,5907,0.0652757671864122,2021-11-19 13:29:23 UTC
791505,mainnet,249,107568000,107658710,90711,84762,5949,0.06558190296656415,2021-11-19 13:31:44 UTC
791507,mainnet,249,107568000,107659010,91011,85027,5984,0.0657502939205151,2021-11-19 13:34:06 UTC
791508,mainnet,249,107568000,107659222,91223,85228,5995,0.0657180754853491,2021-11-19 13:36:05 UTC
791510,mainnet,249,107568000,107659438,91439,85418,6021,0.06584717680639553,2021-11-19 13:38:17 UTC
791511,mainnet,249,107568000,107659661,91662,85607,6055,0.06605790840260958,2021-11-19 13:40:22 UTC
791513,mainnet,249,107568000,107659908,91909,85841,6068,0.06602182593652417,2021-11-19 13:42:39 UTC
791514,mainnet,249,107568000,107660124,92125,86031,6094,0.06614925373134328,2021-11-19 13:44:41 UTC
791516,mainnet,249,107568000,107660344,92345,86235,6110,0.06616492500947534,2021-11-19 13:46:41 UTC
791517,mainnet,249,107568000,107660554,92555,86420,6135,0.0662849116741397,2021-11-19 13:48:43 UTC
791519,mainnet,249,107568000,107660724,92725,86579,6146,0.06628201671609599,2021-11-19 13:50:52 UTC
791521,mainnet,249,107568000,107661013,93014,86812,6202,0.0666781344743802,2021-11-19 13:53:39 UTC
791522,mainnet,249,107568000,107661259,93260,87022,6238,0.06688826935449281,2021-11-19 13:55:47 UTC
791524,mainnet,249,107568000,107661474,93475,87221,6254,0.0669055897298743,2021-11-19 13:57:51 UTC
791525,mainnet,249,107568000,107661677,93678,87417,6261,0.06683532953308141,2021-11-19 14:00:05 UTC
791527,mainnet,249,107568000,107661894,93895,87603,6292,0.06701102295116886,2021-11-19 14:02:22 UTC
791528,mainnet,249,107568000,107662094,94095,87766,6329,0.06726180987300069,2021-11-19 14:04:41 UTC
791530,mainnet,249,107568000,107662216,94217,87863,6354,0.06744005858815288,2021-11-19 14:06:43 UTC
791531,mainnet,249,107568000,107662446,94447,88014,6433,0.06811227460903999,2021-11-19 14:08:46 UTC
791533,mainnet,249,107568000,107662650,94651,88151,6500,0.06867333678460873,2021-11-19 14:10:56 UTC
791534,mainnet,249,107568000,107662830,94831,88299,6532,0.06888042939545086,2021-11-19 14:13:11 UTC
791536,mainnet,249,107568000,107662984,94985,88413,6572,0.06918987208506606,2021-11-19 14:15:13 UTC
791537,mainnet,249,107568000,107663158,95159,88526,6633,0.069704389495476,2021-11-19 14:17:15 UTC
791539,mainnet,249,107568000,107663300,95301,88632,6669,0.06997827934649165,2021-11-19 14:19:18 UTC
791540,mainnet,249,107568000,107663524,95525,88794,6731,0.07046322952106779,2021-11-19 14:21:33 UTC
791542,mainnet,249,107568000,107663699,95700,88936,6764,0.07067920585161964,2021-11-19 14:23:42 UTC
791544,mainnet,249,107568000,107663881,95882,89081,6801,0.07093093594209549,2021-11-19 14:25:59 UTC
791545,mainnet,249,107568000,107664073,96074,89248,6826,0.07104939942127943,2021-11-19 14:28:04 UTC
791547,mainnet,249,107568000,107664273,96274,89427,6847,0.07111992853729979,2021-11-19 14:30:09 UTC
791548,mainnet,249,107568000,107664523,96524,89661,6863,0.07110148771290042,2021-11-19 14:32:25 UTC
791550,mainnet,249,107568000,107664775,96776,89898,6878,0.0710713400016533,2021-11-19 14:34:43 UTC
791551,mainnet,249,107568000,107665008,97009,90122,6887,0.07099341298230061,2021-11-19 14:37:02 UTC
791553,mainnet,249,107568000,107665251,97252,90350,6902,0.07097026282235841,2021-11-19 14:39:02 UTC
791554,mainnet,249,107568000,107665498,97499,90571,6928,0.07105713904757997,2021-11-19 14:41:19 UTC
791556,mainnet,249,107568000,107665755,97756,90817,6939,0.07098285527231066,2021-11-19 14:43:33 UTC
791557,mainnet,249,107568000,107665983,97984,91030,6954,0.07097077073807968,2021-11-19 14:45:39 UTC
791559,mainnet,249,107568000,107666210,98211,91246,6965,0.0709187361904471,2021-11-19 14:47:50 UTC
791560,mainnet,249,107568000,107666426,98427,91443,6984,0.07095614008351367,2021-11-19 14:49:52 UTC
791562,mainnet,249,107568000,107666647,98648,91635,7013,0.07109115238018003,2021-11-19 14:52:02 UTC
791564,mainnet,249,107568000,107666862,98863,91818,7045,0.07126022880147274,2021-11-19 14:54:15 UTC
791565,mainnet,249,107568000,107667094,99095,92042,7053,0.07117412583884151,2021-11-19 14:56:33 UTC
791567,mainnet,249,107568000,107667311,99312,92227,7085,0.07134082487514097,2021-11-19 14:58:38 UTC
791568,mainnet,249,107568000,107667532,99533,92436,7097,0.07130298493966825,2021-11-19 15:00:51 UTC
791570,mainnet,249,107568000,107667790,99791,92678,7113,0.07127897305368219,2021-11-19 15:03:16 UTC
791571,mainnet,249,107568000,107667992,99993,92863,7130,0.07130499134939446,2021-11-19 15:05:19 UTC
791572,mainnet,249,107568000,107668211,100212,93061,7151,0.071358719514629,2021-11-19 15:07:23 UTC
791574,mainnet,249,107568000,107668428,100429,93256,7173,0.071423592786944,2021-11-19 15:09:21 UTC
791575,mainnet,249,107568000,107668690,100691,93505,7186,0.07136685503173074,2021-11-19 15:11:55 UTC
791577,mainnet,249,107568000,107668914,100915,93714,7201,0.07135708269335579,2021-11-19 15:14:00 UTC
791578,mainnet,249,107568000,107669144,101145,93917,7228,0.07146176281575956,2021-11-19 15:16:05 UTC
791580,mainnet,249,107568000,107669363,101364,94120,7244,0.07146521447456691,2021-11-19 15:18:10 UTC
791581,mainnet,249,107568000,107669582,101583,94321,7262,0.07148833958437928,2021-11-19 15:20:16 UTC
791583,mainnet,249,107568000,107669803,101804,94523,7281,0.07151978311264784,2021-11-19 15:22:22 UTC
791584,mainnet,249,107568000,107670029,102030,94730,7300,0.07154758404390865,2021-11-19 15:24:21 UTC
791586,mainnet,249,107568000,107670251,102252,94939,7313,0.07151938348394163,2021-11-19 15:26:27 UTC
791587,mainnet,249,107568000,107670480,102481,95147,7334,0.07156448512407178,2021-11-19 15:28:27 UTC
791589,mainnet,249,107568000,107670709,102710,95365,7345,0.0715120241456528,2021-11-19 15:30:30 UTC
791590,mainnet,249,107568000,107670933,102934,95569,7365,0.07155070239182389,2021-11-19 15:32:32 UTC
791592,mainnet,249,107568000,107671147,103148,95766,7382,0.07156706867801606,2021-11-19 15:34:38 UTC
791593,mainnet,249,107568000,107671380,103381,95978,7403,0.0716089029899111,2021-11-19 15:36:42 UTC
791595,mainnet,249,107568000,107671608,103609,96191,7418,0.07159609686417204,2021-11-19 15:38:43 UTC
791596,mainnet,249,107568000,107671897,103898,96461,7437,0.0715798186683093,2021-11-19 15:41:19 UTC
791598,mainnet,249,107568000,107672105,104106,96663,7443,0.07149443836090139,2021-11-19 15:43:34 UTC
791599,mainnet,249,107568000,107672364,104365,96900,7465,0.07152781104776505,2021-11-19 15:45:41 UTC
791601,mainnet,249,107568000,107672626,104627,97136,7491,0.07159719766408289,2021-11-19 15:48:02 UTC
791603,mainnet,249,107568000,107672872,104873,97362,7511,0.0716199593794399,2021-11-19 15:50:28 UTC
791604,mainnet,249,107568000,107673099,105100,97574,7526,0.07160799238820172,2021-11-19 15:52:42 UTC
791606,mainnet,249,107568000,107673314,105315,97776,7539,0.07158524426719841,2021-11-19 15:54:44 UTC
791607,mainnet,249,107568000,107673628,105629,98061,7568,0.07164699088318549,2021-11-19 15:57:20 UTC
791609,mainnet,249,107568000,107673888,105889,98304,7585,0.07163161423755064,2021-11-19 15:59:34 UTC
791610,mainnet,249,107568000,107674116,106117,98515,7602,0.07163790910033266,2021-11-19 16:01:48 UTC
791612,mainnet,249,107568000,107674362,106363,98739,7624,0.07167906132771734,2021-11-19 16:04:05 UTC
791613,mainnet,249,107568000,107674600,106601,98958,7643,0.07169726362792093,2021-11-19 16:06:18 UTC
791615,mainnet,249,107568000,107674878,106879,99222,7657,0.07164176311529862,2021-11-19 16:08:53 UTC
791616,mainnet,249,107568000,107675162,107163,99489,7674,0.07161053721900283,2021-11-19 16:11:22 UTC
791618,mainnet,249,107568000,107675403,107404,99716,7688,0.07158020185467953,2021-11-19 16:13:29 UTC
791620,mainnet,249,107568000,107675628,107629,99924,7705,0.07158851238978342,2021-11-19 16:15:42 UTC
791621,mainnet,249,107568000,107675915,107916,100174,7742,0.07174098372808481,2021-11-19 16:18:11 UTC
791623,mainnet,249,107568000,107676157,108158,100393,7765,0.0717931174762847,2021-11-19 16:20:15 UTC
791624,mainnet,249,107568000,107676424,108425,100635,7790,0.07184689877795711,2021-11-19 16:22:37 UTC
791626,mainnet,249,107568000,107676664,108665,100866,7799,0.07177103943312015,2021-11-19 16:24:54 UTC
791627,mainnet,249,107568000,107676897,108898,101084,7814,0.07175522048155154,2021-11-19 16:27:02 UTC
791629,mainnet,249,107568000,107677134,109135,101299,7836,0.07180098043707335,2021-11-19 16:29:06 UTC
791630,mainnet,249,107568000,107677355,109356,101492,7864,0.07191192069936721,2021-11-19 16:31:12 UTC
791632,mainnet,249,107568000,107677594,109595,101720,7875,0.07185546785893517,2021-11-19 16:33:27 UTC
791633,mainnet,249,107568000,107677828,109829,101943,7886,0.07180252938659189,2021-11-19 16:35:30 UTC
791635,mainnet,249,107568000,107678064,110065,102171,7894,0.0717212556216781,2021-11-19 16:37:33 UTC
791636,mainnet,249,107568000,107678299,110300,102394,7906,0.07167724388032638,2021-11-19 16:39:45 UTC
791638,mainnet,249,107568000,107678536,110537,102616,7921,0.07165926341406045,2021-11-19 16:41:49 UTC
791639,mainnet,249,107568000,107678800,110801,102866,7935,0.07161487712204763,2021-11-19 16:44:06 UTC
791641,mainnet,249,107568000,107679047,111048,103106,7942,0.07151862257762409,2021-11-19 16:46:20 UTC
791642,mainnet,249,107568000,107679273,111274,103306,7968,0.07160702410266549,2021-11-19 16:48:23 UTC
791644,mainnet,249,107568000,107679520,111521,103548,7973,0.07149326135884722,2021-11-19 16:50:39 UTC
791645,mainnet,249,107568000,107679768,111769,103783,7986,0.0714509389902388,2021-11-19 16:52:46 UTC
791647,mainnet,249,107568000,107679998,111999,103997,8002,0.0714470664916651,2021-11-19 16:54:52 UTC
791648,mainnet,249,107568000,107680229,112230,104209,8021,0.0714693041076361,2021-11-19 16:57:05 UTC
791650,mainnet,249,107568000,107680455,112456,104422,8034,0.07144127480970335,2021-11-19 16:59:08 UTC
791651,mainnet,249,107568000,107680672,112673,104623,8050,0.07144568796428603,2021-11-19 17:01:18 UTC
791653,mainnet,249,107568000,107680881,112882,104809,8073,0.07151715951170248,2021-11-19 17:03:33 UTC
791654,mainnet,249,107568000,107681096,113097,104991,8106,0.07167298867343962,2021-11-19 17:05:42 UTC
791656,mainnet,249,107568000,107681326,113327,105194,8133,0.07176577514625818,2021-11-19 17:07:59 UTC
791657,mainnet,249,107568000,107681540,113541,105380,8161,0.07187711927849852,2021-11-19 17:10:23 UTC
791659,mainnet,249,107568000,107681746,113747,105560,8187,0.071975524629221,2021-11-19 17:12:51 UTC
791660,mainnet,249,107568000,107682016,114017,105808,8209,0.07199803538068884,2021-11-19 17:15:09 UTC
791662,mainnet,249,107568000,107682267,114268,106035,8233,0.07204991773724928,2021-11-19 17:17:30 UTC
791664,mainnet,249,107568000,107682491,114492,106253,8239,0.07196135974565908,2021-11-19 17:19:46 UTC
791665,mainnet,249,107568000,107682724,114725,106455,8270,0.07208542166049248,2021-11-19 17:21:48 UTC
791667,mainnet,249,107568000,107682944,114945,106654,8291,0.07213014920179216,2021-11-19 17:23:58 UTC
791668,mainnet,249,107568000,107683190,115191,106878,8313,0.07216709638773862,2021-11-19 17:26:15 UTC
791670,mainnet,249,107568000,107683483,115484,107153,8331,0.07213986353087874,2021-11-19 17:28:54 UTC
791671,mainnet,249,107568000,107683716,115717,107361,8356,0.07221065184890725,2021-11-19 17:31:09 UTC
791673,mainnet,249,107568000,107683945,115946,107585,8361,0.07211115519293464,2021-11-19 17:33:18 UTC
791674,mainnet,249,107568000,107684189,116190,107822,8368,0.07201996729494793,2021-11-19 17:35:28 UTC
791676,mainnet,249,107568000,107684429,116430,108055,8375,0.07193163274070256,2021-11-19 17:37:36 UTC
791677,mainnet,249,107568000,107684659,116660,108272,8388,0.07190125150008572,2021-11-19 17:39:41 UTC
791678,mainnet,249,107568000,107684889,116890,108485,8405,0.07190521002652066,2021-11-19 17:41:47 UTC
791680,mainnet,249,107568000,107685111,117112,108675,8437,0.07204214768768359,2021-11-19 17:43:51 UTC
791681,mainnet,249,107568000,107685366,117367,108913,8454,0.07203046853033647,2021-11-19 17:46:03 UTC
791683,mainnet,249,107568000,107685586,117587,109106,8481,0.07212531997584767,2021-11-19 17:48:08 UTC
791684,mainnet,249,107568000,107685815,117816,109321,8495,0.07210395871528485,2021-11-19 17:50:22 UTC
791686,mainnet,249,107568000,107686059,118060,109543,8517,0.07214128409283416,2021-11-19 17:52:49 UTC
791687,mainnet,249,107568000,107686301,118302,109769,8533,0.07212895809031124,2021-11-19 17:54:54 UTC
791689,mainnet,249,107568000,107686550,118551,110010,8541,0.07204494268289596,2021-11-19 17:57:17 UTC
791690,mainnet,249,107568000,107686807,118808,110256,8552,0.07198168473503468,2021-11-19 17:59:25 UTC
791692,mainnet,249,107568000,107687036,119037,110472,8565,0.07195241815569949,2021-11-19 18:01:41 UTC
791693,mainnet,249,107568000,107687277,119278,110697,8581,0.0719411794295679,2021-11-19 18:03:46 UTC
791695,mainnet,249,107568000,107687491,119492,110898,8594,0.07192113279550096,2021-11-19 18:05:47 UTC
791696,mainnet,249,107568000,107687708,119709,111108,8601,0.071849234393404,2021-11-19 18:07:54 UTC
791697,mainnet,249,107568000,107687956,119957,111343,8614,0.07180906491492785,2021-11-19 18:10:12 UTC
791699,mainnet,249,107568000,107688186,120187,111571,8616,0.07168828575469893,2021-11-19 18:12:16 UTC
791700,mainnet,249,107568000,107688468,120469,111842,8627,0.07161178394441724,2021-11-19 18:14:43 UTC
791702,mainnet,249,107568000,107688718,120719,112083,8636,0.07153803460929928,2021-11-19 18:16:55 UTC
791703,mainnet,249,107568000,107688977,120978,112327,8651,0.0715088693812098,2021-11-19 18:19:02 UTC
791705,mainnet,249,107568000,107689234,121235,112574,8661,0.07143976574421577,2021-11-19 18:21:15 UTC
791706,mainnet,249,107568000,107689480,121481,112809,8672,0.0713856487845836,2021-11-19 18:23:23 UTC
791708,mainnet,249,107568000,107689678,121679,112998,8681,0.07134345285546397,2021-11-19 18:25:25 UTC
791709,mainnet,249,107568000,107689915,121916,113210,8706,0.07140982315692772,2021-11-19 18:27:32 UTC
791711,mainnet,249,107568000,107690138,122139,113421,8718,0.07137769262889003,2021-11-19 18:29:38 UTC
791712,mainnet,249,107568000,107690361,122362,113638,8724,0.0712966443830601,2021-11-19 18:31:44 UTC
791714,mainnet,249,107568000,107690593,122594,113863,8731,0.07121881984436433,2021-11-19 18:33:50 UTC
791715,mainnet,249,107568000,107690827,122828,114075,8753,0.0712622529065034,2021-11-19 18:35:54 UTC
791717,mainnet,249,107568000,107691069,123070,114304,8766,0.07122775656130657,2021-11-19 18:38:03 UTC
791718,mainnet,249,107568000,107691314,123315,114520,8795,0.07132141264241981,2021-11-19 18:40:10 UTC
791720,mainnet,249,107568000,107691554,123555,114725,8830,0.07146614867872607,2021-11-19 18:42:25 UTC
791721,mainnet,249,107568000,107691788,123789,114946,8843,0.07143607267204678,2021-11-19 18:44:34 UTC
791723,mainnet,249,107568000,107691996,123997,115132,8865,0.07149366516931861,2021-11-19 18:46:41 UTC
791724,mainnet,249,107568000,107692206,124207,115329,8878,0.07147745296158832,2021-11-19 18:48:44 UTC
791725,mainnet,249,107568000,107692431,124432,115546,8886,0.07141249839269641,2021-11-19 18:50:51 UTC
791726,mainnet,249,107568000,107692660,124661,115760,8901,0.07140164125107291,2021-11-19 18:52:57 UTC
791728,mainnet,249,107568000,107692887,124888,115981,8907,0.07131990263275895,2021-11-19 18:54:58 UTC
791729,mainnet,249,107568000,107693156,125157,116213,8944,0.07146224342226164,2021-11-19 18:57:15 UTC
791731,mainnet,249,107568000,107693400,125401,116436,8965,0.07149065796923469,2021-11-19 18:59:23 UTC
791732,mainnet,249,107568000,107693644,125645,116670,8975,0.07143141390425405,2021-11-19 19:01:44 UTC
791734,mainnet,249,107568000,107693916,125917,116934,8983,0.07134064502807405,2021-11-19 19:03:54 UTC
791735,mainnet,249,107568000,107694167,126168,117150,9018,0.07147612706867035,2021-11-19 19:06:11 UTC
791737,mainnet,249,107568000,107694440,126441,117420,9021,0.07134552874463189,2021-11-19 19:08:31 UTC
791738,mainnet,249,107568000,107694693,126694,117661,9033,0.07129777258591567,2021-11-19 19:10:39 UTC
791739,mainnet,249,107568000,107694948,126949,117894,9055,0.07132785606818486,2021-11-19 19:12:57 UTC
791741,mainnet,249,107568000,107695183,127184,118121,9063,0.07125896339162159,2021-11-19 19:15:00 UTC
791742,mainnet,249,107568000,107695436,127437,118357,9080,0.07125089259791112,2021-11-19 19:17:07 UTC
791744,mainnet,249,107568000,107695736,127737,118644,9093,0.07118532609972052,2021-11-19 19:19:39 UTC
791745,mainnet,249,107568000,107695983,127984,118885,9099,0.07109482435304414,2021-11-19 19:21:49 UTC
791747,mainnet,249,107568000,107696249,128250,119145,9105,0.07099415204678362,2021-11-19 19:24:17 UTC
791748,mainnet,249,107568000,107696575,128576,119445,9131,0.07101636386261821,2021-11-19 19:26:57 UTC
791750,mainnet,249,107568000,107696850,128851,119697,9154,0.071043298072968,2021-11-19 19:29:26 UTC
791751,mainnet,249,107568000,107697084,129085,119921,9164,0.07099198202734633,2021-11-19 19:31:30 UTC
791753,mainnet,249,107568000,107697322,129323,120157,9166,0.07087679685748088,2021-11-19 19:33:38 UTC
791754,mainnet,249,107568000,107697543,129544,120370,9174,0.07081763725066387,2021-11-19 19:35:45 UTC
791755,mainnet,249,107568000,107697798,129799,120610,9189,0.07079407391428286,2021-11-19 19:37:57 UTC
791757,mainnet,249,107568000,107698062,130063,120866,9197,0.07071188577843045,2021-11-19 19:40:05 UTC
791758,mainnet,249,107568000,107698316,130317,121105,9212,0.0706891656499152,2021-11-19 19:42:18 UTC
791759,mainnet,249,107568000,107698553,130554,121335,9219,0.07061445838503608,2021-11-19 19:44:25 UTC
791761,mainnet,249,107568000,107698797,130798,121575,9223,0.07051331060107953,2021-11-19 19:46:34 UTC
791762,mainnet,249,107568000,107699051,131052,121809,9243,0.0705292555626774,2021-11-19 19:48:46 UTC
791764,mainnet,249,107568000,107699311,131312,122050,9262,0.07053429998781528,2021-11-19 19:51:01 UTC
791765,mainnet,249,107568000,107699546,131547,122272,9275,0.0705071191285244,2021-11-19 19:53:12 UTC
791767,mainnet,249,107568000,107699794,131795,122511,9284,0.07044273303236086,2021-11-19 19:55:16 UTC
791768,mainnet,249,107568000,107700032,132033,122743,9290,0.07036119757939303,2021-11-19 19:57:23 UTC
791769,mainnet,249,107568000,107700273,132274,122971,9303,0.07033128203577423,2021-11-19 19:59:32 UTC
791771,mainnet,249,107568000,107700540,132541,123234,9307,0.07021978104888299,2021-11-19 20:01:50 UTC
791772,mainnet,249,107568000,107700773,132774,123453,9321,0.07020199737900493,2021-11-19 20:04:03 UTC
791773,mainnet,249,107568000,107701030,133031,123700,9331,0.070141545955454,2021-11-19 20:06:11 UTC
791775,mainnet,249,107568000,107701285,133286,123946,9340,0.07007487658118632,2021-11-19 20:08:24 UTC
791776,mainnet,249,107568000,107701518,133519,124173,9346,0.06999752844164502,2021-11-19 20:10:36 UTC
791777,mainnet,249,107568000,107701776,133777,124421,9356,0.06993728368852643,2021-11-19 20:12:43 UTC
791779,mainnet,249,107568000,107702023,134024,124646,9378,0.06997254223124216,2021-11-19 20:14:51 UTC
791780,mainnet,249,107568000,107702271,134272,124889,9383,0.0698805409914204,2021-11-19 20:17:05 UTC
791781,mainnet,249,107568000,107702524,134525,125127,9398,0.06986062070247166,2021-11-19 20:19:20 UTC
791782,mainnet,249,107568000,107702770,134771,125363,9408,0.06980730275801174,2021-11-19 20:21:42 UTC
791784,mainnet,249,107568000,107703044,135045,125624,9421,0.06976193120811582,2021-11-19 20:23:53 UTC
791785,mainnet,249,107568000,107703288,135289,125856,9433,0.06972481132981986,2021-11-19 20:26:08 UTC
791787,mainnet,249,107568000,107703593,135594,126144,9450,0.06969334926324174,2021-11-19 20:28:50 UTC
791789,mainnet,249,107568000,107703948,135949,126482,9467,0.06963640777056102,2021-11-19 20:32:02 UTC
791790,mainnet,249,107568000,107704249,136250,126773,9477,0.0695559633027523,2021-11-19 20:34:44 UTC
791791,mainnet,249,107568000,107704528,136529,127039,9490,0.06950904203502553,2021-11-19 20:37:03 UTC
791793,mainnet,249,107568000,107704820,136821,127316,9505,0.0694703298470264,2021-11-19 20:39:40 UTC
791794,mainnet,249,107568000,107705125,137126,127601,9525,0.0694616629960766,2021-11-19 20:42:16 UTC
791796,mainnet,249,107568000,107705415,137416,127881,9535,0.06938784421028119,2021-11-19 20:44:42 UTC
791797,mainnet,249,107568000,107705720,137721,128160,9561,0.06942296381815409,2021-11-19 20:47:19 UTC
791798,mainnet,249,107568000,107706006,138007,128416,9591,0.06949647481649482,2021-11-19 20:49:55 UTC
791800,mainnet,249,107568000,107706343,138344,128736,9608,0.06945006650089632,2021-11-19 20:52:59 UTC
791801,mainnet,249,107568000,107706593,138594,128973,9621,0.06941858954933114,2021-11-19 20:55:04 UTC
791803,mainnet,249,107568000,107706845,138846,129219,9627,0.06933581089840543,2021-11-19 20:57:08 UTC
791804,mainnet,249,107568000,107707132,139133,129496,9637,0.06926466043282327,2021-11-19 20:59:34 UTC
791806,mainnet,249,107568000,107707391,139392,129742,9650,0.06922922405876951,2021-11-19 21:01:58 UTC
791807,mainnet,249,107568000,107707618,139619,129952,9667,0.06923842743466146,2021-11-19 21:04:10 UTC
791809,mainnet,249,107568000,107707852,139853,130180,9673,0.06916548089779984,2021-11-19 21:06:25 UTC
791810,mainnet,249,107568000,107708093,140094,130399,9695,0.0692035347695119,2021-11-19 21:08:42 UTC
791812,mainnet,249,107568000,107708294,140295,130592,9703,0.06916140988631099,2021-11-19 21:10:59 UTC
791813,mainnet,249,107568000,107708563,140564,130836,9728,0.06920690930821548,2021-11-19 21:13:16 UTC
791815,mainnet,249,107568000,107708793,140794,131056,9738,0.06916487918519255,2021-11-19 21:15:27 UTC
791816,mainnet,249,107568000,107709040,141041,131289,9752,0.06914301515162258,2021-11-19 21:17:39 UTC
791818,mainnet,249,107568000,107709289,141290,131518,9772,0.06916271498336754,2021-11-19 21:19:46 UTC
791819,mainnet,249,107568000,107709524,141525,131744,9781,0.06911146440558205,2021-11-19 21:21:54 UTC
791821,mainnet,249,107568000,107709772,141773,131977,9796,0.06909637236991528,2021-11-19 21:24:05 UTC
791822,mainnet,249,107568000,107710036,142037,132232,9805,0.06903130874349642,2021-11-19 21:26:14 UTC
791824,mainnet,249,107568000,107710261,142262,132455,9807,0.06893618815987404,2021-11-19 21:28:17 UTC
791825,mainnet,249,107568000,107710487,142488,132665,9823,0.06893913873448992,2021-11-19 21:30:26 UTC
791826,mainnet,249,107568000,107710693,142694,132860,9834,0.06891670287468289,2021-11-19 21:32:27 UTC
791827,mainnet,249,107568000,107710966,142967,133115,9852,0.06891100743528226,2021-11-19 21:34:35 UTC
791829,mainnet,249,107568000,107711224,143225,133367,9858,0.06882876592773608,2021-11-19 21:36:48 UTC
791830,mainnet,249,107568000,107711488,143489,133630,9859,0.06870909965223815,2021-11-19 21:39:03 UTC
791832,mainnet,249,107568000,107711758,143759,133882,9877,0.06870526367044846,2021-11-19 21:41:15 UTC
791833,mainnet,249,107568000,107712013,144014,134136,9878,0.06859055369616843,2021-11-19 21:43:23 UTC
791835,mainnet,249,107568000,107712274,144275,134391,9884,0.06850805752902443,2021-11-19 21:45:38 UTC
791836,mainnet,249,107568000,107712522,144523,134624,9899,0.06849428810639137,2021-11-19 21:47:43 UTC
791838,mainnet,249,107568000,107712793,144794,134880,9914,0.06846968797049602,2021-11-19 21:50:30 UTC
791839,mainnet,249,107568000,107713102,145103,135171,9932,0.06844793009103878,2021-11-19 21:52:41 UTC
791841,mainnet,249,107568000,107713382,145383,135428,9955,0.06847430579916497,2021-11-19 21:54:55 UTC
791842,mainnet,249,107568000,107713624,145625,135640,9985,0.06856652360515021,2021-11-19 21:57:00 UTC
791844,mainnet,249,107568000,107713892,145893,135896,9997,0.06852282151988101,2021-11-19 21:59:21 UTC
791845,mainnet,249,107568000,107714148,146149,136137,10012,0.06850542939055347,2021-11-19 22:01:27 UTC
791847,mainnet,249,107568000,107714464,146465,136442,10023,0.06843273136926911,2021-11-19 22:04:21 UTC
791849,mainnet,249,107568000,107714719,146720,136684,10036,0.06840239912758997,2021-11-19 22:06:22 UTC
791850,mainnet,249,107568000,107714974,146975,136926,10049,0.06837217213811873,2021-11-19 22:08:30 UTC
791852,mainnet,249,107568000,107715247,147248,137173,10075,0.06842198196240357,2021-11-19 22:10:39 UTC
791853,mainnet,249,107568000,107715499,147500,137418,10082,0.06835254237288135,2021-11-19 22:12:43 UTC
791854,mainnet,249,107568000,107715754,147755,137646,10109,0.06841731244289534,2021-11-19 22:14:58 UTC
791856,mainnet,249,107568000,107716025,148026,137915,10111,0.06830556794076716,2021-11-19 22:17:06 UTC
791857,mainnet,249,107568000,107716273,148274,138158,10116,0.06822504282611921,2021-11-19 22:19:16 UTC
791859,mainnet,249,107568000,107716527,148528,138411,10117,0.06811510287622535,2021-11-19 22:21:32 UTC
791860,mainnet,249,107568000,107716795,148796,138669,10127,0.06805962525874351,2021-11-19 22:23:48 UTC
791861,mainnet,249,107568000,107717076,149077,138936,10141,0.0680252486969821,2021-11-19 22:26:00 UTC
791863,mainnet,249,107568000,107717318,149319,139162,10157,0.06802215391209424,2021-11-19 22:28:09 UTC
791864,mainnet,249,107568000,107717573,149574,139407,10167,0.06797304344337919,2021-11-19 22:30:17 UTC
791866,mainnet,249,107568000,107717830,149831,139646,10185,0.06797658695463556,2021-11-19 22:32:22 UTC
791867,mainnet,249,107568000,107718086,150087,139893,10194,0.06792060604849187,2021-11-19 22:34:28 UTC
791869,mainnet,249,107568000,107718349,150350,140156,10194,0.06780179580977719,2021-11-19 22:36:39 UTC
791870,mainnet,249,107568000,107718582,150583,140384,10199,0.06773008905387726,2021-11-19 22:38:38 UTC
791872,mainnet,249,107568000,107718844,150845,140632,10213,0.06770526036660147,2021-11-19 22:40:53 UTC
791873,mainnet,249,107568000,107719083,151084,140858,10226,0.06768420216568266,2021-11-19 22:42:54 UTC
791875,mainnet,249,107568000,107719322,151323,141082,10241,0.06767642724503214,2021-11-19 22:44:57 UTC
791876,mainnet,249,107568000,107719570,151571,141319,10252,0.06763826853421828,2021-11-19 22:47:00 UTC
791878,mainnet,249,107568000,107719804,151805,141547,10258,0.06757353183360232,2021-11-19 22:49:04 UTC
791879,mainnet,249,107568000,107719980,151981,141713,10268,0.06756107671353656,2021-11-19 22:51:15 UTC
791881,mainnet,249,107568000,107720315,152316,142023,10293,0.06757661703301032,2021-11-19 22:53:19 UTC
791882,mainnet,249,107568000,107720618,152619,142324,10295,0.06745555926850523,2021-11-19 22:55:47 UTC
791884,mainnet,249,107568000,107720857,152858,142561,10297,0.06736317366444675,2021-11-19 22:57:49 UTC
791885,mainnet,249,107568000,107721102,153103,142788,10315,0.06737294501087503,2021-11-19 22:59:50 UTC
791887,mainnet,249,107568000,107721369,153370,143047,10323,0.06730781769576841,2021-11-19 23:02:03 UTC
791888,mainnet,249,107568000,107721612,153613,143277,10336,0.0672859718903999,2021-11-19 23:04:10 UTC
791889,mainnet,249,107568000,107721880,153881,143539,10342,0.0672077774384102,2021-11-19 23:06:28 UTC
791891,mainnet,249,107568000,107722138,154139,143796,10343,0.06710177177742167,2021-11-19 23:08:33 UTC
791892,mainnet,249,107568000,107722402,154403,144038,10365,0.06712952468540119,2021-11-19 23:10:45 UTC
791894,mainnet,249,107568000,107722710,154711,144319,10392,0.067170401587476,2021-11-19 23:13:15 UTC
791896,mainnet,249,107568000,107722986,154987,144563,10424,0.06725725383419255,2021-11-19 23:15:32 UTC
791897,mainnet,249,107568000,107723275,155276,144825,10451,0.06730595842242201,2021-11-19 23:17:54 UTC
791899,mainnet,249,107568000,107723527,155528,145065,10463,0.06727405997633866,2021-11-19 23:20:02 UTC
791900,mainnet,249,107568000,107723780,155781,145307,10474,0.06723541381811646,2021-11-19 23:22:10 UTC
791902,mainnet,249,107568000,107724046,156047,145562,10485,0.06719129493037354,2021-11-19 23:24:25 UTC
791903,mainnet,249,107568000,107724290,156291,145797,10494,0.06714398141927558,2021-11-19 23:26:30 UTC
791904,mainnet,249,107568000,107724507,156508,145999,10509,0.06714672732384287,2021-11-19 23:28:35 UTC
791906,mainnet,249,107568000,107724746,156747,146221,10526,0.06715280037257491,2021-11-19 23:30:53 UTC
791907,mainnet,249,107568000,107724992,156993,146441,10552,0.06721318784913977,2021-11-19 23:33:08 UTC
791909,mainnet,249,107568000,107725318,157319,146747,10572,0.06720103738264291,2021-11-19 23:36:09 UTC
791911,mainnet,249,107568000,107725606,157607,147022,10585,0.06716072255673923,2021-11-19 23:38:21 UTC
791912,mainnet,249,107568000,107725857,157858,147255,10603,0.06716796107894436,2021-11-19 23:40:33 UTC
791914,mainnet,249,107568000,107726101,158102,147487,10615,0.06714020062997306,2021-11-19 23:42:33 UTC
791915,mainnet,249,107568000,107726362,158363,147727,10636,0.06716215277558521,2021-11-19 23:44:42 UTC
791917,mainnet,249,107568000,107726624,158625,147977,10648,0.06712687155240346,2021-11-19 23:47:02 UTC
791918,mainnet,249,107568000,107726913,158914,148261,10653,0.06703625860528337,2021-11-19 23:49:18 UTC
791920,mainnet,249,107568000,107727167,159168,148506,10662,0.06698582629674306,2021-11-19 23:51:24 UTC
791921,mainnet,249,107568000,107727433,159434,148751,10683,0.06700578295721113,2021-11-19 23:53:29 UTC
791923,mainnet,249,107568000,107727666,159667,148977,10690,0.06695184352433502,2021-11-19 23:55:32 UTC
791924,mainnet,249,107568000,107727929,159930,149229,10701,0.06691052335396735,2021-11-19 23:57:41 UTC
791925,mainnet,249,107568000,107728164,160165,149458,10707,0.06684981113226984,2021-11-19 23:59:51 UTC
791927,mainnet,249,107568000,107728434,160435,149715,10720,0.06681833764452894,2021-11-20 00:02:02 UTC
791928,mainnet,249,107568000,107728672,160673,149942,10731,0.0667878237164925,2021-11-20 00:04:12 UTC
791929,mainnet,249,107568000,107728899,160900,150152,10748,0.06679925419515227,2021-11-20 00:06:12 UTC
791931,mainnet,249,107568000,107729117,161118,150366,10752,0.06673369828324582,2021-11-20 00:08:13 UTC
791932,mainnet,249,107568000,107729380,161381,150607,10774,0.06676126681579615,2021-11-20 00:10:19 UTC
791934,mainnet,249,107568000,107729635,161636,150845,10791,0.06676111757281794,2021-11-20 00:12:43 UTC
791935,mainnet,249,107568000,107729890,161891,151092,10799,0.06670537583929928,2021-11-20 00:14:59 UTC
791937,mainnet,249,107568000,107730149,162150,151332,10818,0.06671600370027753,2021-11-20 00:17:17 UTC
791938,mainnet,249,107568000,107730399,162400,151572,10828,0.06667487684729063,2021-11-20 00:19:26 UTC
791940,mainnet,249,107568000,107730675,162676,151822,10854,0.06672158154859967,2021-11-20 00:21:44 UTC
791941,mainnet,249,107568000,107730914,162915,152043,10872,0.06673418653899273,2021-11-20 00:23:50 UTC
791943,mainnet,249,107568000,107731217,163218,152330,10888,0.06670832873825192,2021-11-20 00:26:27 UTC
791944,mainnet,249,107568000,107731463,163464,152548,10916,0.06677922967748251,2021-11-20 00:28:38 UTC
791946,mainnet,249,107568000,107731749,163750,152825,10925,0.0667175572519084,2021-11-20 00:30:56 UTC
791947,mainnet,249,107568000,107731991,163992,153058,10934,0.06667398409678521,2021-11-20 00:33:03 UTC
791949,mainnet,249,107568000,107732324,164325,153384,10941,0.0665814696485623,2021-11-20 00:35:51 UTC
791950,mainnet,249,107568000,107732574,164575,153633,10942,0.06648640437490506,2021-11-20 00:38:00 UTC
791952,mainnet,249,107568000,107732812,164813,153863,10950,0.06643893382196793,2021-11-20 00:40:08 UTC
791953,mainnet,249,107568000,107733068,165069,154109,10960,0.06639647662492655,2021-11-20 00:42:19 UTC
791955,mainnet,249,107568000,107733320,165321,154344,10977,0.066398098245232,2021-11-20 00:44:23 UTC
791956,mainnet,249,107568000,107733548,165549,154567,10982,0.06633685494928994,2021-11-20 00:46:36 UTC
791958,mainnet,249,107568000,107733818,165819,154819,11000,0.06633739197558784,2021-11-20 00:48:47 UTC
791959,mainnet,249,107568000,107734064,166065,155064,11001,0.0662451449733538,2021-11-20 00:50:51 UTC
791960,mainnet,249,107568000,107734305,166306,155303,11003,0.06616117277789135,2021-11-20 00:52:53 UTC
791962,mainnet,249,107568000,107734580,166581,155557,11024,0.06617801549996698,2021-11-20 00:54:59 UTC
791963,mainnet,249,107568000,107734844,166845,155815,11030,0.06610926308849531,2021-11-20 00:57:11 UTC
791964,mainnet,249,107568000,107735082,167083,156053,11030,0.06601509429445246,2021-11-20 00:59:13 UTC
791966,mainnet,249,107568000,107735348,167349,156309,11040,0.06596991915099583,2021-11-20 01:01:26 UTC
791967,mainnet,249,107568000,107735638,167639,156593,11046,0.0658915884728494,2021-11-20 01:03:52 UTC
791969,mainnet,249,107568000,107735920,167921,156861,11060,0.065864305238773,2021-11-20 01:06:07 UTC
791970,mainnet,249,107568000,107736201,168202,157142,11060,0.06575427164956421,2021-11-20 01:08:24 UTC
791972,mainnet,249,107568000,107736481,168482,157413,11069,0.06569841288683657,2021-11-20 01:10:42 UTC
791973,mainnet,249,107568000,107736732,168733,157643,11090,0.06572513971777898,2021-11-20 01:12:55 UTC
791975,mainnet,249,107568000,107737001,169002,157900,11102,0.0656915302777482,2021-11-20 01:15:07 UTC
791976,mainnet,249,107568000,107737278,169279,158167,11112,0.06564310989549796,2021-11-20 01:17:24 UTC
791977,mainnet,249,107568000,107737540,169541,158415,11126,0.06562424428309377,2021-11-20 01:19:37 UTC
791979,mainnet,249,107568000,107737781,169782,158651,11131,0.06556054234253336,2021-11-20 01:21:51 UTC
791980,mainnet,249,107568000,107738042,170043,158900,11143,0.06553048346594685,2021-11-20 01:24:07 UTC
791981,mainnet,249,107568000,107738303,170304,159157,11147,0.06545354190154078,2021-11-20 01:26:15 UTC
791983,mainnet,249,107568000,107738561,170562,159399,11163,0.06544834136560312,2021-11-20 01:28:25 UTC
791984,mainnet,249,107568000,107738833,170834,159663,11171,0.06539096432794408,2021-11-20 01:30:40 UTC
791986,mainnet,249,107568000,107739087,171088,159902,11186,0.06538155802861685,2021-11-20 01:32:43 UTC
791987,mainnet,249,107568000,107739359,171360,160161,11199,0.06535364145658264,2021-11-20 01:34:58 UTC
791989,mainnet,249,107568000,107739690,171691,160483,11208,0.06528006709728523,2021-11-20 01:37:41 UTC
791991,mainnet,249,107568000,107739987,171988,160760,11228,0.06528362443891435,2021-11-20 01:40:04 UTC
791992,mainnet,249,107568000,107740240,172241,160999,11242,0.06526901260443216,2021-11-20 01:42:11 UTC
791994,mainnet,249,107568000,107740507,172508,161257,11251,0.06522016370255293,2021-11-20 01:44:26 UTC
791995,mainnet,249,107568000,107740792,172793,161527,11266,0.06519940043867518,2021-11-20 01:46:53 UTC
791997,mainnet,249,107568000,107741048,173049,161777,11272,0.06513761998046796,2021-11-20 01:49:05 UTC
791998,mainnet,249,107568000,107741301,173302,162019,11283,0.06510599993075672,2021-11-20 01:51:08 UTC
792000,mainnet,249,107568000,107741543,173544,162256,11288,0.06504402341769235,2021-11-20 01:53:15 UTC
792001,mainnet,249,107568000,107741840,173841,162543,11298,0.0649904222824305,2021-11-20 01:55:40 UTC
792003,mainnet,249,107568000,107742120,174121,162822,11299,0.06489165580257407,2021-11-20 01:58:02 UTC
792004,mainnet,249,107568000,107742400,174401,163092,11309,0.06484481166965786,2021-11-20 02:00:20 UTC
792006,mainnet,249,107568000,107742704,174705,163383,11322,0.06480638791105006,2021-11-20 02:02:55 UTC
792008,mainnet,249,107568000,107743118,175119,163755,11364,0.06489301560653042,2021-11-20 02:06:18 UTC
792009,mainnet,249,107568000,107743314,175315,163951,11364,0.0648204660183099,2021-11-20 02:08:58 UTC
792011,mainnet,249,107568000,107743832,175833,164453,11380,0.06472050183981391,2021-11-20 02:12:07 UTC
792012,mainnet,249,107568000,107744127,176128,164747,11381,0.06461777797965117,2021-11-20 02:14:32 UTC
792014,mainnet,249,107568000,107744502,176503,165116,11387,0.06451448417307355,2021-11-20 02:17:44 UTC
792016,mainnet,249,107568000,107744619,176620,165229,11391,0.0644943947457819,2021-11-20 02:20:27 UTC
792017,mainnet,249,107568000,107745032,177033,165610,11423,0.06452469313630792,2021-11-20 02:22:44 UTC
792019,mainnet,249,107568000,107745368,177369,165929,11440,0.0644983057918802,2021-11-20 02:24:59 UTC
792020,mainnet,249,107568000,107745656,177657,166210,11447,0.06443314927078583,2021-11-20 02:27:18 UTC
792022,mainnet,249,107568000,107745917,177918,166452,11466,0.06444541867601929,2021-11-20 02:29:30 UTC
792023,mainnet,249,107568000,107746220,178221,166745,11476,0.06439196278777473,2021-11-20 02:31:59 UTC
792025,mainnet,249,107568000,107746481,178482,166992,11490,0.06437623962080209,2021-11-20 02:34:07 UTC
792026,mainnet,249,107568000,107746759,178760,167249,11511,0.06439360035802193,2021-11-20 02:36:25 UTC
792028,mainnet,249,107568000,107747062,179063,167539,11524,0.06435723739689383,2021-11-20 02:38:52 UTC
792030,mainnet,249,107568000,107747345,179346,167811,11535,0.064317018500552,2021-11-20 02:41:18 UTC
792031,mainnet,249,107568000,107747618,179619,168070,11549,0.06429720686564339,2021-11-20 02:43:36 UTC
792033,mainnet,249,107568000,107747885,179886,168325,11561,0.06426848114917226,2021-11-20 02:45:46 UTC
792034,mainnet,249,107568000,107748138,180139,168563,11576,0.06426148696284535,2021-11-20 02:48:01 UTC
792036,mainnet,249,107568000,107748420,180421,168827,11594,0.0642608122114388,2021-11-20 02:50:15 UTC
792037,mainnet,249,107568000,107748694,180695,169092,11603,0.06421317690030161,2021-11-20 02:52:33 UTC
792039,mainnet,249,107568000,107748979,180980,169364,11616,0.06418388772240026,2021-11-20 02:55:10 UTC
792040,mainnet,249,107568000,107749274,181275,169653,11622,0.06411253620190319,2021-11-20 02:57:38 UTC
792042,mainnet,249,107568000,107749638,181639,170000,11639,0.06407764852261905,2021-11-20 03:00:10 UTC
792043,mainnet,249,107568000,107749918,181919,170258,11661,0.06409995657407967,2021-11-20 03:02:51 UTC
792045,mainnet,249,107568000,107750228,182229,170551,11678,0.06408420174615456,2021-11-20 03:05:02 UTC
792046,mainnet,249,107568000,107750492,182493,170794,11699,0.06410656847111944,2021-11-20 03:07:16 UTC
792048,mainnet,249,107568000,107750768,182769,171061,11708,0.06405900344150266,2021-11-20 03:09:28 UTC
792049,mainnet,249,107568000,107751033,183034,171302,11732,0.06409738081449348,2021-11-20 03:11:43 UTC
792051,mainnet,249,107568000,107751309,183310,171568,11742,0.06405542523593911,2021-11-20 03:14:03 UTC
792052,mainnet,249,107568000,107751592,183593,171837,11756,0.06403294243244569,2021-11-20 03:16:19 UTC
792054,mainnet,249,107568000,107751862,183863,172097,11766,0.06399329935876169,2021-11-20 03:18:33 UTC
792055,mainnet,249,107568000,107752118,184119,172346,11773,0.06394234163774515,2021-11-20 03:20:46 UTC
792056,mainnet,249,107568000,107752398,184399,172620,11779,0.06387778675589346,2021-11-20 03:22:59 UTC
792058,mainnet,249,107568000,107752689,184690,172898,11792,0.0638475282906492,2021-11-20 03:25:37 UTC
792059,mainnet,249,107568000,107752954,184955,173144,11811,0.0638587764591387,2021-11-20 03:27:57 UTC
792061,mainnet,249,107568000,107753270,185271,173449,11822,0.06380923080244615,2021-11-20 03:30:30 UTC
792062,mainnet,249,107568000,107753549,185550,173717,11833,0.06377256804095931,2021-11-20 03:32:43 UTC
792064,mainnet,249,107568000,107753840,185841,173992,11849,0.06375880456949758,2021-11-20 03:35:02 UTC
792066,mainnet,249,107568000,107754120,186121,174271,11850,0.0636682588208746,2021-11-20 03:37:24 UTC
792067,mainnet,249,107568000,107754423,186424,174565,11859,0.06361305411320431,2021-11-20 03:39:47 UTC
792069,mainnet,249,107568000,107754702,186703,174832,11871,0.06358226702302587,2021-11-20 03:42:04 UTC
792070,mainnet,249,107568000,107754971,186972,175091,11881,0.06354427400894251,2021-11-20 03:44:25 UTC
792072,mainnet,249,107568000,107755162,187163,175267,11896,0.06355957106906814,2021-11-20 03:47:06 UTC
792073,mainnet,249,107568000,107755586,187587,175670,11917,0.06352785640796003,2021-11-20 03:49:25 UTC
792075,mainnet,249,107568000,107755862,187863,175923,11940,0.06355695373756408,2021-11-20 03:51:37 UTC
792076,mainnet,249,107568000,107756095,188096,176148,11948,0.06352075535896563,2021-11-20 03:53:39 UTC
792078,mainnet,249,107568000,107756451,188452,176487,11965,0.06349096852248849,2021-11-20 03:56:25 UTC
792079,mainnet,249,107568000,107756705,188706,176739,11967,0.06341610759594289,2021-11-20 03:58:30 UTC
792081,mainnet,249,107568000,107756960,188961,176989,11972,0.06335698900831388,2021-11-20 04:00:33 UTC
792082,mainnet,249,107568000,107757228,189229,177247,11982,0.06332010421235645,2021-11-20 04:02:49 UTC
792084,mainnet,249,107568000,107757482,189483,177500,11983,0.06324050178643995,2021-11-20 04:04:56 UTC
792085,mainnet,249,107568000,107757735,189736,177731,12005,0.06327212547961378,2021-11-20 04:07:00 UTC
792087,mainnet,249,107568000,107758009,190010,177995,12015,0.0632335140255776,2021-11-20 04:09:16 UTC
792088,mainnet,249,107568000,107758280,190281,178266,12015,0.06314345625679915,2021-11-20 04:11:33 UTC
792090,mainnet,249,107568000,107758551,190552,178525,12027,0.0631166295814266,2021-11-20 04:13:37 UTC
792091,mainnet,249,107568000,107758797,190798,178771,12027,0.06303525194184426,2021-11-20 04:15:45 UTC
792093,mainnet,249,107568000,107759068,191069,179038,12031,0.06296678163386002,2021-11-20 04:17:56 UTC
792094,mainnet,249,107568000,107759326,191327,179296,12031,0.06288187239647305,2021-11-20 04:20:02 UTC
792096,mainnet,249,107568000,107759586,191587,179552,12035,0.06281741454274037,2021-11-20 04:22:18 UTC
792097,mainnet,249,107568000,107759894,191895,179852,12043,0.06275827926730765,2021-11-20 04:24:30 UTC
792099,mainnet,249,107568000,107760160,192161,180114,12047,0.06269222162665682,2021-11-20 04:26:35 UTC
792100,mainnet,249,107568000,107760444,192445,180392,12053,0.06263088155057289,2021-11-20 04:28:50 UTC
792102,mainnet,249,107568000,107760707,192708,180643,12065,0.06260767586192581,2021-11-20 04:31:03 UTC
792103,mainnet,249,107568000,107760972,192973,180901,12072,0.06255797443165624,2021-11-20 04:33:23 UTC
792105,mainnet,249,107568000,107761239,193240,181158,12082,0.06252328710411922,2021-11-20 04:35:25 UTC
792106,mainnet,249,107568000,107761504,193505,181418,12087,0.062463502235084366,2021-11-20 04:37:34 UTC
792108,mainnet,249,107568000,107761753,193754,181658,12096,0.06242967887114589,2021-11-20 04:39:37 UTC
792109,mainnet,249,107568000,107762010,194011,181910,12101,0.06237275206045018,2021-11-20 04:41:39 UTC
792110,mainnet,249,107568000,107762260,194261,182160,12101,0.062292482793767145,2021-11-20 04:43:46 UTC
792111,mainnet,249,107568000,107762518,194519,182414,12105,0.06223042479140855,2021-11-20 04:45:53 UTC
792113,mainnet,249,107568000,107762778,194779,182665,12114,0.0621935629610995,2021-11-20 04:47:59 UTC
792114,mainnet,249,107568000,107763062,195063,182940,12123,0.06214915181249135,2021-11-20 04:50:07 UTC
792116,mainnet,249,107568000,107763324,195325,183190,12135,0.06212722385767311,2021-11-20 04:52:16 UTC
792117,mainnet,249,107568000,107763583,195584,183439,12145,0.06209608147905759,2021-11-20 04:54:20 UTC
792118,mainnet,249,107568000,107763862,195863,183718,12145,0.062007627780642595,2021-11-20 04:56:29 UTC
792120,mainnet,249,107568000,107764126,196127,183972,12155,0.06197514875565322,2021-11-20 04:58:36 UTC
792121,mainnet,249,107568000,107764384,196385,184222,12163,0.06193446546324821,2021-11-20 05:00:36 UTC
792122,mainnet,249,107568000,107764640,196641,184473,12168,0.06187926220879674,2021-11-20 05:02:46 UTC
792124,mainnet,249,107568000,107764900,196901,184716,12185,0.06188389088933017,2021-11-20 05:04:46 UTC
792126,mainnet,249,107568000,107765144,197145,184959,12186,0.06181237160465647,2021-11-20 05:06:50 UTC
792127,mainnet,249,107568000,107765423,197424,185233,12191,0.06175034443634006,2021-11-20 05:09:02 UTC
792129,mainnet,249,107568000,107765685,197686,185484,12202,0.06172414839695274,2021-11-20 05:11:13 UTC
792130,mainnet,249,107568000,107765929,197930,185713,12217,0.061723841762239176,2021-11-20 05:13:14 UTC
792132,mainnet,249,107568000,107766251,198252,186031,12221,0.061643766519379375,2021-11-20 05:15:48 UTC
792133,mainnet,249,107568000,107766509,198510,186281,12229,0.06160394942320286,2021-11-20 05:17:53 UTC
792135,mainnet,249,107568000,107766792,198793,186556,12237,0.061556493437897715,2021-11-20 05:20:11 UTC
792136,mainnet,249,107568000,107767095,199096,186852,12244,0.061497970828143206,2021-11-20 05:22:33 UTC
792138,mainnet,249,107568000,107767359,199360,187116,12244,0.06141653290529695,2021-11-20 05:24:39 UTC
792139,mainnet,249,107568000,107767589,199590,187323,12267,0.061460995039831656,2021-11-20 05:26:44 UTC
792141,mainnet,249,107568000,107767865,199866,187591,12275,0.06141614881970921,2021-11-20 05:29:03 UTC
792142,mainnet,249,107568000,107768122,200123,187828,12295,0.06143721611209106,2021-11-20 05:31:06 UTC
792144,mainnet,249,107568000,107768378,200379,188078,12301,0.0613886684732432,2021-11-20 05:33:15 UTC
792145,mainnet,249,107568000,107768665,200666,188356,12310,0.06134571875654072,2021-11-20 05:35:43 UTC
792147,mainnet,249,107568000,107768943,200944,188633,12311,0.06126582530456247,2021-11-20 05:37:47 UTC
792148,mainnet,249,107568000,107769196,201197,188881,12316,0.061213636386228426,2021-11-20 05:39:51 UTC
792150,mainnet,249,107568000,107769484,201485,189148,12337,0.06123036454326625,2021-11-20 05:42:20 UTC
792151,mainnet,249,107568000,107769750,201751,189404,12347,0.061199200995286265,2021-11-20 05:44:39 UTC
792153,mainnet,249,107568000,107770029,202030,189678,12352,0.06113943473741523,2021-11-20 05:46:47 UTC
792154,mainnet,249,107568000,107770329,202330,189953,12377,0.06117234221321603,2021-11-20 05:49:10 UTC
792156,mainnet,249,107568000,107770584,202585,190207,12378,0.061100278895278526,2021-11-20 05:51:29 UTC
792157,mainnet,249,107568000,107770891,202892,190504,12388,0.06105711412968476,2021-11-20 05:53:50 UTC
792159,mainnet,249,107568000,107771154,203155,190755,12400,0.06103713913022077,2021-11-20 05:56:02 UTC
792160,mainnet,249,107568000,107771424,203425,191018,12407,0.060990537052967926,2021-11-20 05:58:09 UTC
792162,mainnet,249,107568000,107771674,203675,191253,12422,0.060989321222535905,2021-11-20 06:00:18 UTC
792163,mainnet,249,107568000,107771936,203937,191509,12428,0.06094038845329685,2021-11-20 06:02:33 UTC
792165,mainnet,249,107568000,107772210,204211,191766,12445,0.06094186894927306,2021-11-20 06:04:45 UTC
792166,mainnet,249,107568000,107772466,204467,192013,12454,0.06090958443171759,2021-11-20 06:06:54 UTC
792168,mainnet,249,107568000,107772715,204716,192261,12455,0.06084038375114793,2021-11-20 06:08:57 UTC
792169,mainnet,249,107568000,107772966,204967,192499,12468,0.060829304229461326,2021-11-20 06:10:57 UTC
792171,mainnet,249,107568000,107773228,205229,192750,12479,0.06080524682184292,2021-11-20 06:13:06 UTC
792172,mainnet,249,107568000,107773476,205477,192986,12491,0.06079025876375458,2021-11-20 06:15:07 UTC
792174,mainnet,249,107568000,107773776,205777,193267,12510,0.06079396628388984,2021-11-20 06:18:03 UTC
792175,mainnet,249,107568000,107774076,206077,193550,12527,0.06078795789923184,2021-11-20 06:20:06 UTC
792177,mainnet,249,107568000,107774317,206318,193785,12533,0.06074603282311771,2021-11-20 06:22:13 UTC
792178,mainnet,249,107568000,107774574,206575,194032,12543,0.060718867239501394,2021-11-20 06:24:25 UTC
792179,mainnet,249,107568000,107774819,206820,194268,12552,0.060690455468523356,2021-11-20 06:26:35 UTC
792180,mainnet,249,107568000,107775046,207047,194475,12572,0.06072051273382372,2021-11-20 06:28:33 UTC
792182,mainnet,249,107568000,107775336,207337,194749,12588,0.060712752668361174,2021-11-20 06:31:01 UTC
792184,mainnet,249,107568000,107775585,207586,194981,12605,0.06072182131742988,2021-11-20 06:33:18 UTC
792185,mainnet,249,107568000,107775867,207868,195250,12618,0.06070198395135375,2021-11-20 06:35:29 UTC
792187,mainnet,249,107568000,107776115,208116,195493,12623,0.060653673912625654,2021-11-20 06:37:33 UTC
792188,mainnet,249,107568000,107776401,208402,195768,12634,0.06062321858715367,2021-11-20 06:40:00 UTC
792190,mainnet,249,107568000,107776699,208700,196053,12647,0.060598945855294684,2021-11-20 06:42:35 UTC
792191,mainnet,249,107568000,107776979,208980,196326,12654,0.060551248923341947,2021-11-20 06:44:50 UTC
792193,mainnet,249,107568000,107777244,209245,196577,12668,0.060541470524982675,2021-11-20 06:47:04 UTC
792194,mainnet,249,107568000,107777523,209524,196834,12690,0.06056585403104179,2021-11-20 06:49:20 UTC
792196,mainnet,249,107568000,107777765,209766,197055,12711,0.06059609278910786,2021-11-20 06:51:23 UTC
792197,mainnet,249,107568000,107778017,210018,197298,12720,0.060566237179670315,2021-11-20 06:53:35 UTC
792199,mainnet,249,107568000,107778290,210291,197566,12725,0.0605113866023748,2021-11-20 06:55:50 UTC
792200,mainnet,249,107568000,107778539,210540,197807,12733,0.060477818941768784,2021-11-20 06:58:05 UTC
792202,mainnet,249,107568000,107778808,210809,198061,12748,0.06047180148855125,2021-11-20 07:00:34 UTC
792203,mainnet,249,107568000,107779134,211135,198382,12753,0.06040211239254505,2021-11-20 07:02:57 UTC
792205,mainnet,249,107568000,107779429,211430,198652,12778,0.0604360781346072,2021-11-20 07:05:17 UTC
792206,mainnet,249,107568000,107779722,211723,198945,12778,0.060352441633643956,2021-11-20 07:07:40 UTC
792208,mainnet,249,107568000,107779984,211985,199205,12780,0.060287284477675306,2021-11-20 07:09:53 UTC
792209,mainnet,249,107568000,107780227,212228,199448,12780,0.06021825583806095,2021-11-20 07:12:05 UTC
792211,mainnet,249,107568000,107780504,212505,199718,12787,0.06017270181878073,2021-11-20 07:14:12 UTC
792212,mainnet,249,107568000,107780744,212745,199955,12790,0.06011892171378881,2021-11-20 07:16:18 UTC
792214,mainnet,249,107568000,107781001,213002,200197,12805,0.06011680641496324,2021-11-20 07:18:20 UTC
792215,mainnet,249,107568000,107781248,213249,200443,12806,0.06005186425258735,2021-11-20 07:20:19 UTC
792217,mainnet,249,107568000,107781508,213509,200697,12812,0.06000683811923619,2021-11-20 07:22:27 UTC
792218,mainnet,249,107568000,107781782,213783,200958,12825,0.05999073827198608,2021-11-20 07:24:36 UTC
792220,mainnet,249,107568000,107782082,214083,201250,12833,0.05994404039554752,2021-11-20 07:26:59 UTC
792221,mainnet,249,107568000,107782339,214340,201503,12837,0.059890827656993564,2021-11-20 07:29:05 UTC
792223,mainnet,249,107568000,107782596,214597,201752,12845,0.05985638196246919,2021-11-20 07:31:11 UTC
792224,mainnet,249,107568000,107782892,214893,202034,12859,0.05983908270627708,2021-11-20 07:33:37 UTC
792226,mainnet,249,107568000,107783157,215158,202294,12864,0.05978862045566514,2021-11-20 07:35:46 UTC
792227,mainnet,249,107568000,107783484,215485,202605,12880,0.0597721419124301,2021-11-20 07:38:24 UTC
792229,mainnet,249,107568000,107783770,215771,202890,12881,0.05969754971706114,2021-11-20 07:40:47 UTC
792230,mainnet,249,107568000,107784084,216085,203200,12885,0.05962931253904714,2021-11-20 07:43:33 UTC
792232,mainnet,249,107568000,107784395,216396,203506,12890,0.059566720272093754,2021-11-20 07:46:02 UTC
792233,mainnet,249,107568000,107784672,216673,203774,12899,0.0595321059845943,2021-11-20 07:48:20 UTC
792235,mainnet,249,107568000,107784954,216955,204045,12910,0.0595054273927773,2021-11-20 07:50:42 UTC
792236,mainnet,249,107568000,107785244,217245,204323,12922,0.05948123086837442,2021-11-20 07:52:58 UTC
792238,mainnet,249,107568000,107785530,217531,204605,12926,0.059421415798208074,2021-11-20 07:55:14 UTC
792239,mainnet,249,107568000,107785802,217803,204855,12948,0.05944821696670845,2021-11-20 07:57:23 UTC
792241,mainnet,249,107568000,107786055,218056,205107,12949,0.05938382800748432,2021-11-20 07:59:27 UTC
792242,mainnet,249,107568000,107786337,218338,205372,12966,0.05938499024448332,2021-11-20 08:01:49 UTC
792244,mainnet,249,107568000,107786628,218629,205662,12967,0.05931052147702272,2021-11-20 08:04:07 UTC
792245,mainnet,249,107568000,107786896,218897,205925,12972,0.05926074820577715,2021-11-20 08:06:21 UTC
792246,mainnet,249,107568000,107787169,219170,206191,12979,0.05921887119587535,2021-11-20 08:08:31 UTC
792248,mainnet,249,107568000,107787442,219443,206439,13004,0.05925912423727346,2021-11-20 08:10:39 UTC
792249,mainnet,249,107568000,107787695,219696,206690,13006,0.05919998543441847,2021-11-20 08:12:46 UTC
792250,mainnet,249,107568000,107787974,219975,206965,13010,0.0591430844414138,2021-11-20 08:14:56 UTC
792251,mainnet,249,107568000,107788241,220242,207211,13031,0.05916673477356726,2021-11-20 08:17:05 UTC
792253,mainnet,249,107568000,107788484,220485,207445,13040,0.0591423452842597,2021-11-20 08:19:08 UTC
792254,mainnet,249,107568000,107788753,220754,207704,13050,0.05911557661469328,2021-11-20 08:21:20 UTC
792256,mainnet,249,107568000,107789038,221039,207985,13054,0.05905745139997919,2021-11-20 08:23:40 UTC
792257,mainnet,249,107568000,107789317,221318,208248,13070,0.05905529599942164,2021-11-20 08:26:00 UTC
792259,mainnet,249,107568000,107789550,221551,208463,13088,0.05907443432889042,2021-11-20 08:28:05 UTC
792260,mainnet,249,107568000,107789850,221851,208747,13104,0.05906667087369451,2021-11-20 08:30:26 UTC
792262,mainnet,249,107568000,107790105,222106,208996,13110,0.05902587053028734,2021-11-20 08:32:34 UTC
792263,mainnet,249,107568000,107790373,222374,209263,13111,0.05895923084533264,2021-11-20 08:34:50 UTC
792265,mainnet,249,107568000,107790657,222658,209543,13115,0.05890199319135176,2021-11-20 08:37:01 UTC
792266,mainnet,249,107568000,107790917,222918,209794,13124,0.05887366655003185,2021-11-20 08:39:09 UTC
792268,mainnet,249,107568000,107791156,223157,210021,13136,0.05886438695626846,2021-11-20 08:41:24 UTC
792269,mainnet,249,107568000,107791419,223420,210250,13170,0.058947274192104555,2021-11-20 08:43:39 UTC
792271,mainnet,249,107568000,107791667,223668,210484,13184,0.058944507037215876,2021-11-20 08:45:41 UTC
792272,mainnet,249,107568000,107791944,223945,210743,13202,0.05895197481524481,2021-11-20 08:48:00 UTC
792274,mainnet,249,107568000,107792203,224204,210987,13217,0.05895077697097286,2021-11-20 08:50:00 UTC
792275,mainnet,249,107568000,107792450,224451,211222,13229,0.05893936761253013,2021-11-20 08:52:10 UTC
792277,mainnet,249,107568000,107792721,224722,211489,13233,0.058886090369434235,2021-11-20 08:54:18 UTC
792278,mainnet,249,107568000,107792991,224992,211751,13241,0.058850981368226425,2021-11-20 08:56:28 UTC
792279,mainnet,249,107568000,107793249,225250,211993,13257,0.05885460599334073,2021-11-20 08:58:40 UTC
792281,mainnet,249,107568000,107793516,225517,212238,13279,0.05888247892620069,2021-11-20 09:00:48 UTC
792282,mainnet,249,107568000,107793770,225771,212487,13284,0.05883838048287867,2021-11-20 09:02:52 UTC
792283,mainnet,249,107568000,107794020,226021,212736,13285,0.05877772419376961,2021-11-20 09:04:59 UTC
792285,mainnet,249,107568000,107794226,226227,212937,13290,0.05874630349162567,2021-11-20 09:07:01 UTC
792286,mainnet,249,107568000,107794425,226426,213107,13319,0.05882275003753986,2021-11-20 09:09:30 UTC
792288,mainnet,249,107568000,107794810,226811,213462,13349,0.05885517016370458,2021-11-20 09:11:48 UTC
792289,mainnet,249,107568000,107795119,227120,213758,13362,0.05883233532934132,2021-11-20 09:14:03 UTC
792291,mainnet,249,107568000,107795381,227382,214019,13363,0.05876894389177684,2021-11-20 09:16:12 UTC
792292,mainnet,249,107568000,107795647,227648,214274,13374,0.05874859432105707,2021-11-20 09:18:29 UTC
792294,mainnet,249,107568000,107795937,227938,214549,13389,0.05873965727522396,2021-11-20 09:20:52 UTC
792295,mainnet,249,107568000,107796188,228189,214796,13393,0.05869257501457126,2021-11-20 09:22:59 UTC
792297,mainnet,249,107568000,107796455,228456,215054,13402,0.05866337500437721,2021-11-20 09:25:08 UTC
792298,mainnet,249,107568000,107796712,228713,215301,13412,0.058641179119682744,2021-11-20 09:27:20 UTC
792300,mainnet,249,107568000,107796987,228988,215572,13416,0.05858822296364875,2021-11-20 09:29:32 UTC
792301,mainnet,249,107568000,107797276,229277,215848,13429,0.058571073417743605,2021-11-20 09:31:57 UTC
792303,mainnet,249,107568000,107797519,229520,216078,13442,0.05856570233530847,2021-11-20 09:34:01 UTC
792304,mainnet,249,107568000,107797804,229805,216342,13463,0.058584452035421335,2021-11-20 09:36:32 UTC
792306,mainnet,249,107568000,107798100,230101,216627,13474,0.05855689458107527,2021-11-20 09:38:37 UTC
792307,mainnet,249,107568000,107798391,230392,216914,13478,0.05850029514913712,2021-11-20 09:40:59 UTC
792309,mainnet,249,107568000,107798640,230641,217157,13484,0.058463152691845766,2021-11-20 09:43:07 UTC
792310,mainnet,249,107568000,107798896,230897,217407,13490,0.058424319068675644,2021-11-20 09:45:11 UTC
792312,mainnet,249,107568000,107799198,231199,217709,13490,0.05834800323530811,2021-11-20 09:47:37 UTC
792313,mainnet,249,107568000,107799441,231442,217943,13499,0.05832562801911494,2021-11-20 09:49:48 UTC
792315,mainnet,249,107568000,107799704,231705,218195,13510,0.05830689885846227,2021-11-20 09:51:58 UTC
792316,mainnet,249,107568000,107800021,232022,218501,13521,0.0582746463697408,2021-11-20 09:54:38 UTC
792318,mainnet,249,107568000,107800280,232281,218741,13540,0.05829146593996065,2021-11-20 09:56:38 UTC
792319,mainnet,249,107568000,107800531,232532,218990,13542,0.05823714585519412,2021-11-20 09:58:52 UTC
792321,mainnet,249,107568000,107800856,232857,219299,13558,0.05822457559789914,2021-11-20 10:01:16 UTC
792322,mainnet,249,107568000,107801107,233108,219532,13576,0.058239099473205554,2021-11-20 10:03:24 UTC
792323,mainnet,249,107568000,107801352,233353,219765,13588,0.05822937780958462,2021-11-20 10:05:30 UTC
792325,mainnet,249,107568000,107801614,233615,220024,13591,0.05817691500973825,2021-11-20 10:07:45 UTC
792326,mainnet,249,107568000,107801878,233879,220278,13601,0.05815400271080345,2021-11-20 10:09:53 UTC
792328,mainnet,249,107568000,107802145,234146,220533,13613,0.058138938952619304,2021-11-20 10:11:59 UTC
792329,mainnet,249,107568000,107802424,234425,220809,13616,0.058082542390956594,2021-11-20 10:14:14 UTC
792331,mainnet,249,107568000,107802716,234717,221083,13634,0.05808697282259061,2021-11-20 10:16:34 UTC
792332,mainnet,249,107568000,107802982,234983,221340,13643,0.05805951919926122,2021-11-20 10:18:47 UTC
792334,mainnet,249,107568000,107803274,235275,221627,13648,0.05800871320794815,2021-11-20 10:21:09 UTC
792336,mainnet,249,107568000,107803577,235578,221922,13656,0.05796806153375952,2021-11-20 10:23:41 UTC
792337,mainnet,249,107568000,107803831,235832,222164,13668,0.05795651141490553,2021-11-20 10:25:47 UTC
792338,mainnet,249,107568000,107804088,236089,222412,13677,0.05793154276565193,2021-11-20 10:27:55 UTC
792340,mainnet,249,107568000,107804436,236437,222734,13703,0.057956242043335014,2021-11-20 10:30:40 UTC
792342,mainnet,249,107568000,107804674,236675,222962,13713,0.05794021337276856,2021-11-20 10:32:48 UTC
792343,mainnet,249,107568000,107804949,236950,223219,13731,0.05794893437434058,2021-11-20 10:35:03 UTC
792345,mainnet,249,107568000,107805205,237206,223469,13737,0.057911688574487995,2021-11-20 10:37:09 UTC
792346,mainnet,249,107568000,107805482,237483,223741,13742,0.057865194561294915,2021-11-20 10:39:22 UTC
792347,mainnet,249,107568000,107805741,237742,223989,13753,0.05784842392173028,2021-11-20 10:41:32 UTC
792349,mainnet,249,107568000,107806044,238045,224282,13763,0.057816799344661725,2021-11-20 10:44:04 UTC
792350,mainnet,249,107568000,107806342,238343,224577,13766,0.057757097963858806,2021-11-20 10:46:28 UTC
792352,mainnet,249,107568000,107806607,238608,224837,13771,0.05771390732917589,2021-11-20 10:48:41 UTC
792353,mainnet,249,107568000,107806899,238900,225113,13787,0.057710339053997486,2021-11-20 10:51:05 UTC
792355,mainnet,249,107568000,107807173,239174,225386,13788,0.05764840659937953,2021-11-20 10:53:19 UTC
792356,mainnet,249,107568000,107807446,239447,225650,13797,0.05762026669784963,2021-11-20 10:55:25 UTC
792358,mainnet,249,107568000,107807748,239749,225943,13806,0.057585224547339095,2021-11-20 10:57:50 UTC
792359,mainnet,249,107568000,107807974,239975,226163,13812,0.057555995416189186,2021-11-20 10:59:56 UTC
792361,mainnet,249,107568000,107808300,240301,226476,13825,0.057532011935031484,2021-11-20 11:02:21 UTC
792362,mainnet,249,107568000,107808584,240585,226759,13826,0.05746825446307958,2021-11-20 11:04:50 UTC
792364,mainnet,249,107568000,107808835,240836,227005,13831,0.057429121892075934,2021-11-20 11:06:49 UTC
792365,mainnet,249,107568000,107809118,241119,227288,13831,0.05736171765808584,2021-11-20 11:09:11 UTC
792367,mainnet,249,107568000,107809360,241361,227503,13858,0.057416069704716174,2021-11-20 11:11:20 UTC
792368,mainnet,249,107568000,107809626,241627,227743,13884,0.057460465924751784,2021-11-20 11:13:30 UTC
792370,mainnet,249,107568000,107809892,241893,227988,13905,0.05748409420694274,2021-11-20 11:15:42 UTC
792371,mainnet,249,107568000,107810160,242161,228244,13917,0.057470030269118476,2021-11-20 11:17:49 UTC
792373,mainnet,249,107568000,107810417,242418,228495,13923,0.057433853921738484,2021-11-20 11:19:52 UTC
792374,mainnet,249,107568000,107810671,242672,228741,13931,0.057406705347135226,2021-11-20 11:21:59 UTC
792375,mainnet,249,107568000,107810917,242918,228986,13932,0.057352686914926024,2021-11-20 11:24:04 UTC
792377,mainnet,249,107568000,107811177,243178,229236,13942,0.057332488958705144,2021-11-20 11:26:11 UTC
792378,mainnet,249,107568000,107811423,243424,229476,13948,0.057299198107006705,2021-11-20 11:28:21 UTC
792380,mainnet,249,107568000,107811572,243573,229616,13957,0.05730109659116569,2021-11-20 11:30:25 UTC
792382,mainnet,249,107568000,107811996,243997,229993,14004,0.057394148288708466,2021-11-20 11:32:57 UTC
792383,mainnet,249,107568000,107812262,244263,230240,14023,0.05740943163721071,2021-11-20 11:35:25 UTC
792385,mainnet,249,107568000,107812534,244535,230491,14044,0.057431451530455764,2021-11-20 11:37:43 UTC
792386,mainnet,249,107568000,107812775,244776,230718,14058,0.057432101186390826,2021-11-20 11:40:04 UTC
792388,mainnet,249,107568000,107813040,245041,230962,14079,0.0574556910884301,2021-11-20 11:42:09 UTC
792389,mainnet,249,107568000,107813267,245268,231185,14083,0.05741882349103838,2021-11-20 11:44:11 UTC
792391,mainnet,249,107568000,107813525,245526,231434,14092,0.05739514348785872,2021-11-20 11:46:40 UTC
792392,mainnet,249,107568000,107813803,245804,231706,14098,0.05735464028250151,2021-11-20 11:48:50 UTC
792393,mainnet,249,107568000,107814052,246053,231945,14108,0.05733724035065616,2021-11-20 11:50:55 UTC
792395,mainnet,249,107568000,107814328,246329,232209,14120,0.057321712019291274,2021-11-20 11:53:19 UTC
792397,mainnet,249,107568000,107814618,246619,232481,14138,0.05732729432849862,2021-11-20 11:55:40 UTC
792398,mainnet,249,107568000,107814850,246851,232701,14150,0.05732202826806454,2021-11-20 11:57:41 UTC
792399,mainnet,249,107568000,107815092,247093,232934,14159,0.05730231127551165,2021-11-20 11:59:45 UTC
792401,mainnet,249,107568000,107815420,247421,233240,14181,0.057315264266169806,2021-11-20 12:02:44 UTC
792403,mainnet,249,107568000,107815706,247707,233504,14203,0.057337903248596125,2021-11-20 12:05:00 UTC
792404,mainnet,249,107568000,107815998,247999,233770,14229,0.057375231351739324,2021-11-20 12:07:28 UTC
792406,mainnet,249,107568000,107816276,248277,234038,14239,0.057351264917813574,2021-11-20 12:09:46 UTC
792407,mainnet,249,107568000,107816515,248516,234266,14250,0.05734037245086836,2021-11-20 12:11:54 UTC
792409,mainnet,249,107568000,107816766,248767,234507,14260,0.05732271563350445,2021-11-20 12:14:04 UTC
792410,mainnet,249,107568000,107817041,249042,234762,14280,0.05733972582937818,2021-11-20 12:16:13 UTC
792412,mainnet,249,107568000,107817306,249307,235008,14299,0.05735498802681032,2021-11-20 12:18:18 UTC
792413,mainnet,249,107568000,107817552,249553,235241,14312,0.057350542770473606,2021-11-20 12:20:22 UTC
792415,mainnet,249,107568000,107817811,249812,235487,14325,0.05734312202776488,2021-11-20 12:22:30 UTC
792416,mainnet,249,107568000,107818065,250066,235722,14344,0.05736085673382227,2021-11-20 12:24:37 UTC
792417,mainnet,249,107568000,107818320,250321,235970,14351,0.0573303877820878,2021-11-20 12:26:47 UTC
792419,mainnet,249,107568000,107818580,250581,236229,14352,0.0572748931483233,2021-11-20 12:28:54 UTC
792420,mainnet,249,107568000,107818827,250828,236455,14373,0.05730221506370899,2021-11-20 12:30:55 UTC
792422,mainnet,249,107568000,107819072,251073,236670,14403,0.05736578604628933,2021-11-20 12:33:02 UTC
792423,mainnet,249,107568000,107819327,251328,236915,14413,0.057347370766488416,2021-11-20 12:35:19 UTC
792425,mainnet,249,107568000,107819605,251606,237191,14415,0.05729195647162627,2021-11-20 12:37:27 UTC
792426,mainnet,249,107568000,107819852,251853,237424,14429,0.05729135646587494,2021-11-20 12:39:33 UTC
792428,mainnet,249,107568000,107820090,252091,237641,14450,0.05732057074627813,2021-11-20 12:41:35 UTC
792429,mainnet,249,107568000,107820336,252337,237879,14458,0.05729639331528868,2021-11-20 12:43:46 UTC
792431,mainnet,249,107568000,107820612,252613,238141,14472,0.05728921314421665,2021-11-20 12:46:07 UTC
792432,mainnet,249,107568000,107820864,252865,238380,14485,0.05728353073774544,2021-11-20 12:48:12 UTC
792434,mainnet,249,107568000,107821105,253106,238604,14502,0.0572961526000964,2021-11-20 12:50:19 UTC
792435,mainnet,249,107568000,107821368,253369,238851,14518,0.05729982752428277,2021-11-20 12:52:36 UTC
792437,mainnet,249,107568000,107821654,253655,239099,14556,0.0573850308489878,2021-11-20 12:54:51 UTC
792438,mainnet,249,107568000,107821928,253929,239356,14573,0.057390057850816564,2021-11-20 12:57:18 UTC
792440,mainnet,249,107568000,107822238,254239,239649,14590,0.05738694692789068,2021-11-20 12:59:37 UTC
792441,mainnet,249,107568000,107822558,254559,239947,14612,0.05740123114877101,2021-11-20 13:02:17 UTC
792443,mainnet,249,107568000,107822801,254802,240185,14617,0.05736611172596762,2021-11-20 13:04:44 UTC
792444,mainnet,249,107568000,107823110,255111,240447,14664,0.05748086127215212,2021-11-20 13:06:59 UTC
792446,mainnet,249,107568000,107823386,255387,240698,14689,0.05751663162181317,2021-11-20 13:09:18 UTC
792447,mainnet,249,107568000,107823643,255644,240949,14695,0.05748228004568853,2021-11-20 13:11:36 UTC
792449,mainnet,249,107568000,107823930,255931,241218,14713,0.05748815110322704,2021-11-20 13:13:52 UTC
792450,mainnet,249,107568000,107824253,256254,241534,14720,0.05744300576771485,2021-11-20 13:16:37 UTC
792452,mainnet,249,107568000,107824526,256527,241798,14729,0.057416958058995736,2021-11-20 13:18:57 UTC
792453,mainnet,249,107568000,107824816,256817,242059,14758,0.05746504320196872,2021-11-20 13:21:31 UTC
792455,mainnet,249,107568000,107825137,257138,242367,14771,0.05744386282852009,2021-11-20 13:24:08 UTC
792456,mainnet,249,107568000,107825412,257413,242640,14773,0.05739026389498588,2021-11-20 13:26:27 UTC
792458,mainnet,249,107568000,107825660,257661,242862,14799,0.05743593326114546,2021-11-20 13:28:41 UTC
792459,mainnet,249,107568000,107825916,257917,243112,14805,0.05740218752544423,2021-11-20 13:30:56 UTC
792461,mainnet,249,107568000,107826166,258167,243349,14818,0.05739695623375567,2021-11-20 13:33:05 UTC
792462,mainnet,249,107568000,107826445,258446,243622,14824,0.057358210225733806,2021-11-20 13:35:21 UTC
792464,mainnet,249,107568000,107826721,258722,243880,14842,0.05736659425947542,2021-11-20 13:37:48 UTC
792465,mainnet,249,107568000,107827000,259001,244129,14872,0.057420627719584096,2021-11-20 13:40:00 UTC
792467,mainnet,249,107568000,107827328,259329,244448,14881,0.05738270690898434,2021-11-20 13:42:43 UTC
792468,mainnet,249,107568000,107827618,259619,244719,14900,0.05739179335872952,2021-11-20 13:45:10 UTC
792470,mainnet,249,107568000,107827867,259868,244952,14916,0.057398371480905694,2021-11-20 13:47:16 UTC
792471,mainnet,249,107568000,107828144,260145,245217,14928,0.05738338234446174,2021-11-20 13:49:30 UTC
792473,mainnet,249,107568000,107828396,260397,245459,14938,0.05736625229937365,2021-11-20 13:51:40 UTC
792474,mainnet,249,107568000,107828633,260634,245682,14952,0.05736780312622298,2021-11-20 13:53:51 UTC
792476,mainnet,249,107568000,107828901,260902,245927,14975,0.05739703030256572,2021-11-20 13:55:58 UTC
792477,mainnet,249,107568000,107829126,261127,246137,14990,0.05740501748191493,2021-11-20 13:58:03 UTC
792479,mainnet,249,107568000,107829424,261425,246427,14998,0.057370182652768484,2021-11-20 14:00:26 UTC
792480,mainnet,249,107568000,107829693,261694,246682,15012,0.05736470839988689,2021-11-20 14:02:34 UTC
792482,mainnet,249,107568000,107829975,261976,246947,15029,0.05736785049012123,2021-11-20 14:05:00 UTC
792483,mainnet,249,107568000,107830260,262261,247214,15047,0.05737414255264794,2021-11-20 14:07:18 UTC
792485,mainnet,249,107568000,107830505,262506,247454,15052,0.057339641760569285,2021-11-20 14:09:36 UTC
792486,mainnet,249,107568000,107830755,262756,247681,15075,0.0573726194644461,2021-11-20 14:11:52 UTC
792487,mainnet,249,107568000,107831044,263045,247952,15093,0.05737801516850729,2021-11-20 14:14:07 UTC
792489,mainnet,249,107568000,107831268,263269,248171,15098,0.05734818759519731,2021-11-20 14:16:26 UTC
792490,mainnet,249,107568000,107831606,263607,248505,15102,0.057289829177525634,2021-11-20 14:18:47 UTC
792492,mainnet,249,107568000,107831867,263868,248756,15112,0.057271059772310395,2021-11-20 14:21:00 UTC
792493,mainnet,249,107568000,107832112,264113,248992,15121,0.05725200955651558,2021-11-20 14:23:11 UTC
792495,mainnet,249,107568000,107832364,264365,249232,15133,0.05724282715185444,2021-11-20 14:25:20 UTC
792496,mainnet,249,107568000,107832607,264608,249462,15146,0.05723938807594631,2021-11-20 14:27:26 UTC
792498,mainnet,249,107568000,107832865,264866,249715,15151,0.05720250994842675,2021-11-20 14:29:41 UTC
792499,mainnet,249,107568000,107833107,265108,249937,15171,0.05722573441767129,2021-11-20 14:31:49 UTC
792500,mainnet,249,107568000,107833356,265357,250179,15178,0.057198415719200923,2021-11-20 14:33:53 UTC
792501,mainnet,249,107568000,107833620,265621,250431,15190,0.057186743518020035,2021-11-20 14:36:04 UTC
792503,mainnet,249,107568000,107833882,265883,250679,15204,0.057183046678426226,2021-11-20 14:38:13 UTC
792504,mainnet,249,107568000,107834140,266141,250924,15217,0.057176459094991,2021-11-20 14:40:18 UTC
792506,mainnet,249,107568000,107834400,266401,251178,15223,0.057143178891971125,2021-11-20 14:42:32 UTC
792507,mainnet,249,107568000,107834673,266674,251441,15233,0.05712217914007365,2021-11-20 14:44:57 UTC
792509,mainnet,249,107568000,107834914,266915,251669,15246,0.05711930764475582,2021-11-20 14:47:07 UTC
792510,mainnet,249,107568000,107835162,267163,251896,15267,0.05714488907520877,2021-11-20 14:49:15 UTC
792512,mainnet,249,107568000,107835428,267429,252144,15285,0.05715535712282512,2021-11-20 14:51:40 UTC
792513,mainnet,249,107568000,107835702,267703,252402,15301,0.057156625065837886,2021-11-20 14:54:11 UTC
792515,mainnet,249,107568000,107835964,267965,252656,15309,0.057130595413580135,2021-11-20 14:56:30 UTC
792516,mainnet,249,107568000,107836258,268259,252948,15311,0.05707543828911611,2021-11-20 14:58:57 UTC
792518,mainnet,249,107568000,107836547,268548,253228,15320,0.05704752967812086,2021-11-20 15:01:18 UTC
792519,mainnet,249,107568000,107836786,268787,253464,15323,0.057007965414994026,2021-11-20 15:03:35 UTC
792521,mainnet,249,107568000,107837052,269053,253712,15341,0.05701850564758616,2021-11-20 15:06:10 UTC
792522,mainnet,249,107568000,107837287,269288,253929,15359,0.05703559014883693,2021-11-20 15:08:27 UTC
792524,mainnet,249,107568000,107837548,269549,254164,15385,0.057076820911967766,2021-11-20 15:10:42 UTC
792525,mainnet,249,107568000,107837790,269791,254387,15404,0.05709604842266792,2021-11-20 15:12:49 UTC
792526,mainnet,249,107568000,107838037,270038,254597,15441,0.05718084121494012,2021-11-20 15:15:04 UTC
792528,mainnet,249,107568000,107838267,270268,254811,15457,0.05719138040759542,2021-11-20 15:17:19 UTC
792529,mainnet,249,107568000,107838515,270516,255037,15479,0.0572202753256739,2021-11-20 15:19:31 UTC
792531,mainnet,249,107568000,107838780,270781,255282,15499,0.05723813709233661,2021-11-20 15:21:44 UTC
792532,mainnet,249,107568000,107839048,271049,255540,15509,0.05721843651885821,2021-11-20 15:24:02 UTC
792534,mainnet,249,107568000,107839295,271296,255773,15523,0.05721794644963435,2021-11-20 15:26:22 UTC
792535,mainnet,249,107568000,107839566,271567,256012,15555,0.05727868260871166,2021-11-20 15:28:46 UTC
792537,mainnet,249,107568000,107839811,271812,256243,15569,0.057278560181301785,2021-11-20 15:31:20 UTC
792538,mainnet,249,107568000,107840116,272117,256536,15581,0.057258458677701136,2021-11-20 15:33:43 UTC
792540,mainnet,249,107568000,107840384,272385,256793,15592,0.05724250601171137,2021-11-20 15:36:05 UTC
792541,mainnet,249,107568000,107840651,272652,257052,15600,0.05721579155847014,2021-11-20 15:38:30 UTC
792543,mainnet,249,107568000,107840930,272931,257308,15623,0.05724157387764673,2021-11-20 15:40:57 UTC
792544,mainnet,249,107568000,107841177,273178,257530,15648,0.05728133305024563,2021-11-20 15:43:26 UTC
792546,mainnet,249,107568000,107841401,273402,257733,15669,0.057311212061360195,2021-11-20 15:45:26 UTC
792547,mainnet,249,107568000,107841658,273659,257975,15684,0.05731220241249146,2021-11-20 15:47:55 UTC
792549,mainnet,249,107568000,107841906,273907,258199,15708,0.05734793196230838,2021-11-20 15:50:19 UTC
792550,mainnet,249,107568000,107842131,274132,258419,15713,0.057319101746603825,2021-11-20 15:52:34 UTC
792552,mainnet,249,107568000,107842364,274365,258636,15729,0.05732874091083046,2021-11-20 15:54:43 UTC
792553,mainnet,249,107568000,107842598,274599,258864,15735,0.05730173817093289,2021-11-20 15:57:01 UTC
792555,mainnet,249,107568000,107842845,274846,259100,15746,0.0572902643662269,2021-11-20 15:59:16 UTC
792556,mainnet,249,107568000,107843098,275099,259334,15765,0.057306642336031756,2021-11-20 16:01:39 UTC
792557,mainnet,249,107568000,107843352,275353,259571,15782,0.05731551862518295,2021-11-20 16:04:00 UTC
792559,mainnet,249,107568000,107843571,275572,259764,15808,0.05736431858098791,2021-11-20 16:06:28 UTC
792560,mainnet,249,107568000,107843796,275797,259959,15838,0.057426295427433945,2021-11-20 16:08:29 UTC
792562,mainnet,249,107568000,107844012,276013,260156,15857,0.05745019256339375,2021-11-20 16:10:39 UTC
792563,mainnet,249,107568000,107844249,276250,260375,15875,0.05746606334841629,2021-11-20 16:12:49 UTC
792564,mainnet,249,107568000,107844516,276517,260635,15882,0.057435890017611936,2021-11-20 16:15:05 UTC
792566,mainnet,249,107568000,107844750,276751,260849,15902,0.05745959364193806,2021-11-20 16:17:10 UTC
792567,mainnet,249,107568000,107844986,276987,261078,15909,0.057435908544444324,2021-11-20 16:19:13 UTC
792569,mainnet,249,107568000,107845224,277225,261302,15923,0.05743709982865903,2021-11-20 16:21:28 UTC
792570,mainnet,249,107568000,107845456,277457,261525,15932,0.057421510360163915,2021-11-20 16:23:33 UTC
792572,mainnet,249,107568000,107845700,277701,261755,15946,0.05742147129466585,2021-11-20 16:25:46 UTC
792573,mainnet,249,107568000,107845919,277920,261961,15959,0.05742299942429476,2021-11-20 16:27:53 UTC
792575,mainnet,249,107568000,107846204,278205,262222,15983,0.057450441221401485,2021-11-20 16:30:05 UTC
792576,mainnet,249,107568000,107846434,278435,262436,15999,0.057460448578662886,2021-11-20 16:32:20 UTC
792578,mainnet,249,107568000,107846680,278681,262650,16031,0.0575245531629354,2021-11-20 16:34:29 UTC
792579,mainnet,249,107568000,107846919,278920,262886,16034,0.05748601749605622,2021-11-20 16:36:37 UTC
792580,mainnet,249,107568000,107847142,279143,263097,16046,0.0574830821478597,2021-11-20 16:38:48 UTC
792582,mainnet,249,107568000,107847389,279390,263321,16069,0.05751458534664806,2021-11-20 16:40:59 UTC
792583,mainnet,249,107568000,107847637,279638,263549,16089,0.057535098949355955,2021-11-20 16:43:16 UTC
792584,mainnet,249,107568000,107847886,279887,263792,16095,0.05750535037354361,2021-11-20 16:45:31 UTC
792585,mainnet,249,107568000,107848144,280145,264031,16114,0.05752021274697032,2021-11-20 16:47:41 UTC
792587,mainnet,249,107568000,107848398,280399,264266,16133,0.05753586853020161,2021-11-20 16:49:46 UTC
792588,mainnet,249,107568000,107848648,280649,264512,16137,0.05749886869363511,2021-11-20 16:51:58 UTC
792589,mainnet,249,107568000,107848900,280901,264747,16154,0.05750780524099238,2021-11-20 16:54:05 UTC
792590,mainnet,249,107568000,107849152,281153,264990,16163,0.057488271510529855,2021-11-20 16:56:14 UTC
792592,mainnet,249,107568000,107849417,281418,265245,16173,0.057469671449587444,2021-11-20 16:58:26 UTC
792593,mainnet,249,107568000,107849654,281655,265461,16194,0.05749587261010811,2021-11-20 17:00:41 UTC
792594,mainnet,249,107568000,107849915,281916,265717,16199,0.057460378268704156,2021-11-20 17:02:54 UTC
792596,mainnet,249,107568000,107850148,282149,265925,16224,0.057501532878018354,2021-11-20 17:05:03 UTC
792597,mainnet,249,107568000,107850390,282391,266166,16225,0.057455797104015355,2021-11-20 17:07:10 UTC
792599,mainnet,249,107568000,107850622,282623,266381,16242,0.05746878350311192,2021-11-20 17:09:14 UTC
792600,mainnet,249,107568000,107850872,282873,266603,16270,0.05751697758357991,2021-11-20 17:11:23 UTC
792601,mainnet,249,107568000,107851144,283145,266865,16280,0.05749704215154779,2021-11-20 17:13:33 UTC
792603,mainnet,249,107568000,107851408,283409,267118,16291,0.0574822959045055,2021-11-20 17:15:42 UTC
792604,mainnet,249,107568000,107851664,283665,267362,16303,0.05747272310648124,2021-11-20 17:18:00 UTC
792606,mainnet,249,107568000,107851907,283908,267597,16311,0.0574517097087789,2021-11-20 17:20:12 UTC
792607,mainnet,249,107568000,107852182,284183,267859,16324,0.0574418596467769,2021-11-20 17:22:19 UTC
792609,mainnet,249,107568000,107852466,284467,268134,16333,0.057416150203714315,2021-11-20 17:24:40 UTC
792610,mainnet,249,107568000,107852760,284761,268413,16348,0.05740954695341005,2021-11-20 17:27:06 UTC
792612,mainnet,249,107568000,107853011,285012,268650,16362,0.057408109132247066,2021-11-20 17:29:12 UTC
792613,mainnet,249,107568000,107853260,285261,268888,16373,0.057396559641871826,2021-11-20 17:31:23 UTC
792615,mainnet,249,107568000,107853553,285554,269158,16396,0.05741821161671698,2021-11-20 17:33:50 UTC
792616,mainnet,249,107568000,107853810,285811,269404,16407,0.057405068384351894,2021-11-20 17:35:56 UTC
792618,mainnet,249,107568000,107854079,286080,269656,16424,0.05741051454138702,2021-11-20 17:38:18 UTC
792619,mainnet,249,107568000,107854332,286333,269898,16435,0.05739820418882909,2021-11-20 17:40:26 UTC
792621,mainnet,249,107568000,107854602,286603,270143,16460,0.057431359755480575,2021-11-20 17:42:40 UTC
792622,mainnet,249,107568000,107854870,286871,270390,16481,0.057450909990901834,2021-11-20 17:44:58 UTC
792624,mainnet,249,107568000,107855119,287120,270633,16487,0.05742198383950961,2021-11-20 17:47:07 UTC
792625,mainnet,249,107568000,107855355,287356,270859,16497,0.057409624298779216,2021-11-20 17:49:13 UTC
792627,mainnet,249,107568000,107855624,287625,271116,16509,0.05739765319426336,2021-11-20 17:51:34 UTC
792628,mainnet,249,107568000,107855916,287917,271393,16524,0.05739153992296391,2021-11-20 17:54:13 UTC
792630,mainnet,249,107568000,107856220,288221,271676,16545,0.05740386717137197,2021-11-20 17:56:36 UTC
792632,mainnet,249,107568000,107856476,288477,271927,16550,0.05737025828748912,2021-11-20 17:59:03 UTC
792633,mainnet,249,107568000,107856750,288751,272169,16582,0.05742664094669802,2021-11-20 18:01:25 UTC
792635,mainnet,249,107568000,107856917,288918,272316,16602,0.05746267106929994,2021-11-20 18:03:44 UTC
792636,mainnet,249,107568000,107857152,289153,272494,16659,0.05761309756426528,2021-11-20 18:06:07 UTC
792638,mainnet,249,107568000,107857344,289345,272642,16703,0.05772693497382018,2021-11-20 18:08:14 UTC
792639,mainnet,249,107568000,107857449,289450,272742,16708,0.0577232682674037,2021-11-20 18:10:35 UTC
792641,mainnet,249,107568000,107857829,289830,273094,16736,0.0577441948728565,2021-11-20 18:12:48 UTC
792642,mainnet,249,107568000,107858088,290089,273348,16741,0.057709875245183374,2021-11-20 18:15:08 UTC
792644,mainnet,249,107568000,107858353,290354,273593,16761,0.057726086088016694,2021-11-20 18:17:26 UTC
792645,mainnet,249,107568000,107858602,290603,273827,16776,0.05772824093350722,2021-11-20 18:19:35 UTC
792647,mainnet,249,107568000,107858873,290874,274056,16818,0.05781884939870872,2021-11-20 18:21:59 UTC
792648,mainnet,249,107568000,107859095,291096,274260,16836,0.057836589990930824,2021-11-20 18:24:07 UTC
792650,mainnet,249,107568000,107859296,291297,274442,16855,0.057861907263033946,2021-11-20 18:26:10 UTC
792651,mainnet,249,107568000,107859514,291515,274626,16889,0.05793526919712536,2021-11-20 18:28:23 UTC
792652,mainnet,249,107568000,107859743,291744,274826,16918,0.057989196007458596,2021-11-20 18:30:33 UTC
792653,mainnet,249,107568000,107859955,291956,275023,16933,0.057998465522201975,2021-11-20 18:32:39 UTC
792655,mainnet,249,107568000,107860186,292187,275235,16952,0.05801763938847382,2021-11-20 18:34:48 UTC
792656,mainnet,249,107568000,107860432,292433,275446,16987,0.058088519421542716,2021-11-20 18:37:05 UTC
792658,mainnet,249,107568000,107860672,292673,275669,17004,0.05809897052341692,2021-11-20 18:39:11 UTC
792659,mainnet,249,107568000,107860905,292906,275883,17023,0.05811762135292551,2021-11-20 18:41:19 UTC
792660,mainnet,249,107568000,107861144,293145,276103,17042,0.05813505261901107,2021-11-20 18:43:30 UTC
792662,mainnet,249,107568000,107861388,293389,276323,17066,0.05816850665839551,2021-11-20 18:45:43 UTC
792663,mainnet,249,107568000,107861632,293633,276539,17094,0.05821552754629078,2021-11-20 18:47:53 UTC
792665,mainnet,249,107568000,107861888,293889,276791,17098,0.058178427909857125,2021-11-20 18:50:02 UTC
792666,mainnet,249,107568000,107862146,294147,277040,17107,0.05815799583201597,2021-11-20 18:52:15 UTC
792668,mainnet,249,107568000,107862396,294397,277280,17117,0.05814257618114315,2021-11-20 18:54:22 UTC
792669,mainnet,249,107568000,107862657,294658,277528,17130,0.05813519402154362,2021-11-20 18:56:35 UTC
792671,mainnet,249,107568000,107862880,294881,277741,17140,0.058125142006436495,2021-11-20 18:58:39 UTC
792672,mainnet,249,107568000,107863133,295134,277971,17163,0.05815324564435138,2021-11-20 19:00:55 UTC
792674,mainnet,249,107568000,107863402,295403,278215,17188,0.05818492026147331,2021-11-20 19:03:05 UTC
792675,mainnet,249,107568000,107863637,295638,278438,17200,0.05817925977039488,2021-11-20 19:05:11 UTC
792677,mainnet,249,107568000,107863898,295899,278689,17210,0.058161737619931125,2021-11-20 19:07:22 UTC
792678,mainnet,249,107568000,107864154,296155,278937,17218,0.05813847478516317,2021-11-20 19:09:35 UTC
792679,mainnet,249,107568000,107864390,296391,279162,17229,0.05812929542395012,2021-11-20 19:11:40 UTC
792680,mainnet,249,107568000,107864624,296625,279380,17245,0.058137378845343445,2021-11-20 19:13:43 UTC
792681,mainnet,249,107568000,107864881,296882,279604,17278,0.05819820669491583,2021-11-20 19:15:53 UTC
792683,mainnet,249,107568000,107865120,297121,279813,17308,0.05825236183238479,2021-11-20 19:18:04 UTC
792685,mainnet,249,107568000,107865429,297430,280110,17320,0.05823218908650775,2021-11-20 19:20:41 UTC
792686,mainnet,249,107568000,107865700,297701,280373,17328,0.058206052381416254,2021-11-20 19:22:57 UTC
792687,mainnet,249,107568000,107865949,297950,280604,17346,0.05821782178217822,2021-11-20 19:25:07 UTC
792689,mainnet,249,107568000,107866204,298205,280850,17355,0.05819821934575208,2021-11-20 19:27:19 UTC
792690,mainnet,249,107568000,107866484,298485,281116,17369,0.05819052883729501,2021-11-20 19:29:37 UTC
792692,mainnet,249,107568000,107866748,298749,281379,17370,0.05814245403331894,2021-11-20 19:32:09 UTC
792694,mainnet,249,107568000,107867055,299056,281667,17389,0.05814630035846129,2021-11-20 19:34:33 UTC
792695,mainnet,249,107568000,107867350,299351,281949,17402,0.058132426482624074,2021-11-20 19:36:56 UTC
792696,mainnet,249,107568000,107867624,299625,282202,17423,0.058149353358364624,2021-11-20 19:39:09 UTC
792698,mainnet,249,107568000,107867882,299883,282459,17424,0.05810266003741459,2021-11-20 19:41:31 UTC
792699,mainnet,249,107568000,107868195,300196,282756,17440,0.058095377686578104,2021-11-20 19:44:08 UTC
792701,mainnet,249,107568000,107868478,300479,283023,17456,0.058093910056942415,2021-11-20 19:46:16 UTC
792702,mainnet,249,107568000,107868728,300729,283260,17469,0.058088844108815575,2021-11-20 19:48:27 UTC
792704,mainnet,249,107568000,107868991,300992,283506,17486,0.0580945672974697,2021-11-20 19:50:38 UTC
792705,mainnet,249,107568000,107869280,301281,283788,17493,0.058062074940006175,2021-11-20 19:53:06 UTC
792707,mainnet,249,107568000,107869542,301543,284048,17495,0.05801825941905466,2021-11-20 19:55:19 UTC
792708,mainnet,249,107568000,107869805,301806,284297,17509,0.05801408852044028,2021-11-20 19:57:28 UTC
792710,mainnet,249,107568000,107870076,302077,284559,17518,0.05799183651850356,2021-11-20 19:59:44 UTC
792711,mainnet,249,107568000,107870346,302347,284811,17536,0.057999583260293634,2021-11-20 20:01:58 UTC
792713,mainnet,249,107568000,107870594,302595,285053,17542,0.05797187660073696,2021-11-20 20:04:20 UTC
792714,mainnet,249,107568000,107870872,302873,285314,17559,0.05797479471593704,2021-11-20 20:06:29 UTC
792716,mainnet,249,107568000,107871139,303140,285565,17575,0.057976512502474105,2021-11-20 20:08:43 UTC
792717,mainnet,249,107568000,107871398,303399,285817,17582,0.05795009212291405,2021-11-20 20:10:51 UTC
792718,mainnet,249,107568000,107871672,303673,286078,17595,0.057940613752292765,2021-11-20 20:13:06 UTC
792719,mainnet,249,107568000,107871944,303945,286344,17601,0.05790850318314169,2021-11-20 20:15:24 UTC
792721,mainnet,249,107568000,107872250,304251,286636,17615,0.05789627642965841,2021-11-20 20:17:55 UTC
792722,mainnet,249,107568000,107872533,304534,286910,17624,0.05787202742550914,2021-11-20 20:20:17 UTC
792724,mainnet,249,107568000,107872799,304800,287165,17635,0.05785761154855643,2021-11-20 20:22:27 UTC
792725,mainnet,249,107568000,107873086,305087,287443,17644,0.057832683791836426,2021-11-20 20:24:51 UTC
792727,mainnet,249,107568000,107873380,305381,287726,17655,0.057813027005609384,2021-11-20 20:27:31 UTC
792728,mainnet,249,107568000,107873668,305669,288013,17656,0.057761827336105395,2021-11-20 20:29:49 UTC
792730,mainnet,249,107568000,107873973,305974,288309,17665,0.0577336636446234,2021-11-20 20:32:26 UTC
792731,mainnet,249,107568000,107874286,306287,288609,17678,0.05771710846363052,2021-11-20 20:34:48 UTC
792733,mainnet,249,107568000,107874569,306570,288883,17687,0.057693185895554035,2021-11-20 20:37:21 UTC
792734,mainnet,249,107568000,107874843,306844,289144,17700,0.05768403488417567,2021-11-20 20:39:36 UTC
792736,mainnet,249,107568000,107875091,307092,289386,17706,0.05765698878511977,2021-11-20 20:41:40 UTC
792737,mainnet,249,107568000,107875356,307357,289641,17716,0.057639812986201716,2021-11-20 20:43:52 UTC
792739,mainnet,249,107568000,107875611,307612,289889,17723,0.05761478745952694,2021-11-20 20:46:04 UTC
792740,mainnet,249,107568000,107875895,307896,290163,17733,0.0575941226907787,2021-11-20 20:48:24 UTC
792742,mainnet,249,107568000,107876195,308196,290450,17746,0.05758024114524524,2021-11-20 20:50:50 UTC
792743,mainnet,249,107568000,107876445,308446,290680,17766,0.05759841268812045,2021-11-20 20:52:57 UTC
792745,mainnet,249,107568000,107876721,308722,290955,17767,0.05755015839493136,2021-11-20 20:55:14 UTC
792746,mainnet,249,107568000,107877023,309024,291246,17778,0.05752951227089158,2021-11-20 20:57:41 UTC
792748,mainnet,249,107568000,107877282,309283,291498,17785,0.057503968857001514,2021-11-20 20:59:47 UTC
792749,mainnet,249,107568000,107877562,309563,291758,17805,0.05751656367201507,2021-11-20 21:02:09 UTC
792751,mainnet,249,107568000,107877842,309843,292033,17810,0.057480724108661486,2021-11-20 21:04:25 UTC
792752,mainnet,249,107568000,107878119,310120,292298,17822,0.05746807687346833,2021-11-20 21:06:51 UTC
792754,mainnet,249,107568000,107878382,310383,292552,17831,0.05744837829391429,2021-11-20 21:09:00 UTC
792755,mainnet,249,107568000,107878656,310657,292826,17831,0.05739770872698829,2021-11-20 21:11:11 UTC
792757,mainnet,249,107568000,107878942,310943,293107,17836,0.057360995423598536,2021-11-20 21:13:28 UTC
792758,mainnet,249,107568000,107879206,311207,293365,17842,0.05733161529142982,2021-11-20 21:15:34 UTC
792760,mainnet,249,107568000,107879486,311487,293601,17886,0.057421337006038776,2021-11-20 21:17:55 UTC
792761,mainnet,249,107568000,107879752,311753,293861,17892,0.057391588853996596,2021-11-20 21:20:16 UTC
792763,mainnet,249,107568000,107880015,312016,294109,17907,0.05739128762627557,2021-11-20 21:22:27 UTC
792764,mainnet,249,107568000,107880280,312281,294356,17925,0.05740022607843577,2021-11-20 21:24:48 UTC
792766,mainnet,249,107568000,107880548,312549,294614,17935,0.05738300234523227,2021-11-20 21:27:06 UTC
792767,mainnet,249,107568000,107880801,312802,294857,17945,0.05736855902455867,2021-11-20 21:29:15 UTC
792769,mainnet,249,107568000,107881042,313043,295090,17953,0.057349948729088336,2021-11-20 21:31:26 UTC
792770,mainnet,249,107568000,107881326,313327,295364,17963,0.05732988219974659,2021-11-20 21:33:43 UTC
792772,mainnet,249,107568000,107881609,313610,295635,17975,0.05731641210420586,2021-11-20 21:35:53 UTC
792773,mainnet,249,107568000,107881848,313849,295873,17976,0.057275951173972196,2021-11-20 21:38:02 UTC
792775,mainnet,249,107568000,107882111,314112,296122,17990,0.057272565199674004,2021-11-20 21:40:11 UTC
792776,mainnet,249,107568000,107882374,314375,296384,17991,0.05722783300198807,2021-11-20 21:42:23 UTC
792778,mainnet,249,107568000,107882650,314651,296652,17999,0.05720305989810933,2021-11-20 21:44:40 UTC
792779,mainnet,249,107568000,107882911,314912,296900,18012,0.057196931206178234,2021-11-20 21:46:47 UTC
792780,mainnet,249,107568000,107883166,315167,297154,18013,0.05715382638410747,2021-11-20 21:48:57 UTC
792782,mainnet,249,107568000,107883430,315431,297396,18035,0.05717573732448618,2021-11-20 21:51:05 UTC
792783,mainnet,249,107568000,107883700,315701,297654,18047,0.05716484901853336,2021-11-20 21:53:17 UTC
792785,mainnet,249,107568000,107883978,315979,297926,18053,0.05713354368486513,2021-11-20 21:55:27 UTC
792786,mainnet,249,107568000,107884246,316247,298176,18071,0.05714204403520033,2021-11-20 21:57:42 UTC
792788,mainnet,249,107568000,107884506,316507,298427,18080,0.057123539131835946,2021-11-20 21:59:52 UTC
792789,mainnet,249,107568000,107884782,316783,298681,18102,0.05714321791257738,2021-11-20 22:02:15 UTC
792790,mainnet,249,107568000,107885064,317065,298955,18110,0.057117625723432104,2021-11-20 22:04:34 UTC
792792,mainnet,249,107568000,107885336,317337,299212,18125,0.05711593668560552,2021-11-20 22:06:49 UTC
792793,mainnet,249,107568000,107885606,317607,299473,18134,0.057095718923071595,2021-11-20 22:09:01 UTC
792795,mainnet,249,107568000,107885856,317857,299710,18147,0.057091711052454405,2021-11-20 22:11:09 UTC
792796,mainnet,249,107568000,107886110,318111,299951,18160,0.05708699164756956,2021-11-20 22:13:19 UTC
792797,mainnet,249,107568000,107886372,318373,300205,18168,0.05706514057410647,2021-11-20 22:15:29 UTC
792799,mainnet,249,107568000,107886632,318633,300447,18186,0.05707506755420813,2021-11-20 22:17:36 UTC
792800,mainnet,249,107568000,107886908,318909,300709,18200,0.05706957157057342,2021-11-20 22:19:49 UTC
792801,mainnet,249,107568000,107887170,319171,300969,18202,0.057028990729107595,2021-11-20 22:22:04 UTC
792803,mainnet,249,107568000,107887429,319430,301216,18214,0.05702031744044078,2021-11-20 22:24:12 UTC
792804,mainnet,249,107568000,107887703,319704,301489,18215,0.056974576483247004,2021-11-20 22:26:25 UTC
792806,mainnet,249,107568000,107887954,319955,301731,18224,0.056958009720116894,2021-11-20 22:28:30 UTC
792807,mainnet,249,107568000,107888236,320237,301998,18239,0.05695469293054831,2021-11-20 22:30:54 UTC
792809,mainnet,249,107568000,107888526,320527,302275,18252,0.056943720809791376,2021-11-20 22:33:11 UTC
792810,mainnet,249,107568000,107888804,320805,302550,18255,0.05690372656286529,2021-11-20 22:35:26 UTC
792812,mainnet,249,107568000,107889069,321070,302813,18257,0.05686298937926309,2021-11-20 22:37:39 UTC
792813,mainnet,249,107568000,107889308,321309,303047,18262,0.056836254197672645,2021-11-20 22:39:47 UTC
792815,mainnet,249,107568000,107889619,321620,303353,18267,0.05679684099247559,2021-11-20 22:42:19 UTC
792816,mainnet,249,107568000,107889861,321862,303590,18272,0.05676967147411002,2021-11-20 22:44:28 UTC
792818,mainnet,249,107568000,107890143,322144,303853,18291,0.05677895599483461,2021-11-20 22:46:39 UTC
792819,mainnet,249,107568000,107890406,322407,304103,18304,0.05677296088484431,2021-11-20 22:48:54 UTC
792821,mainnet,249,107568000,107890654,322655,304344,18311,0.05675101889014582,2021-11-20 22:51:01 UTC
792822,mainnet,249,107568000,107890934,322935,304598,18337,0.05678232461640888,2021-11-20 22:53:35 UTC
792824,mainnet,249,107568000,107891221,323222,304883,18339,0.056738093322855496,2021-11-20 22:55:45 UTC
792825,mainnet,249,107568000,107891492,323493,305143,18350,0.05672456591023608,2021-11-20 22:58:01 UTC
792827,mainnet,249,107568000,107891736,323737,305386,18351,0.05668490163311577,2021-11-20 23:00:01 UTC
792828,mainnet,249,107568000,107892042,324043,305687,18356,0.056646803047743666,2021-11-20 23:02:37 UTC
792829,mainnet,249,107568000,107892378,324379,306017,18362,0.05660662373334895,2021-11-20 23:05:17 UTC
792830,mainnet,249,107568000,107892648,324649,306278,18371,0.056587268095697196,2021-11-20 23:07:33 UTC
792831,mainnet,249,107568000,107892920,324921,306540,18381,0.05657067410232026,2021-11-20 23:09:43 UTC
792833,mainnet,249,107568000,107893178,325179,306798,18381,0.056525790410819884,2021-11-20 23:11:52 UTC
792834,mainnet,249,107568000,107893445,325446,307053,18393,0.0565162884165115,2021-11-20 23:14:14 UTC
792836,mainnet,249,107568000,107893729,325730,307318,18412,0.056525343075553375,2021-11-20 23:16:25 UTC
792837,mainnet,249,107568000,107893980,325981,307565,18416,0.05649409014635822,2021-11-20 23:18:35 UTC
792839,mainnet,249,107568000,107894241,326242,307817,18425,0.05647648064933393,2021-11-20 23:20:37 UTC
792840,mainnet,249,107568000,107894496,326497,308071,18426,0.05643543432252057,2021-11-20 23:22:47 UTC
792842,mainnet,249,107568000,107894762,326763,308326,18437,0.056423156844563185,2021-11-20 23:25:31 UTC
792843,mainnet,249,107568000,107895072,327073,308625,18448,0.05640331057592648,2021-11-20 23:27:49 UTC
792845,mainnet,249,107568000,107895335,327336,308886,18450,0.05636410294009825,2021-11-20 23:30:06 UTC
792847,mainnet,249,107568000,107895561,327562,309086,18476,0.056404589054896474,2021-11-20 23:32:14 UTC
792848,mainnet,249,107568000,107895831,327832,309347,18485,0.056385587740061985,2021-11-20 23:34:29 UTC
792850,mainnet,249,107568000,107896123,328124,309634,18490,0.056350647925784154,2021-11-20 23:36:48 UTC
792851,mainnet,249,107568000,107896424,328425,309935,18490,0.05629900281647256,2021-11-20 23:39:18 UTC
792853,mainnet,249,107568000,107896692,328693,310187,18506,0.05630177703814806,2021-11-20 23:41:41 UTC
792854,mainnet,249,107568000,107896998,328999,310485,18514,0.056273727275766794,2021-11-20 23:44:00 UTC
792856,mainnet,249,107568000,107897226,329227,310703,18524,0.056265130138172144,2021-11-20 23:46:03 UTC
792858,mainnet,249,107568000,107897497,329498,310958,18540,0.05626741285227831,2021-11-20 23:48:26 UTC
792859,mainnet,249,107568000,107897766,329767,311207,18560,0.056282162860443886,2021-11-20 23:50:36 UTC
792861,mainnet,249,107568000,107898035,330036,311470,18566,0.05625446920941958,2021-11-20 23:52:55 UTC
792862,mainnet,249,107568000,107898294,330295,311719,18576,0.05624063337319669,2021-11-20 23:55:05 UTC
792864,mainnet,249,107568000,107898556,330557,311969,18588,0.0562323593207828,2021-11-20 23:57:24 UTC
792865,mainnet,249,107568000,107898832,330833,312237,18596,0.05620962842279942,2021-11-20 23:59:38 UTC
792867,mainnet,249,107568000,107899063,331064,312451,18613,0.05622175772660271,2021-11-21 00:01:45 UTC
792869,mainnet,249,107568000,107899317,331318,312695,18623,0.05620883863840782,2021-11-21 00:04:03 UTC
792871,mainnet,249,107568000,107899573,331574,312941,18633,0.0561956003787993,2021-11-21 00:06:21 UTC
792872,mainnet,249,107568000,107899875,331876,313238,18638,0.056159529462811414,2021-11-21 00:08:37 UTC
792874,mainnet,249,107568000,107900161,332162,313513,18649,0.05614429103871003,2021-11-21 00:11:00 UTC
792875,mainnet,249,107568000,107900444,332445,313790,18655,0.05611454526312623,2021-11-21 00:13:29 UTC
792877,mainnet,249,107568000,107900704,332705,314034,18671,0.05611878390766595,2021-11-21 00:15:38 UTC
792878,mainnet,249,107568000,107900967,332968,314285,18683,0.05611049710482689,2021-11-21 00:17:55 UTC
792880,mainnet,249,107568000,107901242,333243,314538,18705,0.05613021128725885,2021-11-21 00:20:15 UTC
792881,mainnet,249,107568000,107901511,333512,314794,18718,0.05612391758017703,2021-11-21 00:22:37 UTC
792883,mainnet,249,107568000,107901752,333753,315020,18733,0.056128334426956465,2021-11-21 00:24:46 UTC
792885,mainnet,249,107568000,107901983,333984,315239,18745,0.05612544313500048,2021-11-21 00:27:05 UTC
792886,mainnet,249,107568000,107902205,334206,315450,18756,0.05612107502558302,2021-11-21 00:29:17 UTC
792888,mainnet,249,107568000,107902445,334446,315684,18762,0.05609874239787589,2021-11-21 00:31:24 UTC
792889,mainnet,249,107568000,107902725,334726,315944,18782,0.056111565877762705,2021-11-21 00:33:45 UTC
792891,mainnet,249,107568000,107903041,335042,316239,18803,0.05612132210290053,2021-11-21 00:36:30 UTC
792892,mainnet,249,107568000,107903299,335300,316489,18811,0.05610199821055771,2021-11-21 00:38:40 UTC
792894,mainnet,249,107568000,107903564,335565,316749,18816,0.056072593983281925,2021-11-21 00:40:50 UTC
792895,mainnet,249,107568000,107903812,335813,316989,18824,0.056055006804382204,2021-11-21 00:42:58 UTC
792897,mainnet,249,107568000,107904135,336136,317294,18842,0.056054692148416116,2021-11-21 00:45:33 UTC
792899,mainnet,249,107568000,107904408,336409,317546,18863,0.05607162709677803,2021-11-21 00:47:49 UTC
792900,mainnet,249,107568000,107904653,336654,317790,18864,0.05603379137036839,2021-11-21 00:50:00 UTC
792902,mainnet,249,107568000,107904927,336928,318044,18884,0.05604758286636908,2021-11-21 00:52:32 UTC
792903,mainnet,249,107568000,107905230,337231,318342,18889,0.05601205108664387,2021-11-21 00:54:39 UTC
792905,mainnet,249,107568000,107905537,337538,318643,18895,0.05597888237768785,2021-11-21 00:57:11 UTC
792906,mainnet,249,107568000,107905833,337834,318925,18909,0.05597127583369347,2021-11-21 00:59:35 UTC
792908,mainnet,249,107568000,107906118,338119,319206,18913,0.05593592788337834,2021-11-21 01:01:58 UTC
792909,mainnet,249,107568000,107906411,338412,319478,18934,0.05594955261633748,2021-11-21 01:04:32 UTC
792911,mainnet,249,107568000,107906688,338689,319745,18944,0.05593331935787699,2021-11-21 01:06:48 UTC
792912,mainnet,249,107568000,107907013,339014,320058,18956,0.0559150949518309,2021-11-21 01:09:28 UTC
792914,mainnet,249,107568000,107907292,339293,320303,18990,0.0559693244481908,2021-11-21 01:11:42 UTC
792915,mainnet,249,107568000,107907586,339587,320593,18994,0.0559326475984063,2021-11-21 01:14:01 UTC
792917,mainnet,249,107568000,107907862,339863,320857,19006,0.055922533491436256,2021-11-21 01:16:16 UTC
792918,mainnet,249,107568000,107908148,340149,321138,19011,0.05589021281850013,2021-11-21 01:18:32 UTC
792919,mainnet,249,107568000,107908442,340443,321418,19025,0.05588306999997063,2021-11-21 01:20:53 UTC
792921,mainnet,249,107568000,107908701,340702,321664,19038,0.05587874447464353,2021-11-21 01:23:13 UTC
792922,mainnet,249,107568000,107909000,341001,321948,19053,0.0558737364406556,2021-11-21 01:25:32 UTC
792924,mainnet,249,107568000,107909274,341275,322210,19065,0.05586403926452275,2021-11-21 01:27:43 UTC
792925,mainnet,249,107568000,107909554,341555,322480,19075,0.05584752089707368,2021-11-21 01:30:09 UTC
792927,mainnet,249,107568000,107909832,341833,322742,19091,0.055848908677629136,2021-11-21 01:32:20 UTC
792928,mainnet,249,107568000,107910138,342139,323044,19095,0.0558106500574328,2021-11-21 01:34:54 UTC
792930,mainnet,249,107568000,107910430,342431,323323,19108,0.05580102268778236,2021-11-21 01:37:03 UTC
792931,mainnet,249,107568000,107910716,342717,323600,19117,0.05578071703475462,2021-11-21 01:39:23 UTC
792933,mainnet,249,107568000,107911054,343055,323923,19132,0.05576948302750288,2021-11-21 01:42:08 UTC
792935,mainnet,249,107568000,107911316,343317,324163,19154,0.05579100364968819,2021-11-21 01:44:25 UTC
792936,mainnet,249,107568000,107911591,343592,324434,19158,0.05575799203706722,2021-11-21 01:46:31 UTC
792938,mainnet,249,107568000,107911867,343868,324697,19171,0.05575104400525783,2021-11-21 01:48:57 UTC
792939,mainnet,249,107568000,107912110,344111,324936,19175,0.055723298586793216,2021-11-21 01:50:58 UTC
792941,mainnet,249,107568000,107912391,344392,325206,19186,0.05570977258472903,2021-11-21 01:53:18 UTC
792942,mainnet,249,107568000,107912648,344649,325453,19196,0.05569724560349805,2021-11-21 01:55:20 UTC
792944,mainnet,249,107568000,107912919,344920,325705,19215,0.05570857010321234,2021-11-21 01:57:35 UTC
792945,mainnet,249,107568000,107913190,345191,325974,19217,0.05567062872438737,2021-11-21 01:59:50 UTC
792947,mainnet,249,107568000,107913476,345477,326247,19230,0.0556621714325411,2021-11-21 02:02:01 UTC
792948,mainnet,249,107568000,107913732,345733,326500,19233,0.05562963327191792,2021-11-21 02:04:06 UTC
792950,mainnet,249,107568000,107914002,346003,326766,19237,0.05559778383424421,2021-11-21 02:06:14 UTC
792951,mainnet,249,107568000,107914287,346288,327042,19246,0.05557801598669316,2021-11-21 02:08:31 UTC
792953,mainnet,249,107568000,107914543,346544,327291,19253,0.05555715868691999,2021-11-21 02:10:41 UTC
792954,mainnet,249,107568000,107914792,346793,327530,19263,0.05554610387176212,2021-11-21 02:12:45 UTC
792956,mainnet,249,107568000,107915059,347060,327779,19281,0.05555523540598167,2021-11-21 02:14:59 UTC
792957,mainnet,249,107568000,107915342,347343,328045,19298,0.05555891438721955,2021-11-21 02:17:16 UTC
792959,mainnet,249,107568000,107915619,347620,328311,19309,0.055546286174558424,2021-11-21 02:19:31 UTC
792960,mainnet,249,107568000,107915885,347886,328558,19328,0.05555843006042209,2021-11-21 02:21:48 UTC
792962,mainnet,249,107568000,107916137,348138,328805,19333,0.05553257616232644,2021-11-21 02:23:51 UTC
792963,mainnet,249,107568000,107916451,348452,329108,19344,0.055514102372780184,2021-11-21 02:26:24 UTC
792965,mainnet,249,107568000,107916742,348743,329393,19350,0.05548498464485309,2021-11-21 02:28:43 UTC
792966,mainnet,249,107568000,107916994,348995,329632,19363,0.05548217023166521,2021-11-21 02:30:54 UTC
792968,mainnet,249,107568000,107917265,349266,329891,19375,0.05547347866668957,2021-11-21 02:33:12 UTC
792969,mainnet,249,107568000,107917534,349535,330149,19386,0.055462256998583835,2021-11-21 02:35:33 UTC
792971,mainnet,249,107568000,107917814,349815,330425,19390,0.05542929834341009,2021-11-21 02:37:51 UTC
792972,mainnet,249,107568000,107918122,350123,330712,19411,0.05544051661844552,2021-11-21 02:40:33 UTC
792974,mainnet,249,107568000,107918408,350409,330978,19431,0.055452342833660094,2021-11-21 02:43:04 UTC
792975,mainnet,249,107568000,107918686,350687,331251,19436,0.055422641843011,2021-11-21 02:45:24 UTC
792977,mainnet,249,107568000,107918955,350956,331507,19449,0.05541720329613969,2021-11-21 02:47:38 UTC
792978,mainnet,249,107568000,107919204,351205,331738,19467,0.05542916530231631,2021-11-21 02:49:46 UTC
792980,mainnet,249,107568000,107919482,351483,332003,19480,0.055422310609616963,2021-11-21 02:51:58 UTC
792981,mainnet,249,107568000,107919740,351741,332243,19498,0.055432832680864616,2021-11-21 02:54:14 UTC
792983,mainnet,249,107568000,107920063,352064,332551,19513,0.055424581894201054,2021-11-21 02:56:46 UTC
792985,mainnet,249,107568000,107920332,352333,332809,19524,0.0554134866731189,2021-11-21 02:59:08 UTC
792986,mainnet,249,107568000,107920601,352602,333044,19558,0.055467637733194936,2021-11-21 03:01:27 UTC
792988,mainnet,249,107568000,107920894,352895,333303,19592,0.05551793026254268,2021-11-21 03:03:51 UTC
792989,mainnet,249,107568000,107921133,353134,333525,19609,0.05552849626487396,2021-11-21 03:06:09 UTC
792991,mainnet,249,107568000,107921375,353376,333755,19621,0.05552442723897492,2021-11-21 03:08:12 UTC
792992,mainnet,249,107568000,107921663,353664,334025,19639,0.0555301076728194,2021-11-21 03:10:28 UTC
792994,mainnet,249,107568000,107921924,353925,334264,19661,0.05555131736949919,2021-11-21 03:12:51 UTC
792995,mainnet,249,107568000,107922185,354186,334517,19669,0.055532968553246034,2021-11-21 03:15:01 UTC
792997,mainnet,249,107568000,107922480,354481,334812,19669,0.0554867538739735,2021-11-21 03:17:28 UTC
792998,mainnet,249,107568000,107922736,354737,335055,19682,0.05548335809346079,2021-11-21 03:19:35 UTC
793000,mainnet,249,107568000,107922990,354991,335303,19688,0.055460560971968303,2021-11-21 03:21:37 UTC
793001,mainnet,249,107568000,107923254,355255,335555,19700,0.055453125219912455,2021-11-21 03:23:56 UTC
793003,mainnet,249,107568000,107923540,355541,335829,19712,0.05544226966791453,2021-11-21 03:26:00 UTC
793004,mainnet,249,107568000,107923803,355804,336072,19732,0.05545749907252307,2021-11-21 03:28:10 UTC
793005,mainnet,249,107568000,107924051,356052,336311,19741,0.055444148607506766,2021-11-21 03:30:13 UTC
793007,mainnet,249,107568000,107924320,356321,336571,19750,0.055427549877778745,2021-11-21 03:32:28 UTC
793008,mainnet,249,107568000,107924576,356577,336818,19759,0.05541299635141919,2021-11-21 03:34:34 UTC
793010,mainnet,249,107568000,107924852,356853,337088,19765,0.05538695205028401,2021-11-21 03:36:43 UTC
793011,mainnet,249,107568000,107925119,357120,337343,19777,0.05537914426523297,2021-11-21 03:38:52 UTC
793012,mainnet,249,107568000,107925386,357387,337599,19788,0.055368550059179546,2021-11-21 03:41:10 UTC
793014,mainnet,249,107568000,107925628,357629,337833,19796,0.05535345287993983,2021-11-21 03:43:26 UTC
793015,mainnet,249,107568000,107925899,357900,338080,19820,0.05537859737356803,2021-11-21 03:45:36 UTC
793017,mainnet,249,107568000,107926139,358140,338311,19829,0.05536661640699168,2021-11-21 03:47:47 UTC
793018,mainnet,249,107568000,107926403,358404,338547,19857,0.055403957545116685,2021-11-21 03:49:59 UTC
793020,mainnet,249,107568000,107926646,358647,338779,19868,0.055397089617367494,2021-11-21 03:52:12 UTC
793021,mainnet,249,107568000,107926947,358948,339071,19877,0.05537570901634777,2021-11-21 03:54:34 UTC
793022,mainnet,249,107568000,107927222,359223,339336,19887,0.055361154491778086,2021-11-21 03:56:49 UTC
793024,mainnet,249,107568000,107927475,359476,339581,19895,0.055344445804448694,2021-11-21 03:58:55 UTC
793025,mainnet,249,107568000,107927743,359744,339846,19898,0.05531155488347269,2021-11-21 04:01:09 UTC
793027,mainnet,249,107568000,107928019,360020,340118,19902,0.05528026220765513,2021-11-21 04:03:24 UTC
793028,mainnet,249,107568000,107928276,360277,340365,19912,0.055268585005426384,2021-11-21 04:05:36 UTC
793030,mainnet,249,107568000,107928533,360534,340618,19916,0.055240282469891884,2021-11-21 04:07:47 UTC
793031,mainnet,249,107568000,107928800,360801,340865,19936,0.055254835768193546,2021-11-21 04:09:56 UTC
793033,mainnet,249,107568000,107929063,361064,341114,19950,0.055253362284802696,2021-11-21 04:12:00 UTC
793034,mainnet,249,107568000,107929300,361301,341341,19960,0.055244795890407164,2021-11-21 04:14:01 UTC
793036,mainnet,249,107568000,107929565,361566,341597,19969,0.055229197435599585,2021-11-21 04:16:15 UTC
793037,mainnet,249,107568000,107929823,361824,341822,20002,0.05528102060670381,2021-11-21 04:18:30 UTC
793039,mainnet,249,107568000,107930138,362139,342118,20021,0.05528540146186962,2021-11-21 04:21:00 UTC
793040,mainnet,249,107568000,107930440,362441,342408,20033,0.05527244434266543,2021-11-21 04:23:28 UTC
793042,mainnet,249,107568000,107930705,362706,342658,20048,0.05527341703749042,2021-11-21 04:25:47 UTC
793043,mainnet,249,107568000,107930978,362979,342928,20051,0.05524011030941184,2021-11-21 04:27:57 UTC
793045,mainnet,249,107568000,107931243,363244,343183,20061,0.0552273403001839,2021-11-21 04:30:05 UTC
793046,mainnet,249,107568000,107931500,363501,343428,20073,0.05522130613120734,2021-11-21 04:32:16 UTC
793048,mainnet,249,107568000,107931803,363804,343710,20094,0.05523303756968038,2021-11-21 04:34:48 UTC
793049,mainnet,249,107568000,107932061,364062,343962,20100,0.055210376254594,2021-11-21 04:37:05 UTC
793051,mainnet,249,107568000,107932369,364370,344248,20122,0.055224085407689985,2021-11-21 04:39:30 UTC
793052,mainnet,249,107568000,107932696,364697,344559,20138,0.05521844161043277,2021-11-21 04:42:07 UTC
793054,mainnet,249,107568000,107932956,364957,344809,20148,0.05520650377989736,2021-11-21 04:44:17 UTC
793055,mainnet,249,107568000,107933215,365216,345060,20156,0.055189257863839485,2021-11-21 04:46:24 UTC
793057,mainnet,249,107568000,107933484,365485,345311,20174,0.05519788773821087,2021-11-21 04:48:40 UTC
793058,mainnet,249,107568000,107933739,365740,345558,20182,0.055181276316508994,2021-11-21 04:50:45 UTC
793060,mainnet,249,107568000,107934014,366015,345828,20187,0.05515347731650342,2021-11-21 04:52:58 UTC
793061,mainnet,249,107568000,107934275,366276,346084,20192,0.05512782710305889,2021-11-21 04:55:04 UTC
793063,mainnet,249,107568000,107934540,366541,346344,20197,0.055101612097964485,2021-11-21 04:57:14 UTC
793064,mainnet,249,107568000,107934849,366850,346645,20205,0.05507700695106992,2021-11-21 04:59:42 UTC
793066,mainnet,249,107568000,107935183,367184,346968,20216,0.055056865222885526,2021-11-21 05:02:28 UTC
793067,mainnet,249,107568000,107935480,367481,347256,20225,0.05503685904849502,2021-11-21 05:04:51 UTC
793069,mainnet,249,107568000,107935737,367738,347508,20230,0.0550119922336011,2021-11-21 05:07:03 UTC
793070,mainnet,249,107568000,107936032,368033,347788,20245,0.05500865411525597,2021-11-21 05:09:29 UTC
793072,mainnet,249,107568000,107936324,368325,348073,20252,0.054984049412882645,2021-11-21 05:11:52 UTC
793074,mainnet,249,107568000,107936646,368647,348382,20265,0.05497128689505136,2021-11-21 05:14:23 UTC
793075,mainnet,249,107568000,107936909,368910,348640,20270,0.05494565070071291,2021-11-21 05:16:33 UTC
793077,mainnet,249,107568000,107937184,369185,348911,20274,0.05491555724094966,2021-11-21 05:18:50 UTC
793078,mainnet,249,107568000,107937471,369472,349188,20284,0.05489996535596744,2021-11-21 05:21:05 UTC
793080,mainnet,249,107568000,107937742,369743,349454,20289,0.05487324979783255,2021-11-21 05:23:22 UTC
793081,mainnet,249,107568000,107938009,370010,349713,20297,0.05485527418177887,2021-11-21 05:25:44 UTC
793083,mainnet,249,107568000,107938300,370301,350000,20301,0.05482296834197045,2021-11-21 05:28:02 UTC
793084,mainnet,249,107568000,107938631,370632,350329,20303,0.0547794038291351,2021-11-21 05:30:42 UTC
793086,mainnet,249,107568000,107938885,370886,350569,20317,0.054779635791051697,2021-11-21 05:33:00 UTC
793087,mainnet,249,107568000,107939136,371137,350811,20326,0.054766838121771744,2021-11-21 05:35:10 UTC
793089,mainnet,249,107568000,107939407,371408,351073,20335,0.05475110929220695,2021-11-21 05:37:20 UTC
793090,mainnet,249,107568000,107939690,371691,351350,20341,0.05472556505269162,2021-11-21 05:39:42 UTC
793092,mainnet,249,107568000,107939972,371973,351626,20347,0.054700206735435096,2021-11-21 05:42:05 UTC
793093,mainnet,249,107568000,107940252,372253,351903,20350,0.05466712155442669,2021-11-21 05:44:30 UTC
793095,mainnet,249,107568000,107940515,372516,352160,20356,0.05464463271376263,2021-11-21 05:46:39 UTC
793096,mainnet,249,107568000,107940790,372791,352427,20364,0.05462578227478668,2021-11-21 05:48:49 UTC
793098,mainnet,249,107568000,107941072,373073,352709,20364,0.054584491507024095,2021-11-21 05:51:02 UTC
793099,mainnet,249,107568000,107941348,373349,352971,20378,0.054581638091972924,2021-11-21 05:53:20 UTC
793101,mainnet,249,107568000,107941626,373627,353240,20387,0.0545651144055435,2021-11-21 05:55:35 UTC
793102,mainnet,249,107568000,107941901,373902,353513,20389,0.054530331477232005,2021-11-21 05:57:50 UTC
793104,mainnet,249,107568000,107942193,374194,353801,20393,0.05449846870874466,2021-11-21 06:00:09 UTC
793105,mainnet,249,107568000,107942464,374465,354066,20399,0.054475051072863954,2021-11-21 06:02:25 UTC
793106,mainnet,249,107568000,107942735,374736,354332,20404,0.05444899876179497,2021-11-21 06:04:34 UTC
793108,mainnet,249,107568000,107943000,375001,354590,20411,0.054429188188831495,2021-11-21 06:06:44 UTC
793109,mainnet,249,107568000,107943296,375297,354874,20423,0.05441823409193252,2021-11-21 06:09:02 UTC
793111,mainnet,249,107568000,107943562,375563,355139,20424,0.054382353959255836,2021-11-21 06:11:10 UTC
793112,mainnet,249,107568000,107943846,375847,355419,20428,0.054351903833208724,2021-11-21 06:13:21 UTC
793114,mainnet,249,107568000,107944121,376122,355693,20429,0.05431482338177506,2021-11-21 06:15:32 UTC
793115,mainnet,249,107568000,107944379,376380,355936,20444,0.05431744513523567,2021-11-21 06:17:43 UTC
793117,mainnet,249,107568000,107944676,376677,356200,20477,0.054362225461071424,2021-11-21 06:20:08 UTC
793118,mainnet,249,107568000,107944941,376942,356448,20494,0.05436910718359854,2021-11-21 06:22:20 UTC
793120,mainnet,249,107568000,107945216,377217,356714,20503,0.05435332978100139,2021-11-21 06:24:35 UTC
793121,mainnet,249,107568000,107945499,377500,356993,20507,0.05432317880794702,2021-11-21 06:26:56 UTC
793122,mainnet,249,107568000,107945840,377841,357312,20529,0.054332377904991784,2021-11-21 06:29:37 UTC
793124,mainnet,249,107568000,107946093,378094,357543,20551,0.05435420821277249,2021-11-21 06:31:50 UTC
793125,mainnet,249,107568000,107946372,378373,357806,20567,0.054356415494763104,2021-11-21 06:34:06 UTC
793127,mainnet,249,107568000,107946620,378621,358049,20572,0.05433401739470341,2021-11-21 06:36:16 UTC
793128,mainnet,249,107568000,107946931,378932,358353,20579,0.05430789693137555,2021-11-21 06:38:45 UTC
793130,mainnet,249,107568000,107947204,379205,358620,20585,0.05428462177450192,2021-11-21 06:40:56 UTC
793131,mainnet,249,107568000,107947476,379477,358879,20598,0.05427996953702069,2021-11-21 06:43:11 UTC
793133,mainnet,249,107568000,107947740,379741,359139,20602,0.05425276701751983,2021-11-21 06:45:23 UTC
793134,mainnet,249,107568000,107948035,380036,359432,20604,0.05421591638686861,2021-11-21 06:47:50 UTC
793136,mainnet,249,107568000,107948323,380324,359714,20610,0.05419063745648447,2021-11-21 06:50:31 UTC
793138,mainnet,249,107568000,107948664,380665,360045,20620,0.054168363259033535,2021-11-21 06:52:58 UTC
793139,mainnet,249,107568000,107948952,380953,360324,20629,0.05415103700456487,2021-11-21 06:55:20 UTC
793141,mainnet,249,107568000,107949210,381211,360579,20632,0.05412225775226843,2021-11-21 06:57:32 UTC
793142,mainnet,249,107568000,107949495,381496,360849,20647,0.0541211441273303,2021-11-21 07:00:13 UTC
793144,mainnet,249,107568000,107949830,381831,361168,20663,0.054115564215582286,2021-11-21 07:02:45 UTC
793145,mainnet,249,107568000,107950109,382110,361434,20676,0.054110073015623775,2021-11-21 07:04:59 UTC
793147,mainnet,249,107568000,107950380,382381,361704,20677,0.05407433946770368,2021-11-21 07:07:24 UTC
793148,mainnet,249,107568000,107950709,382710,362002,20708,0.05410885526900264,2021-11-21 07:10:07 UTC
793150,mainnet,249,107568000,107951015,383016,362283,20733,0.05413089792593521,2021-11-21 07:12:42 UTC
793151,mainnet,249,107568000,107951290,383291,362552,20739,0.0541077145041235,2021-11-21 07:14:50 UTC
793153,mainnet,249,107568000,107951560,383561,362807,20754,0.05410873368251725,2021-11-21 07:16:55 UTC
793154,mainnet,249,107568000,107951828,383829,363066,20763,0.05409440141312928,2021-11-21 07:19:03 UTC
793156,mainnet,249,107568000,107952108,384109,363337,20772,0.05407839962094093,2021-11-21 07:21:19 UTC
793157,mainnet,249,107568000,107952356,384357,363583,20774,0.05404870992332649,2021-11-21 07:23:27 UTC
793159,mainnet,249,107568000,107952621,384622,363831,20791,0.05405567024247183,2021-11-21 07:25:29 UTC
793160,mainnet,249,107568000,107952889,384890,364080,20810,0.05406739587934215,2021-11-21 07:27:44 UTC
793162,mainnet,249,107568000,107953155,385156,364337,20819,0.0540534225093209,2021-11-21 07:29:53 UTC
793163,mainnet,249,107568000,107953474,385475,364635,20840,0.05406316881769246,2021-11-21 07:32:26 UTC
793165,mainnet,249,107568000,107953775,385776,364921,20855,0.0540598689394882,2021-11-21 07:35:01 UTC
793166,mainnet,249,107568000,107954091,386092,365210,20882,0.054085554738248914,2021-11-21 07:37:39 UTC
793168,mainnet,249,107568000,107954346,386347,365460,20887,0.05406279846873407,2021-11-21 07:39:50 UTC
793169,mainnet,249,107568000,107954627,386628,365739,20889,0.05402867872994196,2021-11-21 07:42:14 UTC
793171,mainnet,249,107568000,107954959,386960,366060,20900,0.054010750465164355,2021-11-21 07:44:53 UTC
793173,mainnet,249,107568000,107955238,387239,366326,20913,0.05400540751318953,2021-11-21 07:47:04 UTC
793174,mainnet,249,107568000,107955525,387526,366607,20919,0.05398089418516435,2021-11-21 07:49:28 UTC
793176,mainnet,249,107568000,107955868,387869,366945,20924,0.053946048794825056,2021-11-21 07:52:15 UTC
793177,mainnet,249,107568000,107956150,388151,367223,20928,0.05391716110482776,2021-11-21 07:54:28 UTC
793179,mainnet,249,107568000,107956450,388451,367519,20932,0.053885818288535746,2021-11-21 07:56:51 UTC
793180,mainnet,249,107568000,107956706,388707,367765,20942,0.05387605574378645,2021-11-21 07:59:10 UTC
793182,mainnet,249,107568000,107956995,388996,368054,20942,0.05383602916225359,2021-11-21 08:01:26 UTC
793183,mainnet,249,107568000,107957254,389255,368303,20952,0.053825898190132435,2021-11-21 08:03:37 UTC
793185,mainnet,249,107568000,107957531,389532,368579,20953,0.05379018925274432,2021-11-21 08:05:53 UTC
793186,mainnet,249,107568000,107957793,389794,368828,20966,0.053787385131633635,2021-11-21 08:08:06 UTC
793188,mainnet,249,107568000,107958048,390049,369073,20976,0.05377785867929414,2021-11-21 08:10:16 UTC
793189,mainnet,249,107568000,107958321,390322,369328,20994,0.05378636100450397,2021-11-21 08:12:45 UTC
793191,mainnet,249,107568000,107958618,390619,369608,21011,0.053788986198828014,2021-11-21 08:14:57 UTC
793192,mainnet,249,107568000,107958892,390893,369873,21020,0.053774306523780166,2021-11-21 08:17:14 UTC
793194,mainnet,249,107568000,107959168,391169,370122,21047,0.05380538846380976,2021-11-21 08:19:26 UTC
793195,mainnet,249,107568000,107959456,391457,370397,21060,0.05379901240749303,2021-11-21 08:21:49 UTC
793197,mainnet,249,107568000,107959731,391732,370664,21068,0.05378166705809074,2021-11-21 08:24:00 UTC
793198,mainnet,249,107568000,107960008,392009,370932,21077,0.05376662270509096,2021-11-21 08:26:14 UTC
793200,mainnet,249,107568000,107960253,392254,371166,21088,0.053761083379646864,2021-11-21 08:28:27 UTC
793201,mainnet,249,107568000,107960549,392550,371439,21111,0.053779136415743216,2021-11-21 08:30:41 UTC
793203,mainnet,249,107568000,107960835,392836,371710,21126,0.05377816697044059,2021-11-21 08:33:05 UTC
793204,mainnet,249,107568000,107961173,393174,372032,21142,0.0537726299297512,2021-11-21 08:35:43 UTC
793206,mainnet,249,107568000,107961427,393428,372277,21151,0.05376078977602001,2021-11-21 08:37:56 UTC
793207,mainnet,249,107568000,107961703,393704,372541,21163,0.053753581370776016,2021-11-21 08:40:08 UTC
793209,mainnet,249,107568000,107961975,393976,372799,21177,0.05375200519828619,2021-11-21 08:42:37 UTC
793210,mainnet,249,107568000,107962302,394303,373108,21195,0.05375307821649848,2021-11-21 08:45:09 UTC
793212,mainnet,249,107568000,107962571,394572,373362,21210,0.05375444785742526,2021-11-21 08:47:30 UTC
793213,mainnet,249,107568000,107962820,394821,373597,21224,0.053756005886211725,2021-11-21 08:49:47 UTC
793215,mainnet,249,107568000,107963156,395157,373913,21244,0.05376091022049464,2021-11-21 08:52:27 UTC
793216,mainnet,249,107568000,107963447,395448,374189,21259,0.05375928061338027,2021-11-21 08:54:59 UTC
793218,mainnet,249,107568000,107963744,395745,374474,21271,0.05374925772909323,2021-11-21 08:57:25 UTC
793220,mainnet,249,107568000,107964016,396017,374732,21285,0.05374769264955798,2021-11-21 08:59:45 UTC
793221,mainnet,249,107568000,107964318,396319,375028,21291,0.05372187555983942,2021-11-21 09:02:21 UTC
793223,mainnet,249,107568000,107964582,396583,375285,21298,0.053703764407450644,2021-11-21 09:04:36 UTC
793224,mainnet,249,107568000,107964871,396872,375569,21303,0.05367725614303856,2021-11-21 09:07:05 UTC
793226,mainnet,249,107568000,107965157,397158,375846,21312,0.05366126327557295,2021-11-21 09:09:13 UTC
793227,mainnet,249,107568000,107965458,397459,376128,21331,0.053668428693274026,2021-11-21 09:11:40 UTC
793229,mainnet,249,107568000,107965762,397763,376413,21350,0.05367517843539998,2021-11-21 09:14:13 UTC
793230,mainnet,249,107568000,107966036,398037,376687,21350,0.05363822961182001,2021-11-21 09:16:36 UTC
793232,mainnet,249,107568000,107966363,398364,376998,21366,0.05363436455101365,2021-11-21 09:19:07 UTC
793233,mainnet,249,107568000,107966650,398651,377276,21375,0.05361832781054105,2021-11-21 09:21:23 UTC
793235,mainnet,249,107568000,107966929,398930,377538,21392,0.05362344270924724,2021-11-21 09:23:42 UTC
793236,mainnet,249,107568000,107967210,399211,377805,21406,0.05362076696283419,2021-11-21 09:26:07 UTC
793238,mainnet,249,107568000,107967509,399510,378099,21411,0.05359315161072314,2021-11-21 09:28:25 UTC
793239,mainnet,249,107568000,107967777,399778,378353,21425,0.05359224369525086,2021-11-21 09:30:38 UTC
793241,mainnet,249,107568000,107968058,400059,378624,21435,0.05357959700944111,2021-11-21 09:32:47 UTC
793242,mainnet,249,107568000,107968324,400325,378883,21442,0.05356148129644664,2021-11-21 09:35:02 UTC
793244,mainnet,249,107568000,107968597,400598,379147,21451,0.053547446567381765,2021-11-21 09:37:16 UTC
793245,mainnet,249,107568000,107968902,400903,379443,21460,0.0535291579259821,2021-11-21 09:39:37 UTC
793247,mainnet,249,107568000,107969172,401173,379699,21474,0.05352802905479681,2021-11-21 09:41:53 UTC
793248,mainnet,249,107568000,107969454,401455,379970,21485,0.05351782889738576,2021-11-21 09:44:12 UTC
793250,mainnet,249,107568000,107969718,401719,380230,21489,0.05349261548495341,2021-11-21 09:46:19 UTC
793251,mainnet,249,107568000,107970020,402021,380518,21503,0.05348725564087448,2021-11-21 09:48:47 UTC
793253,mainnet,249,107568000,107970287,402288,380775,21513,0.05347661376923995,2021-11-21 09:51:14 UTC
793254,mainnet,249,107568000,107970571,402572,381047,21525,0.05346869628290095,2021-11-21 09:53:32 UTC
793256,mainnet,249,107568000,107970827,402828,381301,21527,0.05343968145213342,2021-11-21 09:55:41 UTC
793257,mainnet,249,107568000,107971096,403097,381562,21535,0.05342386571966549,2021-11-21 09:57:54 UTC
793259,mainnet,249,107568000,107971400,403401,381854,21547,0.053413352966403156,2021-11-21 10:00:24 UTC
793260,mainnet,249,107568000,107971672,403673,382124,21549,0.05338231687529262,2021-11-21 10:02:35 UTC
793262,mainnet,249,107568000,107971937,403938,382379,21559,0.05337205214661656,2021-11-21 10:04:49 UTC
793263,mainnet,249,107568000,107972189,404190,382625,21565,0.05335362082189069,2021-11-21 10:07:07 UTC
793265,mainnet,249,107568000,107972502,404503,382919,21584,0.053359307594752076,2021-11-21 10:09:34 UTC
793266,mainnet,249,107568000,107972802,404803,383206,21597,0.0533518773329249,2021-11-21 10:12:02 UTC
793268,mainnet,249,107568000,107973088,405089,383491,21598,0.05331667855705783,2021-11-21 10:14:22 UTC
793269,mainnet,249,107568000,107973384,405385,383782,21603,0.05329008226747413,2021-11-21 10:16:49 UTC
793271,mainnet,249,107568000,107973644,405645,384037,21608,0.05326825179652159,2021-11-21 10:18:57 UTC
793272,mainnet,249,107568000,107973926,405927,384302,21625,0.0532731254634454,2021-11-21 10:21:08 UTC
793273,mainnet,249,107568000,107974198,406199,384566,21633,0.05325714735880689,2021-11-21 10:23:21 UTC
793275,mainnet,249,107568000,107974478,406479,384834,21645,0.053249983393976075,2021-11-21 10:25:38 UTC
793276,mainnet,249,107568000,107974729,406730,385084,21646,0.05321958055712635,2021-11-21 10:27:46 UTC
793278,mainnet,249,107568000,107975036,407037,385366,21671,0.0532408601675032,2021-11-21 10:30:12 UTC
793279,mainnet,249,107568000,107975340,407341,385662,21679,0.05322076589393162,2021-11-21 10:32:48 UTC
793281,mainnet,249,107568000,107975630,407631,385942,21689,0.05320743515581494,2021-11-21 10:35:16 UTC
793282,mainnet,249,107568000,107975885,407886,386167,21719,0.053247721176995534,2021-11-21 10:37:27 UTC
793284,mainnet,249,107568000,107976179,408180,386440,21740,0.053260816306531435,2021-11-21 10:39:45 UTC
793285,mainnet,249,107568000,107976449,408450,386704,21746,0.053240298690170156,2021-11-21 10:42:16 UTC
793287,mainnet,249,107568000,107976690,408691,386936,21755,0.05323092507542373,2021-11-21 10:44:23 UTC
793288,mainnet,249,107568000,107976951,408952,387183,21769,0.053231186056065256,2021-11-21 10:46:43 UTC
793290,mainnet,249,107568000,107977222,409223,387450,21773,0.05320570935651222,2021-11-21 10:48:55 UTC
793291,mainnet,249,107568000,107977524,409525,387740,21785,0.0531957755936756,2021-11-21 10:51:25 UTC
793293,mainnet,249,107568000,107977795,409796,387999,21797,0.053189879842653415,2021-11-21 10:53:41 UTC
793294,mainnet,249,107568000,107978074,410075,388270,21805,0.05317320002438578,2021-11-21 10:55:58 UTC
793296,mainnet,249,107568000,107978348,410349,388543,21806,0.053140131936473586,2021-11-21 10:58:35 UTC
793297,mainnet,249,107568000,107978668,410669,388848,21821,0.05313525004322216,2021-11-21 11:00:53 UTC
793299,mainnet,249,107568000,107978922,410923,389082,21841,0.05315107696575758,2021-11-21 11:03:14 UTC
793300,mainnet,249,107568000,107979199,411200,389342,21858,0.05315661478599222,2021-11-21 11:05:30 UTC
793302,mainnet,249,107568000,107979456,411457,389595,21862,0.05313313420357413,2021-11-21 11:07:39 UTC
793303,mainnet,249,107568000,107979697,411698,389835,21863,0.053104460065387736,2021-11-21 11:09:42 UTC
793305,mainnet,249,107568000,107979948,411949,390078,21871,0.05309152346528333,2021-11-21 11:11:48 UTC
793306,mainnet,249,107568000,107980214,412215,390330,21885,0.0530912266656963,2021-11-21 11:13:58 UTC
793308,mainnet,249,107568000,107980480,412481,390595,21886,0.053059413645719436,2021-11-21 11:16:11 UTC
793309,mainnet,249,107568000,107980725,412726,390839,21887,0.05303033974113577,2021-11-21 11:18:25 UTC
793311,mainnet,249,107568000,107980996,412997,391094,21903,0.0530342835420112,2021-11-21 11:20:35 UTC
793312,mainnet,249,107568000,107981260,413261,391348,21913,0.05302460188597521,2021-11-21 11:22:49 UTC
793314,mainnet,249,107568000,107981519,413520,391602,21918,0.05300348229831689,2021-11-21 11:24:58 UTC
793315,mainnet,249,107568000,107981772,413773,391850,21923,0.05298315743173189,2021-11-21 11:27:09 UTC
793316,mainnet,249,107568000,107982034,414035,392104,21931,0.05296895190020167,2021-11-21 11:29:25 UTC
793318,mainnet,249,107568000,107982282,414283,392342,21941,0.052961381471119985,2021-11-21 11:31:26 UTC
793319,mainnet,249,107568000,107982550,414551,392597,21954,0.052958502090213265,2021-11-21 11:33:36 UTC
793320,mainnet,249,107568000,107982833,414834,392874,21960,0.052936837385556636,2021-11-21 11:35:54 UTC
793322,mainnet,249,107568000,107983129,415130,393153,21977,0.05294004287813456,2021-11-21 11:38:31 UTC
793324,mainnet,249,107568000,107983453,415454,393464,21990,0.05293004761056579,2021-11-21 11:41:02 UTC
793325,mainnet,249,107568000,107983719,415720,393718,22002,0.05292504570383912,2021-11-21 11:43:21 UTC
793327,mainnet,249,107568000,107984011,416012,393980,22032,0.05296001076892013,2021-11-21 11:45:48 UTC
793328,mainnet,249,107568000,107984327,416328,394280,22048,0.05295824446109798,2021-11-21 11:48:11 UTC
793330,mainnet,249,107568000,107984609,416610,394548,22062,0.05295600201627421,2021-11-21 11:50:25 UTC
793331,mainnet,249,107568000,107984852,416853,394787,22066,0.05293472758982183,2021-11-21 11:52:37 UTC
793333,mainnet,249,107568000,107985147,417148,395074,22074,0.052916470892824606,2021-11-21 11:54:50 UTC
793334,mainnet,249,107568000,107985443,417444,395356,22088,0.05291248646525043,2021-11-21 11:57:18 UTC
793336,mainnet,249,107568000,107985763,417764,395675,22089,0.05287435011154623,2021-11-21 12:00:09 UTC
793337,mainnet,249,107568000,107986065,418066,395956,22110,0.052886386360048415,2021-11-21 12:02:18 UTC
793339,mainnet,249,107568000,107986328,418329,396209,22120,0.052877041754217376,2021-11-21 12:04:26 UTC
793340,mainnet,249,107568000,107986597,418598,396469,22129,0.05286456218137688,2021-11-21 12:06:39 UTC
793341,mainnet,249,107568000,107986853,418854,396724,22130,0.05283463927764806,2021-11-21 12:08:52 UTC
793343,mainnet,249,107568000,107987136,419137,396958,22179,0.052915872375858014,2021-11-21 12:11:18 UTC
793344,mainnet,249,107568000,107987403,419404,397219,22185,0.05289649121133799,2021-11-21 12:13:27 UTC
793346,mainnet,249,107568000,107987734,419735,397536,22199,0.05288813179744362,2021-11-21 12:16:09 UTC
793347,mainnet,249,107568000,107987986,419987,397776,22211,0.052884970249079136,2021-11-21 12:18:37 UTC
793349,mainnet,249,107568000,107988268,420269,398051,22218,0.052866140495730116,2021-11-21 12:20:42 UTC
793350,mainnet,249,107568000,107988522,420523,398295,22228,0.05285798874258958,2021-11-21 12:22:49 UTC
793352,mainnet,249,107568000,107988808,420809,398570,22239,0.05284820429220858,2021-11-21 12:25:07 UTC
793353,mainnet,249,107568000,107989100,421101,398848,22253,0.05284480445308845,2021-11-21 12:27:26 UTC
793355,mainnet,249,107568000,107989380,421381,399119,22262,0.05283104838613986,2021-11-21 12:29:46 UTC
793356,mainnet,249,107568000,107989608,421609,399332,22277,0.052838056113602885,2021-11-21 12:31:48 UTC
793358,mainnet,249,107568000,107989853,421854,399568,22286,0.0528287037695506,2021-11-21 12:33:56 UTC
793359,mainnet,249,107568000,107990167,422168,399875,22293,0.05280599192738436,2021-11-21 12:36:38 UTC
793361,mainnet,249,107568000,107990418,422419,400119,22300,0.05279118600252356,2021-11-21 12:38:41 UTC
793362,mainnet,249,107568000,107990683,422684,400370,22314,0.05279121045509175,2021-11-21 12:41:13 UTC
793364,mainnet,249,107568000,107990973,422974,400645,22329,0.052790478847399604,2021-11-21 12:43:23 UTC
793365,mainnet,249,107568000,107991235,423236,400898,22338,0.052779064162783884,2021-11-21 12:45:47 UTC
793367,mainnet,249,107568000,107991505,423506,401160,22346,0.05276430558244748,2021-11-21 12:47:56 UTC
793368,mainnet,249,107568000,107991765,423766,401414,22352,0.05274609100305357,2021-11-21 12:50:15 UTC
793370,mainnet,249,107568000,107992034,424035,401673,22362,0.0527362128126216,2021-11-21 12:52:23 UTC
793371,mainnet,249,107568000,107992306,424307,401928,22379,0.05274247184232172,2021-11-21 12:54:34 UTC
793373,mainnet,249,107568000,107992544,424545,402162,22383,0.0527223262551673,2021-11-21 12:56:37 UTC
793374,mainnet,249,107568000,107992828,424829,402427,22402,0.052731805032142344,2021-11-21 12:58:58 UTC
793376,mainnet,249,107568000,107993096,425097,402689,22408,0.05271267498947299,2021-11-21 13:01:12 UTC
793377,mainnet,249,107568000,107993389,425390,402973,22417,0.052697524624462255,2021-11-21 13:03:39 UTC
793379,mainnet,249,107568000,107993652,425653,403225,22428,0.052690806830916266,2021-11-21 13:05:50 UTC
793380,mainnet,249,107568000,107993917,425918,403481,22437,0.05267915420339126,2021-11-21 13:08:18 UTC
793382,mainnet,249,107568000,107994223,426224,403779,22445,0.05266010360749277,2021-11-21 13:10:37 UTC
793383,mainnet,249,107568000,107994487,426488,404036,22452,0.05264391964134982,2021-11-21 13:12:53 UTC
793385,mainnet,249,107568000,107994880,426881,404420,22461,0.05261653716141032,2021-11-21 13:16:09 UTC
793386,mainnet,249,107568000,107995142,427143,404673,22470,0.05260533357681151,2021-11-21 13:18:29 UTC
793388,mainnet,249,107568000,107995416,427417,404940,22477,0.052587987843253775,2021-11-21 13:20:47 UTC
793389,mainnet,249,107568000,107995665,427666,405178,22488,0.052583090542619705,2021-11-21 13:23:02 UTC
793391,mainnet,249,107568000,107995933,427934,405425,22509,0.05259923259194175,2021-11-21 13:25:32 UTC
793392,mainnet,249,107568000,107996268,428269,405745,22524,0.052593113206886324,2021-11-21 13:28:06 UTC
793394,mainnet,249,107568000,107996550,428551,406006,22545,0.052607507624530106,2021-11-21 13:30:25 UTC
793395,mainnet,249,107568000,107996798,428799,406249,22550,0.052588742044640965,2021-11-21 13:32:37 UTC
793397,mainnet,249,107568000,107997063,429064,406501,22563,0.05258656051311692,2021-11-21 13:35:00 UTC
793398,mainnet,249,107568000,107997328,429329,406752,22577,0.05258671089071551,2021-11-21 13:37:12 UTC
793400,mainnet,249,107568000,107997577,429578,406984,22594,0.052595803323261435,2021-11-21 13:39:19 UTC
793401,mainnet,249,107568000,107997826,429827,407222,22605,0.05259092611678652,2021-11-21 13:41:29 UTC
793403,mainnet,249,107568000,107998106,430107,407489,22618,0.05258691441897016,2021-11-21 13:43:49 UTC
793404,mainnet,249,107568000,107998389,430390,407758,22632,0.052584864889983506,2021-11-21 13:46:08 UTC
793406,mainnet,249,107568000,107998655,430656,408010,22646,0.05258489374349829,2021-11-21 13:48:29 UTC
793407,mainnet,249,107568000,107998942,430943,408284,22659,0.05258003958760207,2021-11-21 13:51:01 UTC
793409,mainnet,249,107568000,107999261,431262,408578,22684,0.052599116082566975,2021-11-21 13:53:38 UTC
793410,mainnet,249,107568000,107999528,431529,408840,22689,0.052578158130739766,2021-11-21 13:55:54 UTC
793412,mainnet,249,107568000,107999828,431829,409123,22706,0.05258099849709028,2021-11-21 13:58:34 UTC
793414,mainnet,249,107568000,107999964,431965,409231,22734,0.05262926394499554,2021-11-21 14:00:51 UTC
793418,mainnet,250,108000000,108001150,1151,970,181,0.157254561251086,2021-11-21 14:12:02 UTC
793419,mainnet,250,108000000,108001367,1368,1177,191,0.13961988304093567,2021-11-21 14:13:54 UTC
793420,mainnet,250,108000000,108001591,1592,1395,197,0.12374371859296482,2021-11-21 14:15:51 UTC
793422,mainnet,250,108000000,108001820,1821,1614,207,0.11367380560131796,2021-11-21 14:17:50 UTC
793423,mainnet,250,108000000,108002050,2051,1828,223,0.10872745002437835,2021-11-21 14:19:51 UTC
793424,mainnet,250,108000000,108002251,2252,2013,239,0.10612788632326821,2021-11-21 14:21:54 UTC
793426,mainnet,250,108000000,108002573,2574,2310,264,0.10256410256410256,2021-11-21 14:24:03 UTC
793427,mainnet,250,108000000,108002798,2799,2529,270,0.09646302250803858,2021-11-21 14:26:01 UTC
793429,mainnet,250,108000000,108003027,3028,2738,290,0.09577278731836196,2021-11-21 14:27:52 UTC
793430,mainnet,250,108000000,108003269,3270,2962,308,0.09418960244648318,2021-11-21 14:29:52 UTC
793432,mainnet,250,108000000,108003505,3506,3187,319,0.09098687963491157,2021-11-21 14:31:49 UTC
793433,mainnet,250,108000000,108003779,3780,3451,329,0.08703703703703704,2021-11-21 14:34:08 UTC
793435,mainnet,250,108000000,108004018,4019,3670,349,0.08683752177158498,2021-11-21 14:36:07 UTC
793436,mainnet,250,108000000,108004263,4264,3896,368,0.08630393996247655,2021-11-21 14:38:22 UTC
793438,mainnet,250,108000000,108004544,4545,4172,373,0.08206820682068207,2021-11-21 14:40:46 UTC
793439,mainnet,250,108000000,108004775,4776,4390,386,0.08082077051926298,2021-11-21 14:42:45 UTC
793440,mainnet,250,108000000,108005032,5033,4634,399,0.07927677329624479,2021-11-21 14:44:53 UTC
793442,mainnet,250,108000000,108005277,5278,4867,411,0.07787040545661235,2021-11-21 14:46:59 UTC
793443,mainnet,250,108000000,108005496,5497,5082,415,0.07549572494087685,2021-11-21 14:48:52 UTC
793445,mainnet,250,108000000,108005758,5759,5336,423,0.07345025177982288,2021-11-21 14:51:15 UTC
793446,mainnet,250,108000000,108006036,6037,5609,428,0.07089614046711944,2021-11-21 14:53:14 UTC
793447,mainnet,250,108000000,108006328,6329,5888,441,0.06967925422657607,2021-11-21 14:55:40 UTC
793449,mainnet,250,108000000,108006552,6553,6099,454,0.06928124523119182,2021-11-21 14:57:34 UTC
793450,mainnet,250,108000000,108006778,6779,6308,471,0.06947927422923734,2021-11-21 14:59:29 UTC
793451,mainnet,250,108000000,108007033,7034,6555,479,0.06809781063406312,2021-11-21 15:01:34 UTC
793453,mainnet,250,108000000,108007256,7257,6760,497,0.0684856001102384,2021-11-21 15:03:31 UTC
793454,mainnet,250,108000000,108007485,7486,6977,509,0.06799358803099119,2021-11-21 15:05:42 UTC
793456,mainnet,250,108000000,108007823,7824,7289,535,0.06837934560327198,2021-11-21 15:08:21 UTC
793457,mainnet,250,108000000,108008100,8101,7553,548,0.0676459696333786,2021-11-21 15:10:34 UTC
793459,mainnet,250,108000000,108008308,8309,7760,549,0.06607293296425562,2021-11-21 15:12:32 UTC
793460,mainnet,250,108000000,108008551,8552,7993,559,0.06536482694106642,2021-11-21 15:14:28 UTC
793461,mainnet,250,108000000,108008800,8801,8235,566,0.06431087376434497,2021-11-21 15:16:28 UTC
793463,mainnet,250,108000000,108009044,9045,8475,570,0.06301824212271974,2021-11-21 15:18:27 UTC
793464,mainnet,250,108000000,108009285,9286,8712,574,0.061813482662071935,2021-11-21 15:20:26 UTC
793466,mainnet,250,108000000,108009528,9529,8935,594,0.06233602686535838,2021-11-21 15:22:43 UTC
793467,mainnet,250,108000000,108009794,9795,9200,595,0.06074527820316488,2021-11-21 15:24:43 UTC
793468,mainnet,250,108000000,108010037,10038,9428,610,0.06076907750547918,2021-11-21 15:26:54 UTC
793470,mainnet,250,108000000,108010244,10245,9622,623,0.06081015129331381,2021-11-21 15:29:12 UTC
793471,mainnet,250,108000000,108010549,10550,9904,646,0.06123222748815166,2021-11-21 15:31:15 UTC
793473,mainnet,250,108000000,108010799,10800,10153,647,0.05990740740740741,2021-11-21 15:33:23 UTC
793474,mainnet,250,108000000,108011040,11041,10389,652,0.059052622045104614,2021-11-21 15:35:25 UTC
793476,mainnet,250,108000000,108011273,11274,10614,660,0.05854177754124534,2021-11-21 15:37:34 UTC
793477,mainnet,250,108000000,108011498,11499,10833,666,0.057918079833028956,2021-11-21 15:39:31 UTC
793478,mainnet,250,108000000,108011730,11731,11050,681,0.058051317023271674,2021-11-21 15:41:34 UTC
793480,mainnet,250,108000000,108011951,11952,11251,701,0.05865127175368139,2021-11-21 15:43:37 UTC
793481,mainnet,250,108000000,108012178,12179,11458,721,0.059200262747351996,2021-11-21 15:45:40 UTC
793483,mainnet,250,108000000,108012394,12395,11654,741,0.059782170229931424,2021-11-21 15:47:42 UTC
793484,mainnet,250,108000000,108012428,12429,11688,741,0.059618633840212404,2021-11-21 15:49:42 UTC
793485,mainnet,250,108000000,108012805,12806,11999,807,0.06301733562392628,2021-11-21 15:51:41 UTC
793487,mainnet,250,108000000,108013009,13010,12169,841,0.06464258262874711,2021-11-21 15:53:43 UTC
793488,mainnet,250,108000000,108013183,13184,12323,861,0.06530643203883495,2021-11-21 15:55:47 UTC
793490,mainnet,250,108000000,108013354,13355,12460,895,0.067016098839386,2021-11-21 15:57:47 UTC
793491,mainnet,250,108000000,108013551,13552,12603,949,0.07002656434474616,2021-11-21 15:59:50 UTC
793493,mainnet,250,108000000,108013722,13723,12735,988,0.07199591925963711,2021-11-21 16:01:56 UTC
793494,mainnet,250,108000000,108013935,13936,12876,1060,0.07606199770378874,2021-11-21 16:04:05 UTC
793496,mainnet,250,108000000,108014105,14106,13012,1094,0.077555650077981,2021-11-21 16:06:05 UTC
793497,mainnet,250,108000000,108014284,14285,13175,1110,0.07770388519425972,2021-11-21 16:08:06 UTC
793498,mainnet,250,108000000,108014439,14440,13299,1141,0.07901662049861496,2021-11-21 16:10:04 UTC
793500,mainnet,250,108000000,108014613,14614,13441,1173,0.0802654988367319,2021-11-21 16:12:08 UTC
793501,mainnet,250,108000000,108014808,14809,13596,1213,0.08190964953744345,2021-11-21 16:14:07 UTC
793503,mainnet,250,108000000,108015043,15044,13810,1234,0.0820260568997607,2021-11-21 16:16:22 UTC
793504,mainnet,250,108000000,108015275,15276,14021,1255,0.08215501440167583,2021-11-21 16:18:38 UTC
793506,mainnet,250,108000000,108015517,15518,14245,1273,0.08203376723804615,2021-11-21 16:20:50 UTC
793507,mainnet,250,108000000,108015770,15771,14488,1283,0.08135184832921184,2021-11-21 16:23:01 UTC
793509,mainnet,250,108000000,108015995,15996,14695,1301,0.08133283320830208,2021-11-21 16:25:01 UTC
793510,mainnet,250,108000000,108016268,16269,14956,1313,0.08070563648656955,2021-11-21 16:27:17 UTC
793512,mainnet,250,108000000,108016522,16523,15201,1322,0.08000968347152454,2021-11-21 16:29:25 UTC
793513,mainnet,250,108000000,108016811,16812,15482,1330,0.07911015940994527,2021-11-21 16:31:48 UTC
793515,mainnet,250,108000000,108017064,17065,15731,1334,0.0781716964547319,2021-11-21 16:33:53 UTC
793516,mainnet,250,108000000,108017300,17301,15955,1346,0.07779897115773654,2021-11-21 16:35:54 UTC
793517,mainnet,250,108000000,108017594,17595,16229,1366,0.07763569195794259,2021-11-21 16:38:24 UTC
793519,mainnet,250,108000000,108017904,17905,16526,1379,0.07701759285115889,2021-11-21 16:41:02 UTC
793520,mainnet,250,108000000,108018161,18162,16770,1392,0.0766435414601916,2021-11-21 16:43:19 UTC
793522,mainnet,250,108000000,108018392,18393,16995,1398,0.07600717664328821,2021-11-21 16:45:35 UTC
793523,mainnet,250,108000000,108018648,18649,17215,1434,0.07689420344254383,2021-11-21 16:47:41 UTC
793525,mainnet,250,108000000,108018896,18897,17455,1442,0.07630840874212838,2021-11-21 16:49:44 UTC
793526,mainnet,250,108000000,108019132,19133,17683,1450,0.07578529242669733,2021-11-21 16:51:48 UTC
793527,mainnet,250,108000000,108019364,19365,17901,1464,0.0756003098373354,2021-11-21 16:53:50 UTC
793529,mainnet,250,108000000,108019573,19574,18100,1474,0.07530397466026362,2021-11-21 16:55:57 UTC
793530,mainnet,250,108000000,108019838,19839,18340,1499,0.07555824386309794,2021-11-21 16:58:04 UTC
793531,mainnet,250,108000000,108020067,20068,18556,1512,0.07534383097468607,2021-11-21 17:00:05 UTC
793533,mainnet,250,108000000,108020307,20308,18776,1532,0.07543825093559188,2021-11-21 17:02:15 UTC
793534,mainnet,250,108000000,108020555,20556,19005,1551,0.07545242265032108,2021-11-21 17:04:21 UTC
793535,mainnet,250,108000000,108020778,20779,19221,1558,0.07497954665768324,2021-11-21 17:06:23 UTC
793536,mainnet,250,108000000,108021039,21040,19459,1581,0.0751425855513308,2021-11-21 17:08:31 UTC
793537,mainnet,250,108000000,108021278,21279,19684,1595,0.07495652991211993,2021-11-21 17:10:36 UTC
793539,mainnet,250,108000000,108021440,21441,19833,1608,0.07499650202882328,2021-11-21 17:12:35 UTC
793540,mainnet,250,108000000,108021776,21777,20143,1634,0.07503329200532673,2021-11-21 17:14:45 UTC
793542,mainnet,250,108000000,108022024,22025,20389,1636,0.07427922814982973,2021-11-21 17:16:52 UTC
793543,mainnet,250,108000000,108022273,22274,20626,1648,0.0739876088713298,2021-11-21 17:19:02 UTC
793545,mainnet,250,108000000,108022516,22517,20864,1653,0.07341120042634454,2021-11-21 17:21:10 UTC
793546,mainnet,250,108000000,108022747,22748,21095,1653,0.07266572885528398,2021-11-21 17:23:17 UTC
793548,mainnet,250,108000000,108023030,23031,21357,1674,0.07268464243845252,2021-11-21 17:25:32 UTC
793549,mainnet,250,108000000,108023280,23281,21601,1680,0.07216184871783858,2021-11-21 17:27:39 UTC
793551,mainnet,250,108000000,108023529,23530,21836,1694,0.07199320016999575,2021-11-21 17:29:47 UTC
793552,mainnet,250,108000000,108023787,23788,22094,1694,0.07121237598789305,2021-11-21 17:31:56 UTC
793553,mainnet,250,108000000,108024008,24009,22302,1707,0.0710983381232038,2021-11-21 17:33:59 UTC
793555,mainnet,250,108000000,108024276,24277,22542,1735,0.07146682044733699,2021-11-21 17:36:08 UTC
793556,mainnet,250,108000000,108024536,24537,22786,1751,0.0713616171496108,2021-11-21 17:38:19 UTC
793558,mainnet,250,108000000,108024795,24796,23036,1760,0.07097919019196644,2021-11-21 17:40:24 UTC
793559,mainnet,250,108000000,108025054,25055,23282,1773,0.07076431849930154,2021-11-21 17:42:38 UTC
793561,mainnet,250,108000000,108025299,25300,23517,1783,0.07047430830039526,2021-11-21 17:44:46 UTC
793562,mainnet,250,108000000,108025541,25542,23741,1801,0.0705113146973612,2021-11-21 17:46:51 UTC
793564,mainnet,250,108000000,108025796,25797,23983,1814,0.07031825406054967,2021-11-21 17:48:54 UTC
793565,mainnet,250,108000000,108026037,26038,24217,1821,0.06993624702358092,2021-11-21 17:51:00 UTC
793567,mainnet,250,108000000,108026300,26301,24474,1827,0.06946503935211588,2021-11-21 17:53:09 UTC
793568,mainnet,250,108000000,108026525,26526,24698,1828,0.06891351881173188,2021-11-21 17:55:11 UTC
793569,mainnet,250,108000000,108026780,26781,24932,1849,0.06904148463462903,2021-11-21 17:57:20 UTC
793571,mainnet,250,108000000,108027013,27014,25155,1859,0.06881616939364774,2021-11-21 17:59:24 UTC
793572,mainnet,250,108000000,108027254,27255,25387,1868,0.06853788295725555,2021-11-21 18:01:49 UTC
793574,mainnet,250,108000000,108027538,27539,25655,1884,0.06841207015505284,2021-11-21 18:04:07 UTC
793576,mainnet,250,108000000,108027783,27784,25886,1898,0.06831269795565793,2021-11-21 18:06:34 UTC
793577,mainnet,250,108000000,108028019,28020,26101,1919,0.06848679514632405,2021-11-21 18:08:52 UTC
793579,mainnet,250,108000000,108028238,28239,26307,1932,0.06841602039732285,2021-11-21 18:11:19 UTC
793580,mainnet,250,108000000,108028547,28548,26590,1958,0.06858624071738825,2021-11-21 18:13:49 UTC
793582,mainnet,250,108000000,108028745,28746,26777,1969,0.06849648646768246,2021-11-21 18:15:57 UTC
793583,mainnet,250,108000000,108029020,29021,27016,2005,0.06908790186416733,2021-11-21 18:18:12 UTC
793585,mainnet,250,108000000,108029254,29255,27232,2023,0.06915057255170057,2021-11-21 18:20:18 UTC
793586,mainnet,250,108000000,108029517,29518,27475,2043,0.06921200623348465,2021-11-21 18:22:41 UTC
793588,mainnet,250,108000000,108029797,29798,27740,2058,0.06906503792200819,2021-11-21 18:25:05 UTC
793589,mainnet,250,108000000,108030055,30056,27988,2068,0.06880489752462071,2021-11-21 18:27:14 UTC
793591,mainnet,250,108000000,108030301,30302,28227,2075,0.06847732822915979,2021-11-21 18:29:32 UTC
793592,mainnet,250,108000000,108030544,30545,28447,2098,0.06868554591586185,2021-11-21 18:31:48 UTC
793594,mainnet,250,108000000,108030829,30830,28711,2119,0.068731754784301,2021-11-21 18:34:22 UTC
793595,mainnet,250,108000000,108031041,31042,28907,2135,0.06877778493653759,2021-11-21 18:36:31 UTC
793597,mainnet,250,108000000,108031306,31307,29153,2154,0.06880250423228032,2021-11-21 18:38:38 UTC
793598,mainnet,250,108000000,108031558,31559,29396,2163,0.06853829335530276,2021-11-21 18:40:45 UTC
793599,mainnet,250,108000000,108031794,31795,29620,2175,0.06840698222991036,2021-11-21 18:42:51 UTC
793601,mainnet,250,108000000,108032046,32047,29857,2190,0.0683371298405467,2021-11-21 18:45:05 UTC
793602,mainnet,250,108000000,108032296,32297,30082,2215,0.06858222125894047,2021-11-21 18:47:16 UTC
793604,mainnet,250,108000000,108032503,32504,30267,2237,0.06882229879399458,2021-11-21 18:49:19 UTC
793605,mainnet,250,108000000,108032748,32749,30479,2270,0.06931509359064399,2021-11-21 18:51:29 UTC
793607,mainnet,250,108000000,108032983,32984,30710,2274,0.06894251758428328,2021-11-21 18:53:35 UTC
793608,mainnet,250,108000000,108033221,33222,30942,2280,0.06862922160014448,2021-11-21 18:55:47 UTC
793610,mainnet,250,108000000,108033504,33505,31208,2297,0.0685569318012237,2021-11-21 18:58:03 UTC
793611,mainnet,250,108000000,108033770,33771,31463,2308,0.06834266086287051,2021-11-21 19:00:13 UTC
793613,mainnet,250,108000000,108034019,34020,31680,2340,0.06878306878306878,2021-11-21 19:02:21 UTC
793614,mainnet,250,108000000,108034249,34250,31906,2344,0.06843795620437956,2021-11-21 19:04:45 UTC
793616,mainnet,250,108000000,108034515,34516,32153,2363,0.06846100359253679,2021-11-21 19:06:55 UTC
793617,mainnet,250,108000000,108034783,34784,32404,2380,0.06842226310947562,2021-11-21 19:09:20 UTC
793619,mainnet,250,108000000,108035024,35025,32623,2402,0.06857958600999287,2021-11-21 19:11:25 UTC
793620,mainnet,250,108000000,108035301,35302,32886,2416,0.06843804883576002,2021-11-21 19:13:41 UTC
793622,mainnet,250,108000000,108035577,35578,33145,2433,0.06838495699589633,2021-11-21 19:16:03 UTC
793623,mainnet,250,108000000,108035819,35820,33377,2443,0.06820212171970966,2021-11-21 19:18:13 UTC
793625,mainnet,250,108000000,108036080,36081,33624,2457,0.06809678223996009,2021-11-21 19:20:47 UTC
793626,mainnet,250,108000000,108036364,36365,33889,2476,0.06808744672074797,2021-11-21 19:22:57 UTC
793628,mainnet,250,108000000,108036616,36617,34127,2490,0.06800120162765928,2021-11-21 19:25:07 UTC
793629,mainnet,250,108000000,108036868,36869,34360,2509,0.06805175079334942,2021-11-21 19:27:24 UTC
793631,mainnet,250,108000000,108037124,37125,34593,2532,0.06820202020202021,2021-11-21 19:29:37 UTC
793632,mainnet,250,108000000,108037399,37400,34852,2548,0.0681283422459893,2021-11-21 19:32:08 UTC
793634,mainnet,250,108000000,108037692,37693,35139,2554,0.06775793913989335,2021-11-21 19:34:39 UTC
793635,mainnet,250,108000000,108037981,37982,35393,2589,0.06816386709493971,2021-11-21 19:36:57 UTC
793637,mainnet,250,108000000,108038270,38271,35676,2595,0.0678059104805205,2021-11-21 19:39:19 UTC
793638,mainnet,250,108000000,108038581,38582,35969,2613,0.06772588253589756,2021-11-21 19:41:56 UTC
793640,mainnet,250,108000000,108038828,38829,36202,2627,0.06765561822349275,2021-11-21 19:44:04 UTC
793641,mainnet,250,108000000,108039070,39071,36442,2629,0.0672877581838192,2021-11-21 19:46:10 UTC
793643,mainnet,250,108000000,108039325,39326,36687,2639,0.0671057315770737,2021-11-21 19:48:44 UTC
793644,mainnet,250,108000000,108039648,39649,36993,2656,0.06698781810386138,2021-11-21 19:51:09 UTC
793646,mainnet,250,108000000,108039975,39976,37298,2678,0.06699019411646988,2021-11-21 19:53:53 UTC
793647,mainnet,250,108000000,108040243,40244,37548,2696,0.06699135274823576,2021-11-21 19:56:04 UTC
793649,mainnet,250,108000000,108040492,40493,37792,2701,0.0667028869187267,2021-11-21 19:58:16 UTC
793650,mainnet,250,108000000,108040759,40760,38052,2708,0.06643768400392541,2021-11-21 20:00:34 UTC
793652,mainnet,250,108000000,108041013,41014,38297,2717,0.06624567220948945,2021-11-21 20:02:50 UTC
793653,mainnet,250,108000000,108041270,41271,38535,2736,0.0662935232972305,2021-11-21 20:05:01 UTC
793655,mainnet,250,108000000,108041500,41501,38744,2757,0.0664321341654418,2021-11-21 20:07:09 UTC
793656,mainnet,250,108000000,108041758,41759,38986,2773,0.06640484685935966,2021-11-21 20:09:20 UTC
793658,mainnet,250,108000000,108042078,42079,39282,2797,0.06647021079398274,2021-11-21 20:12:01 UTC
793659,mainnet,250,108000000,108042357,42358,39543,2815,0.06645733981774399,2021-11-21 20:14:27 UTC
793661,mainnet,250,108000000,108042631,42632,39790,2842,0.0666635391255395,2021-11-21 20:16:50 UTC
793662,mainnet,250,108000000,108042920,42921,40067,2854,0.06649425689056639,2021-11-21 20:19:16 UTC
793664,mainnet,250,108000000,108043166,43167,40298,2869,0.06646280723700976,2021-11-21 20:21:27 UTC
793665,mainnet,250,108000000,108043462,43463,40567,2896,0.06663138761705359,2021-11-21 20:23:59 UTC
793666,mainnet,250,108000000,108043715,43716,40811,2905,0.06645164241925153,2021-11-21 20:26:15 UTC
793668,mainnet,250,108000000,108043997,43998,41076,2922,0.06641210964134733,2021-11-21 20:28:35 UTC
793669,mainnet,250,108000000,108044272,44273,41340,2933,0.06624805186005014,2021-11-21 20:31:02 UTC
793671,mainnet,250,108000000,108044547,44548,41590,2958,0.06640028733051989,2021-11-21 20:33:24 UTC
793672,mainnet,250,108000000,108044806,44807,41841,2966,0.06619501417189279,2021-11-21 20:35:48 UTC
793674,mainnet,250,108000000,108045063,45064,42084,2980,0.06612817326469021,2021-11-21 20:37:59 UTC
793675,mainnet,250,108000000,108045312,45313,42321,2992,0.06602961622492441,2021-11-21 20:40:11 UTC
793677,mainnet,250,108000000,108045560,45561,42567,2994,0.06571409758345954,2021-11-21 20:42:19 UTC
793678,mainnet,250,108000000,108045816,45817,42801,3016,0.06582709474649148,2021-11-21 20:44:31 UTC
793680,mainnet,250,108000000,108046043,46044,43006,3038,0.06598036660585527,2021-11-21 20:46:35 UTC
793681,mainnet,250,108000000,108046308,46309,43245,3064,0.06616424453130061,2021-11-21 20:48:41 UTC
793683,mainnet,250,108000000,108046579,46580,43508,3072,0.06595105195362817,2021-11-21 20:50:59 UTC
793684,mainnet,250,108000000,108046867,46868,43781,3087,0.06586583596483742,2021-11-21 20:53:31 UTC
793685,mainnet,250,108000000,108047132,47133,44023,3110,0.06598349351834171,2021-11-21 20:55:47 UTC
793687,mainnet,250,108000000,108047402,47403,44287,3116,0.06573423622977449,2021-11-21 20:57:58 UTC
793688,mainnet,250,108000000,108047622,47623,44495,3128,0.06568254834848708,2021-11-21 21:00:09 UTC
793690,mainnet,250,108000000,108047899,47900,44750,3150,0.06576200417536535,2021-11-21 21:02:19 UTC
793691,mainnet,250,108000000,108048194,48195,45028,3167,0.06571221081025003,2021-11-21 21:04:46 UTC
793693,mainnet,250,108000000,108048436,48437,45267,3170,0.06544583686025146,2021-11-21 21:06:52 UTC
793694,mainnet,250,108000000,108048707,48708,45532,3176,0.06520489447318716,2021-11-21 21:09:10 UTC
793696,mainnet,250,108000000,108048948,48949,45765,3184,0.06504729412245398,2021-11-21 21:11:20 UTC
793697,mainnet,250,108000000,108049234,49235,46035,3200,0.06499441454250025,2021-11-21 21:13:38 UTC
793699,mainnet,250,108000000,108049470,49471,46264,3207,0.06482585757312365,2021-11-21 21:15:49 UTC
793700,mainnet,250,108000000,108049730,49731,46494,3237,0.0650901851963564,2021-11-21 21:17:58 UTC
793702,mainnet,250,108000000,108049987,49988,46746,3242,0.06485556533568056,2021-11-21 21:20:21 UTC
793703,mainnet,250,108000000,108050258,50259,46997,3262,0.06490379832467817,2021-11-21 21:22:32 UTC
793705,mainnet,250,108000000,108050568,50569,47291,3278,0.0648223219759141,2021-11-21 21:25:10 UTC
793706,mainnet,250,108000000,108050802,50803,47507,3296,0.06487805838237899,2021-11-21 21:27:19 UTC
793708,mainnet,250,108000000,108051052,51053,47747,3306,0.064756233717901,2021-11-21 21:29:28 UTC
793709,mainnet,250,108000000,108051298,51299,47987,3312,0.06456266204019571,2021-11-21 21:31:41 UTC
793711,mainnet,250,108000000,108051536,51537,48210,3327,0.06455556202340067,2021-11-21 21:33:49 UTC
793712,mainnet,250,108000000,108051794,51795,48452,3343,0.0645429095472536,2021-11-21 21:35:59 UTC
793714,mainnet,250,108000000,108052048,52049,48701,3348,0.06432400238237046,2021-11-21 21:38:08 UTC
793715,mainnet,250,108000000,108052301,52302,48946,3356,0.06416580627891859,2021-11-21 21:40:14 UTC
793716,mainnet,250,108000000,108052551,52552,49177,3375,0.06422210382097732,2021-11-21 21:42:23 UTC
793718,mainnet,250,108000000,108052794,52795,49405,3390,0.06421062600625059,2021-11-21 21:44:34 UTC
793719,mainnet,250,108000000,108053009,53010,49604,3406,0.06425202791926052,2021-11-21 21:46:53 UTC
793721,mainnet,250,108000000,108053265,53266,49843,3423,0.06426238125633613,2021-11-21 21:49:08 UTC
793722,mainnet,250,108000000,108053519,53520,50083,3437,0.06421898355754858,2021-11-21 21:51:17 UTC
793724,mainnet,250,108000000,108053797,53798,50343,3455,0.06422171827948994,2021-11-21 21:53:46 UTC
793725,mainnet,250,108000000,108054032,54033,50571,3462,0.06407195602687246,2021-11-21 21:55:53 UTC
793726,mainnet,250,108000000,108054299,54300,50815,3485,0.0641804788213628,2021-11-21 21:58:03 UTC
793728,mainnet,250,108000000,108054604,54605,51112,3493,0.06396850105301713,2021-11-21 22:00:43 UTC
793730,mainnet,250,108000000,108054858,54859,51362,3497,0.06374523779142893,2021-11-21 22:03:03 UTC
793731,mainnet,250,108000000,108055130,55131,51628,3503,0.06353956938927283,2021-11-21 22:05:22 UTC
793733,mainnet,250,108000000,108055399,55400,51883,3517,0.06348375451263538,2021-11-21 22:07:54 UTC
793734,mainnet,250,108000000,108055650,55651,52103,3548,0.06375446982084779,2021-11-21 22:09:58 UTC
793736,mainnet,250,108000000,108055909,55910,52348,3562,0.0637095331783223,2021-11-21 22:12:06 UTC
793737,mainnet,250,108000000,108056164,56165,52593,3572,0.06359832635983263,2021-11-21 22:14:16 UTC
793739,mainnet,250,108000000,108056432,56433,52852,3581,0.063455779419843,2021-11-21 22:16:35 UTC
793740,mainnet,250,108000000,108056708,56709,53113,3596,0.0634114514450969,2021-11-21 22:18:50 UTC
793741,mainnet,250,108000000,108056980,56981,53377,3604,0.0632491532265141,2021-11-21 22:21:04 UTC
793743,mainnet,250,108000000,108057253,57254,53636,3618,0.0631920913822615,2021-11-21 22:23:16 UTC
793744,mainnet,250,108000000,108057489,57490,53867,3623,0.06301965559227692,2021-11-21 22:25:21 UTC
793746,mainnet,250,108000000,108057744,57745,54105,3640,0.06303576067191964,2021-11-21 22:27:29 UTC
793747,mainnet,250,108000000,108058032,58033,54378,3655,0.0629814071304258,2021-11-21 22:29:42 UTC
793749,mainnet,250,108000000,108058272,58273,54604,3669,0.06296226382715837,2021-11-21 22:31:51 UTC
793750,mainnet,250,108000000,108058540,58541,54844,3697,0.06315232059582174,2021-11-21 22:34:11 UTC
793752,mainnet,250,108000000,108058785,58786,55063,3723,0.0633314054366686,2021-11-21 22:36:18 UTC
793753,mainnet,250,108000000,108059048,59049,55313,3736,0.06326948805229556,2021-11-21 22:38:36 UTC
793755,mainnet,250,108000000,108059320,59321,55572,3749,0.06319853003152341,2021-11-21 22:40:55 UTC
793756,mainnet,250,108000000,108059556,59557,55787,3770,0.06330070352771294,2021-11-21 22:43:05 UTC
793758,mainnet,250,108000000,108059784,59785,55987,3798,0.06352764071255332,2021-11-21 22:45:17 UTC
793759,mainnet,250,108000000,108060033,60034,56222,3812,0.0634973515008162,2021-11-21 22:47:26 UTC
793761,mainnet,250,108000000,108060284,60285,56466,3819,0.06334909181388405,2021-11-21 22:49:32 UTC
793762,mainnet,250,108000000,108060536,60537,56703,3834,0.06333316814510134,2021-11-21 22:52:03 UTC
793764,mainnet,250,108000000,108060836,60837,56988,3849,0.06326741949800287,2021-11-21 22:54:11 UTC
793765,mainnet,250,108000000,108061143,61144,57286,3858,0.06309695145885123,2021-11-21 22:56:43 UTC
793767,mainnet,250,108000000,108061410,61411,57521,3890,0.0633437006399505,2021-11-21 22:58:59 UTC
793768,mainnet,250,108000000,108061672,61673,57772,3901,0.06325296320918392,2021-11-21 23:01:14 UTC
793770,mainnet,250,108000000,108061926,61927,58017,3910,0.06313885704135515,2021-11-21 23:03:28 UTC
793771,mainnet,250,108000000,108062183,62184,58260,3924,0.063103049015824,2021-11-21 23:05:40 UTC
793773,mainnet,250,108000000,108062409,62410,58484,3926,0.06290658548309566,2021-11-21 23:07:43 UTC
793774,mainnet,250,108000000,108062668,62669,58729,3940,0.06286999952129442,2021-11-21 23:09:56 UTC
793775,mainnet,250,108000000,108062922,62923,58973,3950,0.06277513786691671,2021-11-21 23:12:14 UTC
793776,mainnet,250,108000000,108063199,63200,59236,3964,0.06272151898734177,2021-11-21 23:14:33 UTC
793778,mainnet,250,108000000,108063448,63449,59475,3974,0.06263298081924065,2021-11-21 23:16:49 UTC
793779,mainnet,250,108000000,108063688,63689,59706,3983,0.06253827191508737,2021-11-21 23:19:06 UTC
793781,mainnet,250,108000000,108063936,63937,59937,4000,0.06256158405930838,2021-11-21 23:21:16 UTC
793782,mainnet,250,108000000,108064188,64189,60184,4005,0.06239386810824284,2021-11-21 23:23:22 UTC
793784,mainnet,250,108000000,108064421,64422,60413,4009,0.06223029399894446,2021-11-21 23:25:28 UTC
793785,mainnet,250,108000000,108064669,64670,60643,4027,0.062269986083191585,2021-11-21 23:27:38 UTC
793787,mainnet,250,108000000,108064932,64933,60901,4032,0.06209477461383272,2021-11-21 23:29:47 UTC
793788,mainnet,250,108000000,108065200,65201,61150,4051,0.06213094891182651,2021-11-21 23:32:03 UTC
793790,mainnet,250,108000000,108065460,65461,61408,4053,0.06191472785322558,2021-11-21 23:34:13 UTC
793791,mainnet,250,108000000,108065743,65744,61674,4070,0.061906789973229494,2021-11-21 23:36:25 UTC
793793,mainnet,250,108000000,108065979,65980,61896,4084,0.06189754471051834,2021-11-21 23:38:33 UTC
793794,mainnet,250,108000000,108066249,66250,62156,4094,0.06179622641509434,2021-11-21 23:40:42 UTC
793795,mainnet,250,108000000,108066512,66513,62411,4102,0.06167215431569768,2021-11-21 23:42:59 UTC
793796,mainnet,250,108000000,108066788,66789,62678,4111,0.061552051984608246,2021-11-21 23:45:15 UTC
793798,mainnet,250,108000000,108067016,67017,62897,4120,0.06147693868719877,2021-11-21 23:47:24 UTC
793799,mainnet,250,108000000,108067284,67285,63135,4150,0.06167793713309058,2021-11-21 23:49:29 UTC
793801,mainnet,250,108000000,108067522,67523,63365,4158,0.06157901751995616,2021-11-21 23:51:37 UTC
793802,mainnet,250,108000000,108067755,67756,63587,4169,0.06152960623413425,2021-11-21 23:53:44 UTC
793803,mainnet,250,108000000,108067983,67984,63792,4192,0.06166156742763003,2021-11-21 23:55:51 UTC
793805,mainnet,250,108000000,108068186,68187,63991,4196,0.06153665654743573,2021-11-21 23:57:57 UTC
793806,mainnet,250,108000000,108068424,68425,64191,4234,0.06187796857873584,2021-11-22 00:00:07 UTC
793808,mainnet,250,108000000,108068721,68722,64460,4262,0.0620179855068246,2021-11-22 00:02:24 UTC
793809,mainnet,250,108000000,108068961,68962,64683,4279,0.062048664481888574,2021-11-22 00:04:34 UTC
793811,mainnet,250,108000000,108069198,69199,64892,4307,0.062240783826355874,2021-11-22 00:06:47 UTC
793812,mainnet,250,108000000,108069412,69413,65087,4326,0.0623226196821921,2021-11-22 00:08:50 UTC
793814,mainnet,250,108000000,108069657,69658,65283,4375,0.06280685635533607,2021-11-22 00:11:03 UTC
793815,mainnet,250,108000000,108069887,69888,65493,4395,0.06288633241758242,2021-11-22 00:13:18 UTC
793817,mainnet,250,108000000,108070102,70103,65689,4414,0.06296449510006705,2021-11-22 00:15:24 UTC
793818,mainnet,250,108000000,108070312,70313,65886,4427,0.06296133005276407,2021-11-22 00:17:34 UTC
793820,mainnet,250,108000000,108070566,70567,66113,4454,0.06311732112743917,2021-11-22 00:19:57 UTC
793821,mainnet,250,108000000,108070773,70774,66305,4469,0.06314465764263713,2021-11-22 00:22:02 UTC
793823,mainnet,250,108000000,108071024,71025,66534,4491,0.0632312565997888,2021-11-22 00:24:12 UTC
793824,mainnet,250,108000000,108071287,71288,66774,4514,0.06332061497026148,2021-11-22 00:26:23 UTC
793826,mainnet,250,108000000,108071574,71575,67045,4530,0.06329025497729654,2021-11-22 00:28:58 UTC
793827,mainnet,250,108000000,108071813,71814,67270,4544,0.06327457041802434,2021-11-22 00:31:07 UTC
793829,mainnet,250,108000000,108072036,72037,67481,4556,0.0632452767327901,2021-11-22 00:33:15 UTC
793830,mainnet,250,108000000,108072311,72312,67733,4579,0.06332282332116385,2021-11-22 00:35:48 UTC
793832,mainnet,250,108000000,108072557,72558,67968,4590,0.06325973703795584,2021-11-22 00:37:58 UTC
793833,mainnet,250,108000000,108072782,72783,68184,4599,0.06318783232348213,2021-11-22 00:40:13 UTC
793835,mainnet,250,108000000,108073024,73025,68425,4600,0.06299212598425197,2021-11-22 00:42:17 UTC
793836,mainnet,250,108000000,108073312,73313,68680,4633,0.06319479492040975,2021-11-22 00:44:47 UTC
793838,mainnet,250,108000000,108073563,73564,68925,4639,0.06306073622967756,2021-11-22 00:46:57 UTC
793839,mainnet,250,108000000,108073806,73807,69151,4656,0.0630834473694907,2021-11-22 00:49:05 UTC
793841,mainnet,250,108000000,108074044,74045,69370,4675,0.0631372813829428,2021-11-22 00:51:16 UTC
793842,mainnet,250,108000000,108074280,74281,69590,4691,0.06315208465152596,2021-11-22 00:53:23 UTC
793843,mainnet,250,108000000,108074544,74545,69828,4717,0.06327721510497016,2021-11-22 00:55:32 UTC
793845,mainnet,250,108000000,108074846,74847,70124,4723,0.06310206153887263,2021-11-22 00:57:51 UTC
793846,mainnet,250,108000000,108075110,75111,70382,4729,0.06296015230791761,2021-11-22 00:59:58 UTC
793848,mainnet,250,108000000,108075376,75377,70632,4745,0.06295023680963689,2021-11-22 01:02:24 UTC
793849,mainnet,250,108000000,108075684,75685,70923,4762,0.06291867609169584,2021-11-22 01:04:41 UTC
793851,mainnet,250,108000000,108075951,75952,71166,4786,0.06301348219928375,2021-11-22 01:06:58 UTC
793852,mainnet,250,108000000,108076230,76231,71436,4795,0.0629009195734019,2021-11-22 01:09:17 UTC
793854,mainnet,250,108000000,108076476,76477,71676,4801,0.06277704407861187,2021-11-22 01:11:27 UTC
793855,mainnet,250,108000000,108076730,76731,71921,4810,0.06268652826106788,2021-11-22 01:13:43 UTC
793856,mainnet,250,108000000,108077000,77001,72178,4823,0.0626355501876599,2021-11-22 01:16:01 UTC
793858,mainnet,250,108000000,108077234,77235,72407,4828,0.06251051984204052,2021-11-22 01:18:20 UTC
793859,mainnet,250,108000000,108077472,77473,72638,4835,0.06240883920849844,2021-11-22 01:20:42 UTC
793861,mainnet,250,108000000,108077742,77743,72890,4853,0.06242362656444953,2021-11-22 01:23:13 UTC
793862,mainnet,250,108000000,108078005,78006,73149,4857,0.062264441196831014,2021-11-22 01:25:40 UTC
793864,mainnet,250,108000000,108078264,78265,73380,4885,0.06241615025873634,2021-11-22 01:27:55 UTC
793865,mainnet,250,108000000,108078673,78674,73774,4900,0.06228232961334113,2021-11-22 01:30:16 UTC
793867,mainnet,250,108000000,108078948,78949,74030,4919,0.06230604567505605,2021-11-22 01:32:51 UTC
793868,mainnet,250,108000000,108079229,79230,74282,4948,0.06245109175817241,2021-11-22 01:35:08 UTC
793870,mainnet,250,108000000,108079523,79524,74567,4957,0.06233338363261405,2021-11-22 01:37:31 UTC
793871,mainnet,250,108000000,108079785,79786,74827,4959,0.062153761311508286,2021-11-22 01:39:51 UTC
793873,mainnet,250,108000000,108080065,80066,75098,4968,0.062048809731971126,2021-11-22 01:42:11 UTC
793874,mainnet,250,108000000,108080344,80345,75372,4973,0.06189557533138341,2021-11-22 01:44:29 UTC
793876,mainnet,250,108000000,108080637,80638,75655,4983,0.0617946873682383,2021-11-22 01:46:57 UTC
793877,mainnet,250,108000000,108080896,80897,75905,4992,0.06170809795171638,2021-11-22 01:49:21 UTC
793879,mainnet,250,108000000,108081182,81183,76157,5026,0.061909513075397556,2021-11-22 01:51:43 UTC
793880,mainnet,250,108000000,108081438,81439,76392,5047,0.0619727648915139,2021-11-22 01:53:57 UTC
793882,mainnet,250,108000000,108081708,81709,76653,5056,0.061878128480338766,2021-11-22 01:56:16 UTC
793883,mainnet,250,108000000,108081989,81990,76930,5060,0.06171484327356995,2021-11-22 01:58:42 UTC
793885,mainnet,250,108000000,108082255,82256,77186,5070,0.06163684108150165,2021-11-22 02:00:59 UTC
793886,mainnet,250,108000000,108082527,82528,77442,5086,0.06162756882512602,2021-11-22 02:03:17 UTC
793888,mainnet,250,108000000,108082803,82804,77698,5106,0.0616636877445534,2021-11-22 02:05:41 UTC
793889,mainnet,250,108000000,108083063,83064,77938,5126,0.061711451410960225,2021-11-22 02:07:56 UTC
793891,mainnet,250,108000000,108083381,83382,78238,5144,0.061691971888417164,2021-11-22 02:10:27 UTC
793893,mainnet,250,108000000,108083670,83671,78506,5165,0.06172987056447276,2021-11-22 02:12:57 UTC
793894,mainnet,250,108000000,108083930,83931,78749,5182,0.06174119216975849,2021-11-22 02:15:15 UTC
793896,mainnet,250,108000000,108084197,84198,79001,5197,0.06172355637901138,2021-11-22 02:17:44 UTC
793897,mainnet,250,108000000,108084467,84468,79262,5206,0.06163280769048634,2021-11-22 02:19:55 UTC
793899,mainnet,250,108000000,108084713,84714,79491,5223,0.061654508109639496,2021-11-22 02:22:08 UTC
793900,mainnet,250,108000000,108084963,84964,79720,5244,0.06172025799161998,2021-11-22 02:24:21 UTC
793902,mainnet,250,108000000,108085230,85231,79966,5265,0.061773298447747885,2021-11-22 02:26:36 UTC
793903,mainnet,250,108000000,108085512,85513,80237,5276,0.06169822132307368,2021-11-22 02:29:01 UTC
793905,mainnet,250,108000000,108085761,85762,80474,5288,0.06165900981786805,2021-11-22 02:31:16 UTC
793906,mainnet,250,108000000,108085991,85992,80689,5303,0.06166852730486557,2021-11-22 02:33:29 UTC
793908,mainnet,250,108000000,108086259,86260,80951,5309,0.06154648736378391,2021-11-22 02:35:46 UTC
793909,mainnet,250,108000000,108086582,86583,81248,5335,0.061617176582008014,2021-11-22 02:38:17 UTC
793911,mainnet,250,108000000,108086866,86867,81503,5364,0.06174957118353345,2021-11-22 02:40:55 UTC
793912,mainnet,250,108000000,108087193,87194,81804,5390,0.061816180012386174,2021-11-22 02:43:25 UTC
793914,mainnet,250,108000000,108087471,87472,82057,5415,0.061905524053411376,2021-11-22 02:45:47 UTC
793915,mainnet,250,108000000,108087724,87725,82285,5440,0.06201196922200057,2021-11-22 02:47:59 UTC
793917,mainnet,250,108000000,108087979,87980,82524,5456,0.06201409411229825,2021-11-22 02:50:12 UTC
793918,mainnet,250,108000000,108088264,88265,82790,5475,0.062029116863989125,2021-11-22 02:52:30 UTC
793920,mainnet,250,108000000,108088536,88537,83061,5476,0.06184984808611089,2021-11-22 02:54:42 UTC
793921,mainnet,250,108000000,108088797,88798,83312,5486,0.06178067073582738,2021-11-22 02:56:56 UTC
793923,mainnet,250,108000000,108089085,89086,83575,5511,0.06186157196416946,2021-11-22 02:59:10 UTC
793924,mainnet,250,108000000,108089336,89337,83816,5521,0.06179970225102701,2021-11-22 03:01:29 UTC
793926,mainnet,250,108000000,108089621,89622,84090,5532,0.0617259155118163,2021-11-22 03:04:00 UTC
793927,mainnet,250,108000000,108089933,89934,84391,5543,0.061634087219516534,2021-11-22 03:06:27 UTC
793929,mainnet,250,108000000,108090194,90195,84644,5551,0.061544431509507176,2021-11-22 03:08:40 UTC
793930,mainnet,250,108000000,108090486,90487,84905,5582,0.06168841933095362,2021-11-22 03:10:55 UTC
793932,mainnet,250,108000000,108090752,90753,85158,5595,0.06165085451720604,2021-11-22 03:13:12 UTC
793933,mainnet,250,108000000,108091038,91039,85431,5608,0.061599973637671765,2021-11-22 03:15:38 UTC
793935,mainnet,250,108000000,108091312,91313,85692,5621,0.06155750002737836,2021-11-22 03:17:54 UTC
793937,mainnet,250,108000000,108091590,91591,85956,5635,0.061523512135471824,2021-11-22 03:20:21 UTC
793938,mainnet,250,108000000,108091830,91831,86191,5640,0.06141716849429931,2021-11-22 03:22:34 UTC
793940,mainnet,250,108000000,108092106,92107,86443,5664,0.06149369754741768,2021-11-22 03:24:51 UTC
793941,mainnet,250,108000000,108092379,92380,86711,5669,0.061366096557696474,2021-11-22 03:27:13 UTC
793942,mainnet,250,108000000,108092602,92603,86892,5711,0.06167186808202758,2021-11-22 03:29:23 UTC
793944,mainnet,250,108000000,108092852,92853,87118,5735,0.0617642940992752,2021-11-22 03:31:33 UTC
793945,mainnet,250,108000000,108093096,93097,87343,5754,0.061806502894830126,2021-11-22 03:33:52 UTC
793947,mainnet,250,108000000,108093342,93343,87580,5763,0.06174003406790011,2021-11-22 03:36:06 UTC
793948,mainnet,250,108000000,108093566,93567,87774,5793,0.06191285389079483,2021-11-22 03:38:26 UTC
793950,mainnet,250,108000000,108093819,93820,87998,5822,0.062054998934129184,2021-11-22 03:40:54 UTC
793951,mainnet,250,108000000,108094074,94075,88232,5843,0.062110018602179115,2021-11-22 03:43:13 UTC
793952,mainnet,250,108000000,108094327,94328,88476,5852,0.062038843185480454,2021-11-22 03:45:31 UTC
793953,mainnet,250,108000000,108094584,94585,88719,5866,0.06201829042660041,2021-11-22 03:47:46 UTC
793955,mainnet,250,108000000,108094847,94848,88956,5892,0.062120445344129555,2021-11-22 03:50:03 UTC
793956,mainnet,250,108000000,108095083,95084,89167,5917,0.06222918682428169,2021-11-22 03:52:16 UTC
793958,mainnet,250,108000000,108095352,95353,89412,5941,0.062305328621018743,2021-11-22 03:54:32 UTC
793959,mainnet,250,108000000,108095620,95621,89679,5942,0.06214116146034867,2021-11-22 03:56:55 UTC
793961,mainnet,250,108000000,108095882,95883,89928,5955,0.06210694283658209,2021-11-22 03:59:12 UTC
793962,mainnet,250,108000000,108096122,96123,90149,5974,0.06214953757165299,2021-11-22 04:01:35 UTC
793964,mainnet,250,108000000,108096384,96385,90385,6000,0.06225035015821964,2021-11-22 04:03:56 UTC
793965,mainnet,250,108000000,108096642,96643,90617,6026,0.06235319681715178,2021-11-22 04:06:13 UTC
793967,mainnet,250,108000000,108096885,96886,90850,6036,0.06230002270709906,2021-11-22 04:08:25 UTC
793968,mainnet,250,108000000,108097129,97130,91083,6047,0.062256769278286835,2021-11-22 04:10:40 UTC
793970,mainnet,250,108000000,108097416,97417,91354,6063,0.06223759713397046,2021-11-22 04:12:57 UTC
793971,mainnet,250,108000000,108097701,97702,91625,6077,0.06219934085279728,2021-11-22 04:15:23 UTC
793972,mainnet,250,108000000,108097997,97998,91908,6090,0.06214412539031409,2021-11-22 04:17:50 UTC
793974,mainnet,250,108000000,108098268,98269,92177,6092,0.06199310057088197,2021-11-22 04:20:13 UTC
793975,mainnet,250,108000000,108098501,98502,92402,6100,0.06192767659539908,2021-11-22 04:22:23 UTC
793977,mainnet,250,108000000,108098782,98783,92652,6131,0.06206533512851402,2021-11-22 04:24:40 UTC
793978,mainnet,250,108000000,108099056,99057,92903,6154,0.0621258467347083,2021-11-22 04:27:05 UTC
793980,mainnet,250,108000000,108099346,99347,93181,6166,0.06206528631966743,2021-11-22 04:29:36 UTC
793981,mainnet,250,108000000,108099624,99625,93453,6172,0.061952321204516936,2021-11-22 04:31:59 UTC
793983,mainnet,250,108000000,108099902,99903,93710,6193,0.06199013042651372,2021-11-22 04:34:21 UTC
793984,mainnet,250,108000000,108100187,100188,93970,6218,0.06206332095660159,2021-11-22 04:36:40 UTC
793986,mainnet,250,108000000,108100455,100456,94235,6221,0.061927610097953334,2021-11-22 04:39:09 UTC
793987,mainnet,250,108000000,108100776,100777,94539,6238,0.06189904442481915,2021-11-22 04:41:49 UTC
793989,mainnet,250,108000000,108101084,101085,94846,6239,0.06172033437206312,2021-11-22 04:44:26 UTC
793991,mainnet,250,108000000,108101365,101366,95113,6253,0.06168735078823274,2021-11-22 04:46:47 UTC
793992,mainnet,250,108000000,108101652,101653,95376,6277,0.06174928433002469,2021-11-22 04:49:13 UTC
793994,mainnet,250,108000000,108101922,101923,95631,6292,0.06173287677952965,2021-11-22 04:51:33 UTC
793995,mainnet,250,108000000,108102180,102181,95879,6302,0.06167487106213484,2021-11-22 04:54:03 UTC
793997,mainnet,250,108000000,108102429,102430,96119,6311,0.06161280874743728,2021-11-22 04:56:21 UTC
793998,mainnet,250,108000000,108102692,102693,96374,6319,0.06153291850466926,2021-11-22 04:58:35 UTC
794000,mainnet,250,108000000,108102946,102947,96614,6333,0.06151709131883396,2021-11-22 05:00:56 UTC
794001,mainnet,250,108000000,108103201,103202,96833,6369,0.06171392027286293,2021-11-22 05:03:20 UTC
794003,mainnet,250,108000000,108103491,103492,97104,6388,0.06172457774513972,2021-11-22 05:05:49 UTC
794004,mainnet,250,108000000,108103784,103785,97383,6402,0.061685214626391094,2021-11-22 05:08:14 UTC
794006,mainnet,250,108000000,108104062,104063,97644,6419,0.06168378770552454,2021-11-22 05:10:42 UTC
794007,mainnet,250,108000000,108104315,104316,97871,6445,0.061783427278653325,2021-11-22 05:13:02 UTC
794009,mainnet,250,108000000,108104596,104597,98138,6459,0.0617512930581183,2021-11-22 05:15:19 UTC
794010,mainnet,250,108000000,108104861,104862,98398,6464,0.06164292117258874,2021-11-22 05:17:41 UTC
794012,mainnet,250,108000000,108105155,105156,98689,6467,0.06149910608999962,2021-11-22 05:20:12 UTC
794013,mainnet,250,108000000,108105414,105415,98934,6481,0.06148081392591187,2021-11-22 05:22:20 UTC
794015,mainnet,250,108000000,108105672,105673,99192,6481,0.061330708884956425,2021-11-22 05:24:39 UTC
794016,mainnet,250,108000000,108105960,105961,99467,6494,0.061286699823519974,2021-11-22 05:27:09 UTC
794018,mainnet,250,108000000,108106238,106239,99722,6517,0.06134282137444818,2021-11-22 05:29:29 UTC
794019,mainnet,250,108000000,108106531,106532,99995,6537,0.061361844328464685,2021-11-22 05:31:54 UTC
794021,mainnet,250,108000000,108106807,106808,100254,6554,0.06136244476069208,2021-11-22 05:34:16 UTC
794022,mainnet,250,108000000,108107091,107092,100516,6576,0.06140514697643148,2021-11-22 05:36:31 UTC
794024,mainnet,250,108000000,108107352,107353,100773,6580,0.06129311709966186,2021-11-22 05:38:39 UTC
794026,mainnet,250,108000000,108107620,107621,101013,6608,0.061400656005798124,2021-11-22 05:40:58 UTC
794027,mainnet,250,108000000,108107898,107899,101272,6627,0.0614185488280707,2021-11-22 05:43:12 UTC
794028,mainnet,250,108000000,108108172,108173,101529,6644,0.0614201325654276,2021-11-22 05:45:29 UTC
794029,mainnet,250,108000000,108108428,108429,101780,6649,0.06132123324940745,2021-11-22 05:47:45 UTC
794031,mainnet,250,108000000,108108700,108701,102046,6655,0.061222987828998814,2021-11-22 05:50:02 UTC
794032,mainnet,250,108000000,108108982,108983,102322,6661,0.06111962416156648,2021-11-22 05:52:16 UTC
794034,mainnet,250,108000000,108109278,109279,102615,6664,0.0609815243550911,2021-11-22 05:54:44 UTC
794035,mainnet,250,108000000,108109564,109565,102896,6669,0.06086797791265459,2021-11-22 05:56:57 UTC
794037,mainnet,250,108000000,108109840,109841,103163,6678,0.06079697016596717,2021-11-22 05:59:09 UTC
794038,mainnet,250,108000000,108110140,110141,103434,6707,0.06089467137578195,2021-11-22 06:01:30 UTC
794040,mainnet,250,108000000,108110406,110407,103686,6721,0.060874763375510614,2021-11-22 06:03:48 UTC
794042,mainnet,250,108000000,108110687,110688,103953,6735,0.060846704249783175,2021-11-22 06:06:15 UTC
794043,mainnet,250,108000000,108110998,110999,104245,6754,0.060847395021576774,2021-11-22 06:08:38 UTC
794045,mainnet,250,108000000,108111286,111287,104528,6759,0.06073485672180937,2021-11-22 06:10:59 UTC
794046,mainnet,250,108000000,108111584,111585,104824,6761,0.060590581171304385,2021-11-22 06:13:25 UTC
794048,mainnet,250,108000000,108111869,111870,105101,6769,0.060507732189148115,2021-11-22 06:15:46 UTC
794049,mainnet,250,108000000,108112129,112130,105356,6774,0.06041202176045661,2021-11-22 06:17:59 UTC
794051,mainnet,250,108000000,108112411,112412,105628,6784,0.06034942888659574,2021-11-22 06:20:19 UTC
794052,mainnet,250,108000000,108112700,112701,105900,6801,0.06034551601139298,2021-11-22 06:22:36 UTC
794054,mainnet,250,108000000,108112963,112964,106157,6807,0.06025813533515102,2021-11-22 06:24:48 UTC
794055,mainnet,250,108000000,108113225,113226,106412,6814,0.06018052390793634,2021-11-22 06:27:05 UTC
794056,mainnet,250,108000000,108113492,113493,106670,6823,0.06011824517811671,2021-11-22 06:29:22 UTC
794058,mainnet,250,108000000,108113772,113773,106937,6836,0.060084554331871355,2021-11-22 06:31:38 UTC
794059,mainnet,250,108000000,108114072,114073,107228,6845,0.06000543511610986,2021-11-22 06:34:03 UTC
794061,mainnet,250,108000000,108114381,114382,107527,6855,0.059930758336101835,2021-11-22 06:36:33 UTC
794063,mainnet,250,108000000,108114733,114734,107874,6860,0.05979047187407394,2021-11-22 06:39:23 UTC
794064,mainnet,250,108000000,108115059,115060,108196,6864,0.05965583173996176,2021-11-22 06:42:04 UTC
794066,mainnet,250,108000000,108115348,115349,108465,6884,0.05967975448421746,2021-11-22 06:44:36 UTC
794067,mainnet,250,108000000,108115623,115624,108733,6891,0.05959835328305542,2021-11-22 06:46:54 UTC
794069,mainnet,250,108000000,108115901,115902,109003,6899,0.05952442580801021,2021-11-22 06:49:09 UTC
794070,mainnet,250,108000000,108116171,116172,109253,6919,0.059558241228523226,2021-11-22 06:51:26 UTC
794072,mainnet,250,108000000,108116438,116439,109512,6927,0.059490376935562826,2021-11-22 06:53:38 UTC
794073,mainnet,250,108000000,108116710,116711,109783,6928,0.05936030022877021,2021-11-22 06:55:54 UTC
794075,mainnet,250,108000000,108116982,116983,110037,6946,0.059376148671174446,2021-11-22 06:58:18 UTC
794076,mainnet,250,108000000,108117282,117283,110324,6959,0.05933511250564873,2021-11-22 07:00:40 UTC
794078,mainnet,250,108000000,108117570,117571,110599,6972,0.05930033766830256,2021-11-22 07:03:17 UTC
794079,mainnet,250,108000000,108117858,117859,110860,6999,0.059384518789400896,2021-11-22 07:05:56 UTC
794081,mainnet,250,108000000,108118116,118117,111114,7003,0.059288671402084374,2021-11-22 07:08:14 UTC
794082,mainnet,250,108000000,108118422,118423,111399,7024,0.05931280241169368,2021-11-22 07:10:31 UTC
794084,mainnet,250,108000000,108118707,118708,111672,7036,0.0592714897058328,2021-11-22 07:13:03 UTC
794086,mainnet,250,108000000,108119006,119007,111952,7055,0.05928222709588512,2021-11-22 07:15:32 UTC
794087,mainnet,250,108000000,108119283,119284,112223,7061,0.05919486268066128,2021-11-22 07:17:57 UTC
794089,mainnet,250,108000000,108119547,119548,112484,7064,0.05908923612272895,2021-11-22 07:20:07 UTC
794090,mainnet,250,108000000,108119835,119836,112763,7073,0.05902233051837511,2021-11-22 07:22:23 UTC
794092,mainnet,250,108000000,108120104,120105,113019,7086,0.058998376420631944,2021-11-22 07:24:42 UTC
794093,mainnet,250,108000000,108120367,120368,113274,7094,0.05893592981523328,2021-11-22 07:26:57 UTC
794095,mainnet,250,108000000,108120651,120652,113551,7101,0.058855219971488244,2021-11-22 07:29:17 UTC
794096,mainnet,250,108000000,108120944,120945,113829,7116,0.058836661292322956,2021-11-22 07:31:46 UTC
794098,mainnet,250,108000000,108121237,121238,114117,7121,0.058735709925930815,2021-11-22 07:34:11 UTC
794099,mainnet,250,108000000,108121509,121510,114387,7123,0.05862068965517241,2021-11-22 07:36:26 UTC
794101,mainnet,250,108000000,108121778,121779,114647,7132,0.0585651056421879,2021-11-22 07:38:44 UTC
794102,mainnet,250,108000000,108122058,122059,114923,7136,0.05846352993224588,2021-11-22 07:41:00 UTC
794104,mainnet,250,108000000,108122324,122325,115179,7146,0.05841814837522992,2021-11-22 07:43:13 UTC
794105,mainnet,250,108000000,108122596,122597,115441,7156,0.058370106935732524,2021-11-22 07:45:33 UTC
794107,mainnet,250,108000000,108122867,122868,115682,7186,0.05848552918579288,2021-11-22 07:47:52 UTC
794108,mainnet,250,108000000,108123148,123149,115948,7201,0.05847388123330275,2021-11-22 07:50:20 UTC
794110,mainnet,250,108000000,108123415,123416,116204,7212,0.058436507422052246,2021-11-22 07:52:39 UTC
794111,mainnet,250,108000000,108123701,123702,116489,7213,0.058309485699503644,2021-11-22 07:55:07 UTC
794113,mainnet,250,108000000,108123966,123967,116748,7219,0.05823323949115491,2021-11-22 07:57:28 UTC
794114,mainnet,250,108000000,108124281,124282,117034,7248,0.05831898424550619,2021-11-22 08:00:00 UTC
794116,mainnet,250,108000000,108124566,124567,117315,7252,0.058217665995006704,2021-11-22 08:02:28 UTC
794117,mainnet,250,108000000,108124854,124855,117591,7264,0.05817948820631933,2021-11-22 08:04:53 UTC
794119,mainnet,250,108000000,108125116,125117,117836,7281,0.05819353085511961,2021-11-22 08:07:09 UTC
794120,mainnet,250,108000000,108125371,125372,118085,7287,0.058123025874996015,2021-11-22 08:09:27 UTC
794121,mainnet,250,108000000,108125642,125643,118347,7296,0.058069291564193784,2021-11-22 08:11:48 UTC
794123,mainnet,250,108000000,108125932,125933,118628,7305,0.0580070354871241,2021-11-22 08:14:04 UTC
794124,mainnet,250,108000000,108126202,126203,118880,7323,0.05802556199139482,2021-11-22 08:16:25 UTC
794126,mainnet,250,108000000,108126475,126476,119138,7338,0.05801891267908536,2021-11-22 08:18:39 UTC
794127,mainnet,250,108000000,108126767,126768,119414,7354,0.05801148554840338,2021-11-22 08:21:10 UTC
794129,mainnet,250,108000000,108127058,127059,119689,7370,0.05800454906775592,2021-11-22 08:23:37 UTC
794130,mainnet,250,108000000,108127339,127340,119965,7375,0.05791581592586775,2021-11-22 08:25:58 UTC
794132,mainnet,250,108000000,108127623,127624,120229,7395,0.05794364696295368,2021-11-22 08:28:33 UTC
794134,mainnet,250,108000000,108127916,127917,120498,7419,0.057998545932127867,2021-11-22 08:31:03 UTC
794135,mainnet,250,108000000,108128214,128215,120782,7433,0.05797293608392154,2021-11-22 08:33:30 UTC
794137,mainnet,250,108000000,108128481,128482,121039,7443,0.05793029373764418,2021-11-22 08:35:54 UTC
794138,mainnet,250,108000000,108128826,128827,121377,7450,0.057829492264820266,2021-11-22 08:38:42 UTC
794140,mainnet,250,108000000,108129140,129141,121682,7459,0.0577585739617937,2021-11-22 08:41:13 UTC
794141,mainnet,250,108000000,108129431,129432,121950,7482,0.05780641572408678,2021-11-22 08:43:40 UTC
794143,mainnet,250,108000000,108129719,129720,122220,7500,0.057816836262719704,2021-11-22 08:46:01 UTC
794144,mainnet,250,108000000,108129989,129990,122482,7508,0.057758289099161475,2021-11-22 08:48:17 UTC
794145,mainnet,250,108000000,108130257,130258,122732,7526,0.05777764129650386,2021-11-22 08:50:38 UTC
794147,mainnet,250,108000000,108130545,130546,122996,7550,0.05783402019211619,2021-11-22 08:52:59 UTC
794148,mainnet,250,108000000,108130808,130809,123240,7569,0.05786299107859551,2021-11-22 08:55:25 UTC
794150,mainnet,250,108000000,108131103,131104,123523,7581,0.057824322675128145,2021-11-22 08:57:48 UTC
794151,mainnet,250,108000000,108131376,131377,123783,7594,0.05780311622277872,2021-11-22 09:00:05 UTC
794153,mainnet,250,108000000,108131666,131667,124069,7598,0.057706183022321465,2021-11-22 09:02:24 UTC
794154,mainnet,250,108000000,108131939,131940,124279,7661,0.05806427163862362,2021-11-22 09:04:49 UTC
794155,mainnet,250,108000000,108132201,132202,124509,7693,0.058191252779836916,2021-11-22 09:07:13 UTC
794157,mainnet,250,108000000,108132469,132470,124755,7715,0.05823960141918925,2021-11-22 09:09:31 UTC
794158,mainnet,250,108000000,108132749,132750,125016,7734,0.05825988700564972,2021-11-22 09:12:03 UTC
794159,mainnet,250,108000000,108133046,133047,125308,7739,0.05816741452268747,2021-11-22 09:14:44 UTC
794161,mainnet,250,108000000,108133336,133337,125582,7755,0.05816090057523418,2021-11-22 09:17:09 UTC
794162,mainnet,250,108000000,108133616,133617,125844,7773,0.05817373537798334,2021-11-22 09:19:28 UTC
794164,mainnet,250,108000000,108133877,133878,126077,7801,0.058269469218243476,2021-11-22 09:21:44 UTC
794165,mainnet,250,108000000,108134164,134165,126361,7804,0.05816718220102113,2021-11-22 09:24:12 UTC
794167,mainnet,250,108000000,108134440,134441,126614,7827,0.0582188469291362,2021-11-22 09:26:35 UTC
794168,mainnet,250,108000000,108134705,134706,126873,7833,0.058148857511914835,2021-11-22 09:28:49 UTC
794170,mainnet,250,108000000,108134973,134974,127128,7846,0.05812971387081956,2021-11-22 09:31:12 UTC
794171,mainnet,250,108000000,108135230,135231,127353,7878,0.05825587328349269,2021-11-22 09:33:30 UTC
794172,mainnet,250,108000000,108135505,135506,127611,7895,0.05826310274083804,2021-11-22 09:35:55 UTC
794174,mainnet,250,108000000,108135775,135776,127876,7900,0.058184067876502474,2021-11-22 09:38:14 UTC
794175,mainnet,250,108000000,108136025,136026,128103,7923,0.05824621763486392,2021-11-22 09:40:37 UTC
794177,mainnet,250,108000000,108136284,136285,128349,7936,0.058230913159922223,2021-11-22 09:42:50 UTC
794178,mainnet,250,108000000,108136564,136565,128616,7949,0.058206714751217366,2021-11-22 09:45:15 UTC
794180,mainnet,250,108000000,108136847,136848,128873,7975,0.05827633578861218,2021-11-22 09:47:44 UTC
794181,mainnet,250,108000000,108137080,137081,129099,7982,0.058228346743895945,2021-11-22 09:49:58 UTC
794183,mainnet,250,108000000,108137428,137429,129396,8033,0.05845200066943658,2021-11-22 09:52:34 UTC
794184,mainnet,250,108000000,108137611,137612,129555,8057,0.05854867308083597,2021-11-22 09:54:51 UTC
794186,mainnet,250,108000000,108137775,137776,129670,8106,0.05883463012425967,2021-11-22 09:57:08 UTC
794187,mainnet,250,108000000,108137994,137995,129827,8168,0.059190550382260225,2021-11-22 09:59:24 UTC
794189,mainnet,250,108000000,108138144,138145,129933,8212,0.05944478627529046,2021-11-22 10:01:40 UTC
794190,mainnet,250,108000000,108138415,138416,130095,8321,0.06011588255692984,2021-11-22 10:03:57 UTC
794192,mainnet,250,108000000,108138611,138612,130223,8389,0.06052145557383199,2021-11-22 10:06:17 UTC
794193,mainnet,250,108000000,108138811,138812,130350,8462,0.06096014753767686,2021-11-22 10:08:50 UTC
794195,mainnet,250,108000000,108139037,139038,130493,8545,0.06145801867115465,2021-11-22 10:11:02 UTC
794196,mainnet,250,108000000,108139204,139205,130614,8591,0.06171473725800079,2021-11-22 10:13:36 UTC
794198,mainnet,250,108000000,108139457,139458,130776,8682,0.06225530267177214,2021-11-22 10:15:44 UTC
794199,mainnet,250,108000000,108139609,139610,130902,8708,0.06237375546164315,2021-11-22 10:18:04 UTC
794200,mainnet,250,108000000,108139847,139848,131062,8786,0.06282535324066128,2021-11-22 10:20:20 UTC
794202,mainnet,250,108000000,108140008,140009,131191,8818,0.062981665464363,2021-11-22 10:22:30 UTC
794203,mainnet,250,108000000,108140239,140240,131346,8894,0.06341985168282943,2021-11-22 10:24:57 UTC
794205,mainnet,250,108000000,108140441,140442,131515,8927,0.06356360632859116,2021-11-22 10:27:26 UTC
794206,mainnet,250,108000000,108140644,140645,131680,8965,0.06374204557574034,2021-11-22 10:29:36 UTC
794208,mainnet,250,108000000,108140816,140817,131832,8985,0.06380621657896418,2021-11-22 10:31:46 UTC
794209,mainnet,250,108000000,108141018,141019,131992,9027,0.0640126507775548,2021-11-22 10:33:55 UTC
794211,mainnet,250,108000000,108141268,141269,132189,9080,0.06427454006186778,2021-11-22 10:36:20 UTC
794212,mainnet,250,108000000,108141453,141454,132357,9097,0.0643106592956014,2021-11-22 10:38:35 UTC
794213,mainnet,250,108000000,108141721,141722,132590,9132,0.06443600852372955,2021-11-22 10:40:56 UTC
794215,mainnet,250,108000000,108141952,141953,132793,9160,0.06452840024515157,2021-11-22 10:43:10 UTC
794216,mainnet,250,108000000,108142228,142229,133046,9183,0.06456489182937375,2021-11-22 10:45:41 UTC
794218,mainnet,250,108000000,108142465,142466,133252,9214,0.0646750803700532,2021-11-22 10:47:50 UTC
794219,mainnet,250,108000000,108142699,142700,133473,9227,0.06466012613875263,2021-11-22 10:50:08 UTC
794221,mainnet,250,108000000,108142992,142993,133733,9260,0.06475841474757506,2021-11-22 10:52:46 UTC
794222,mainnet,250,108000000,108143243,143244,133969,9275,0.06474965792633548,2021-11-22 10:55:03 UTC
794224,mainnet,250,108000000,108143467,143468,134183,9285,0.06471826470014219,2021-11-22 10:57:21 UTC
794225,mainnet,250,108000000,108143710,143711,134424,9287,0.06462274982430016,2021-11-22 10:59:40 UTC
794227,mainnet,250,108000000,108143972,143973,134676,9297,0.06457460773895106,2021-11-22 11:02:11 UTC
794228,mainnet,250,108000000,108144230,144231,134913,9318,0.06460469663248539,2021-11-22 11:04:24 UTC
794230,mainnet,250,108000000,108144497,144498,135158,9340,0.06463757283837838,2021-11-22 11:06:41 UTC
794231,mainnet,250,108000000,108144732,144733,135389,9344,0.06456025923597244,2021-11-22 11:08:53 UTC
794233,mainnet,250,108000000,108144963,144964,135610,9354,0.0645263651665241,2021-11-22 11:11:10 UTC
794234,mainnet,250,108000000,108145223,145224,135839,9385,0.06462430452266843,2021-11-22 11:13:27 UTC
794235,mainnet,250,108000000,108145467,145468,136077,9391,0.06455715346330465,2021-11-22 11:15:48 UTC
794237,mainnet,250,108000000,108145869,145870,136458,9412,0.06452320559402207,2021-11-22 11:18:05 UTC
794238,mainnet,250,108000000,108146156,146157,136716,9441,0.06459492189905376,2021-11-22 11:20:25 UTC
794239,mainnet,250,108000000,108146456,146457,137012,9445,0.06448991854264391,2021-11-22 11:22:53 UTC
794240,mainnet,250,108000000,108146741,146742,137288,9454,0.0644259993730493,2021-11-22 11:25:15 UTC
794242,mainnet,250,108000000,108147020,147021,137557,9464,0.06437175641575013,2021-11-22 11:27:34 UTC
794243,mainnet,250,108000000,108147300,147301,137822,9479,0.06435122640036388,2021-11-22 11:30:02 UTC
794245,mainnet,250,108000000,108147568,147569,138085,9484,0.06426824061964234,2021-11-22 11:32:21 UTC
794246,mainnet,250,108000000,108147826,147827,138327,9500,0.0642643089557388,2021-11-22 11:34:44 UTC
794248,mainnet,250,108000000,108148114,148115,138615,9500,0.06413935117982648,2021-11-22 11:37:06 UTC
794249,mainnet,250,108000000,108148394,148395,138879,9516,0.06412614980289093,2021-11-22 11:39:25 UTC
794251,mainnet,250,108000000,108148693,148694,139164,9530,0.06409135540102492,2021-11-22 11:41:58 UTC
794253,mainnet,250,108000000,108148955,148956,139420,9536,0.0640189049115175,2021-11-22 11:44:13 UTC
794254,mainnet,250,108000000,108149228,149229,139685,9544,0.06395539740935073,2021-11-22 11:46:30 UTC
794256,mainnet,250,108000000,108149513,149514,139961,9553,0.0638936821969849,2021-11-22 11:48:52 UTC
794257,mainnet,250,108000000,108149783,149784,140220,9564,0.0638519468033969,2021-11-22 11:51:10 UTC
794259,mainnet,250,108000000,108150059,150060,140476,9584,0.0638677862188458,2021-11-22 11:53:42 UTC
794260,mainnet,250,108000000,108150335,150336,140741,9595,0.06382370157513835,2021-11-22 11:56:12 UTC
794262,mainnet,250,108000000,108150620,150621,141002,9619,0.06386227684054681,2021-11-22 11:58:40 UTC
794263,mainnet,250,108000000,108150894,150895,141255,9640,0.06388548328307764,2021-11-22 12:01:05 UTC
794264,mainnet,250,108000000,108151178,151179,141510,9669,0.06395729565614272,2021-11-22 12:03:44 UTC
794266,mainnet,250,108000000,108151261,151262,141578,9684,0.06402136689981622,2021-11-22 12:06:16 UTC
794267,mainnet,250,108000000,108151596,151597,141878,9719,0.06411076736347025,2021-11-22 12:08:41 UTC
794269,mainnet,250,108000000,108152054,152055,142307,9748,0.06410838183552005,2021-11-22 12:11:33 UTC
794270,mainnet,250,108000000,108152320,152321,142563,9758,0.06406207942437353,2021-11-22 12:13:52 UTC
794272,mainnet,250,108000000,108152555,152556,142783,9773,0.06406172159731509,2021-11-22 12:16:06 UTC
794274,mainnet,250,108000000,108152804,152805,143019,9786,0.06404240698930008,2021-11-22 12:18:28 UTC
794275,mainnet,250,108000000,108153077,153078,143264,9814,0.06411110675603288,2021-11-22 12:20:53 UTC
794276,mainnet,250,108000000,108153349,153350,143516,9834,0.0641278121943267,2021-11-22 12:23:20 UTC
794278,mainnet,250,108000000,108153628,153629,143774,9855,0.06414804496546876,2021-11-22 12:25:38 UTC
794280,mainnet,250,108000000,108153897,153898,144030,9868,0.06412039142808873,2021-11-22 12:28:08 UTC
794281,mainnet,250,108000000,108154203,154204,144297,9907,0.0642460636559363,2021-11-22 12:30:44 UTC
794283,mainnet,250,108000000,108154450,154451,144529,9922,0.06424043871519122,2021-11-22 12:33:00 UTC
794284,mainnet,250,108000000,108154721,154722,144774,9948,0.06429596308217318,2021-11-22 12:35:40 UTC
794286,mainnet,250,108000000,108154985,154986,145013,9973,0.06434774753848735,2021-11-22 12:37:58 UTC
794287,mainnet,250,108000000,108155264,155265,145269,9996,0.064380253115641,2021-11-22 12:40:30 UTC
794289,mainnet,250,108000000,108155529,155530,145508,10022,0.06443772905548768,2021-11-22 12:42:48 UTC
794290,mainnet,250,108000000,108155807,155808,145769,10039,0.06443186485931403,2021-11-22 12:45:17 UTC
794291,mainnet,250,108000000,108156058,156059,146002,10057,0.06444357582709104,2021-11-22 12:47:47 UTC
794293,mainnet,250,108000000,108156393,156394,146318,10076,0.06442702405463126,2021-11-22 12:50:26 UTC
794294,mainnet,250,108000000,108156678,156679,146577,10102,0.06447577531130529,2021-11-22 12:52:59 UTC
794296,mainnet,250,108000000,108156951,156952,146830,10122,0.06449105458993833,2021-11-22 12:55:22 UTC
794297,mainnet,250,108000000,108157214,157215,147072,10143,0.06451674458544032,2021-11-22 12:57:40 UTC
794298,mainnet,250,108000000,108157488,157489,147328,10161,0.06451879178863286,2021-11-22 12:59:53 UTC
794300,mainnet,250,108000000,108157772,157773,147600,10173,0.06447871308779068,2021-11-22 13:02:18 UTC
794301,mainnet,250,108000000,108158063,158064,147881,10183,0.06442327158619293,2021-11-22 13:04:46 UTC
794303,mainnet,250,108000000,108158357,158358,148155,10203,0.06442996249005419,2021-11-22 13:07:17 UTC
794304,mainnet,250,108000000,108158623,158624,148408,10216,0.06440387331047004,2021-11-22 13:09:45 UTC
794306,mainnet,250,108000000,108158916,158917,148660,10257,0.06454312628604869,2021-11-22 13:12:16 UTC
794307,mainnet,250,108000000,108159218,159219,148937,10282,0.06457771999572916,2021-11-22 13:15:06 UTC
794309,mainnet,250,108000000,108159536,159537,149224,10313,0.06464331158289299,2021-11-22 13:18:00 UTC
794311,mainnet,250,108000000,108159826,159827,149490,10337,0.06467618112083691,2021-11-22 13:20:42 UTC
794312,mainnet,250,108000000,108160098,160099,149733,10366,0.06474743752303262,2021-11-22 13:23:07 UTC
794314,mainnet,250,108000000,108160376,160377,149994,10383,0.06474120353916085,2021-11-22 13:25:27 UTC
794315,mainnet,250,108000000,108160671,160672,150278,10394,0.06469079864568811,2021-11-22 13:27:58 UTC
794317,mainnet,250,108000000,108160777,160778,150375,10403,0.06470412618641853,2021-11-22 13:30:30 UTC
794318,mainnet,250,108000000,108161043,161044,150617,10427,0.06474628051960955,2021-11-22 13:32:57 UTC
794320,mainnet,250,108000000,108161438,161439,150986,10453,0.06474891445065938,2021-11-22 13:35:18 UTC
794321,mainnet,250,108000000,108161488,161489,151034,10455,0.06474125172612376,2021-11-22 13:37:29 UTC
794323,mainnet,250,108000000,108161763,161764,151269,10495,0.06487846492421058,2021-11-22 13:39:54 UTC
794324,mainnet,250,108000000,108161997,161998,151479,10519,0.06493290040617786,2021-11-22 13:42:24 UTC
794326,mainnet,250,108000000,108162410,162411,151847,10564,0.06504485533615334,2021-11-22 13:44:43 UTC
794327,mainnet,250,108000000,108162669,162670,152098,10572,0.06499047150673141,2021-11-22 13:46:59 UTC
794329,mainnet,250,108000000,108162907,162908,152323,10585,0.06497532349546983,2021-11-22 13:49:11 UTC
794330,mainnet,250,108000000,108162967,162968,152379,10589,0.0649759461980266,2021-11-22 13:51:25 UTC
794332,mainnet,250,108000000,108163391,163392,152780,10612,0.06494810027418724,2021-11-22 13:53:39 UTC
794333,mainnet,250,108000000,108163654,163655,153028,10627,0.06493538235923131,2021-11-22 13:55:59 UTC
794335,mainnet,250,108000000,108163897,163898,153247,10651,0.06498553978694066,2021-11-22 13:58:18 UTC
794336,mainnet,250,108000000,108164165,164166,153492,10674,0.06501955337889698,2021-11-22 14:00:44 UTC
794338,mainnet,250,108000000,108164425,164426,153736,10690,0.06501404887304928,2021-11-22 14:03:07 UTC
794339,mainnet,250,108000000,108164696,164697,153987,10710,0.06502850689447895,2021-11-22 14:05:32 UTC
794340,mainnet,250,108000000,108164985,164986,154254,10732,0.0650479434618695,2021-11-22 14:07:57 UTC
794342,mainnet,250,108000000,108165226,165227,154478,10749,0.0650559533248198,2021-11-22 14:10:15 UTC
794343,mainnet,250,108000000,108165510,165511,154743,10768,0.06505911993764765,2021-11-22 14:12:34 UTC
794345,mainnet,250,108000000,108165817,165818,155040,10778,0.06499897477957761,2021-11-22 14:15:12 UTC
794346,mainnet,250,108000000,108166082,166083,155293,10790,0.06496751624187906,2021-11-22 14:17:38 UTC
794348,mainnet,250,108000000,108166342,166343,155547,10796,0.06490203976121628,2021-11-22 14:20:01 UTC
794349,mainnet,250,108000000,108166621,166622,155799,10823,0.06495540804935723,2021-11-22 14:22:25 UTC
794351,mainnet,250,108000000,108166920,166921,156068,10853,0.06501878133967566,2021-11-22 14:24:59 UTC
794353,mainnet,250,108000000,108167186,167187,156323,10864,0.06498112891552572,2021-11-22 14:27:22 UTC
794354,mainnet,250,108000000,108167445,167446,156560,10886,0.06501200386990433,2021-11-22 14:29:41 UTC
794356,mainnet,250,108000000,108167737,167738,156830,10908,0.06502998724200837,2021-11-22 14:32:10 UTC
794357,mainnet,250,108000000,108167993,167994,157078,10916,0.06497851113730252,2021-11-22 14:34:33 UTC
794359,mainnet,250,108000000,108168262,168263,157338,10925,0.0649281184811872,2021-11-22 14:36:51 UTC
794360,mainnet,250,108000000,108168529,168530,157590,10940,0.06491425858897526,2021-11-22 14:39:10 UTC
794362,mainnet,250,108000000,108168788,168789,157838,10951,0.06487982036744101,2021-11-22 14:41:31 UTC
794363,mainnet,250,108000000,108169054,169055,158082,10973,0.06490787021975097,2021-11-22 14:43:48 UTC
794365,mainnet,250,108000000,108169298,169299,158295,11004,0.06499743058139741,2021-11-22 14:46:08 UTC
794366,mainnet,250,108000000,108169525,169526,158505,11021,0.06501067682833311,2021-11-22 14:48:30 UTC
794368,mainnet,250,108000000,108169810,169811,158761,11050,0.06507234513665193,2021-11-22 14:50:49 UTC
794369,mainnet,250,108000000,108170056,170057,158996,11061,0.06504289738146621,2021-11-22 14:53:08 UTC
794371,mainnet,250,108000000,108170345,170346,159270,11076,0.06502060512134127,2021-11-22 14:55:29 UTC
794372,mainnet,250,108000000,108170620,170621,159528,11093,0.06501544358549065,2021-11-22 14:57:50 UTC
794374,mainnet,250,108000000,108170895,170896,159792,11104,0.06497518958898979,2021-11-22 15:00:16 UTC
794375,mainnet,250,108000000,108171169,171170,160051,11119,0.0649588128760881,2021-11-22 15:02:37 UTC
794376,mainnet,250,108000000,108171419,171420,160288,11132,0.06493991366234979,2021-11-22 15:04:48 UTC
794378,mainnet,250,108000000,108171690,171691,160547,11144,0.06490730440151202,2021-11-22 15:07:06 UTC
794379,mainnet,250,108000000,108171923,171924,160766,11158,0.06490077010772202,2021-11-22 15:09:18 UTC
794381,mainnet,250,108000000,108172154,172155,160962,11193,0.06501699050274462,2021-11-22 15:11:38 UTC
794382,mainnet,250,108000000,108172427,172428,161220,11208,0.06500104391398148,2021-11-22 15:13:54 UTC
794384,mainnet,250,108000000,108172665,172666,161447,11219,0.06497515434422527,2021-11-22 15:16:11 UTC
794385,mainnet,250,108000000,108172918,172919,161678,11241,0.06500731556393456,2021-11-22 15:18:31 UTC
794386,mainnet,250,108000000,108173147,173148,161891,11257,0.06501374546630628,2021-11-22 15:20:48 UTC
794387,mainnet,250,108000000,108173446,173447,162160,11287,0.065074633749791,2021-11-22 15:23:15 UTC
794389,mainnet,250,108000000,108173701,173702,162391,11311,0.06511726980691068,2021-11-22 15:25:32 UTC
794390,mainnet,250,108000000,108173949,173950,162623,11327,0.06511641276228801,2021-11-22 15:27:51 UTC
794392,mainnet,250,108000000,108174223,174224,162865,11359,0.06519767655432088,2021-11-22 15:30:20 UTC
794393,mainnet,250,108000000,108174476,174477,163101,11376,0.0652005708488798,2021-11-22 15:32:47 UTC
794395,mainnet,250,108000000,108174753,174754,163362,11392,0.06518877965597354,2021-11-22 15:35:03 UTC
794396,mainnet,250,108000000,108175017,175018,163600,11418,0.06523900398816122,2021-11-22 15:37:22 UTC
794398,mainnet,250,108000000,108175296,175297,163849,11448,0.06530630872176935,2021-11-22 15:39:50 UTC
794399,mainnet,250,108000000,108175563,175564,164104,11460,0.06527534118612016,2021-11-22 15:42:21 UTC
794400,mainnet,250,108000000,108175840,175841,164360,11481,0.06529193987750297,2021-11-22 15:44:35 UTC
794402,mainnet,250,108000000,108176100,176101,164609,11492,0.06525800534920301,2021-11-22 15:47:06 UTC
794404,mainnet,250,108000000,108176373,176374,164872,11502,0.06521369362831256,2021-11-22 15:49:40 UTC
794405,mainnet,250,108000000,108176481,176482,164972,11510,0.06521911583050963,2021-11-22 15:52:02 UTC
794407,mainnet,250,108000000,108176892,176893,165344,11549,0.06528805549117263,2021-11-22 15:54:25 UTC
794408,mainnet,250,108000000,108177150,177151,165585,11566,0.06528893429898787,2021-11-22 15:56:41 UTC
794410,mainnet,250,108000000,108177400,177401,165821,11580,0.06527584399186025,2021-11-22 15:58:58 UTC
794411,mainnet,250,108000000,108177536,177537,165946,11591,0.06528779916299138,2021-11-22 16:01:20 UTC
794412,mainnet,250,108000000,108177784,177785,166175,11610,0.06530359704137019,2021-11-22 16:03:36 UTC
794414,mainnet,250,108000000,108178005,178006,166385,11621,0.06528431625900251,2021-11-22 16:05:47 UTC
794415,mainnet,250,108000000,108178248,178249,166614,11635,0.06527385847886945,2021-11-22 16:08:05 UTC
794417,mainnet,250,108000000,108178486,178487,166837,11650,0.06527086006263762,2021-11-22 16:10:27 UTC
794418,mainnet,250,108000000,108178875,178876,167208,11668,0.0652295444889197,2021-11-22 16:12:46 UTC
794420,mainnet,250,108000000,108178989,178990,167314,11676,0.06523269456394212,2021-11-22 16:15:12 UTC
794421,mainnet,250,108000000,108179226,179227,167523,11704,0.06530266087140889,2021-11-22 16:17:30 UTC
794423,mainnet,250,108000000,108179452,179453,167733,11720,0.06530957966709947,2021-11-22 16:19:44 UTC
794424,mainnet,250,108000000,108179728,179729,167979,11750,0.06537620528684854,2021-11-22 16:22:17 UTC
794425,mainnet,250,108000000,108180158,180159,168383,11776,0.0653644835950466,2021-11-22 16:24:33 UTC
794427,mainnet,250,108000000,108180274,180275,168486,11789,0.06539453612536403,2021-11-22 16:27:02 UTC
794428,mainnet,250,108000000,108180683,180684,168874,11810,0.06536273272674946,2021-11-22 16:29:22 UTC
794430,mainnet,250,108000000,108180969,180970,169132,11838,0.06541415704260374,2021-11-22 16:31:42 UTC
794431,mainnet,250,108000000,108181217,181218,169374,11844,0.06535774591927954,2021-11-22 16:34:01 UTC
794433,mainnet,250,108000000,108181455,181456,169601,11855,0.06533264262410722,2021-11-22 16:36:38 UTC
794435,mainnet,250,108000000,108181749,181750,169858,11892,0.06543053645116918,2021-11-22 16:38:57 UTC
794436,mainnet,250,108000000,108181864,181865,169966,11899,0.06542765237951227,2021-11-22 16:41:17 UTC
794438,mainnet,250,108000000,108182155,182156,170228,11928,0.06548233382375546,2021-11-22 16:43:47 UTC
794439,mainnet,250,108000000,108182413,182414,170473,11941,0.06546098435427106,2021-11-22 16:46:15 UTC
794441,mainnet,250,108000000,108182813,182814,170845,11969,0.06547091579419519,2021-11-22 16:48:31 UTC
794442,mainnet,250,108000000,108182912,182913,170944,11969,0.06543548025564067,2021-11-22 16:50:48 UTC
794444,mainnet,250,108000000,108183150,183151,171158,11993,0.06548148795256373,2021-11-22 16:53:04 UTC
794445,mainnet,250,108000000,108183409,183410,171385,12025,0.06556349163077259,2021-11-22 16:55:33 UTC
794447,mainnet,250,108000000,108183667,183668,171624,12044,0.06557484156194873,2021-11-22 16:57:43 UTC
794448,mainnet,250,108000000,108183916,183917,171848,12069,0.06562199252923873,2021-11-22 16:59:54 UTC
794450,mainnet,250,108000000,108184180,184181,172094,12087,0.06562566171320604,2021-11-22 17:02:11 UTC
794451,mainnet,250,108000000,108184443,184444,172323,12121,0.06571642341306846,2021-11-22 17:04:32 UTC
794453,mainnet,250,108000000,108184825,184826,172662,12164,0.06581325138238127,2021-11-22 17:06:48 UTC
794454,mainnet,250,108000000,108185032,185033,172841,12192,0.06589094918203779,2021-11-22 17:09:25 UTC
794456,mainnet,250,108000000,108185278,185279,173070,12209,0.0658952174828232,2021-11-22 17:11:42 UTC
794457,mainnet,250,108000000,108185528,185529,173296,12233,0.06593578362412346,2021-11-22 17:13:52 UTC
794459,mainnet,250,108000000,108185827,185828,173557,12271,0.06603418214693157,2021-11-22 17:16:34 UTC
794461,mainnet,250,108000000,108186087,186088,173800,12288,0.06603327457976871,2021-11-22 17:18:42 UTC
794462,mainnet,250,108000000,108186366,186367,174033,12334,0.06618124453363525,2021-11-22 17:21:12 UTC
794464,mainnet,250,108000000,108186633,186634,174253,12381,0.06633839493339906,2021-11-22 17:23:26 UTC
794465,mainnet,250,108000000,108186888,186889,174487,12402,0.0663602459213758,2021-11-22 17:25:50 UTC
794466,mainnet,250,108000000,108187158,187159,174734,12425,0.06638740322399671,2021-11-22 17:28:16 UTC
794468,mainnet,250,108000000,108187385,187386,174949,12437,0.06637102024697683,2021-11-22 17:30:25 UTC
794469,mainnet,250,108000000,108187648,187649,175186,12463,0.06641655431150713,2021-11-22 17:32:37 UTC
794471,mainnet,250,108000000,108187912,187913,175428,12485,0.06644032078674705,2021-11-22 17:35:06 UTC
794472,mainnet,250,108000000,108188328,188329,175822,12507,0.06641037758390901,2021-11-22 17:37:32 UTC
794474,mainnet,250,108000000,108188608,188609,176086,12523,0.06639661946142549,2021-11-22 17:39:52 UTC
794475,mainnet,250,108000000,108188886,188887,176354,12533,0.06635183998898812,2021-11-22 17:42:09 UTC
794477,mainnet,250,108000000,108189163,189164,176621,12543,0.06630754266139434,2021-11-22 17:44:39 UTC
794478,mainnet,250,108000000,108189419,189420,176867,12553,0.06627072114876993,2021-11-22 17:47:13 UTC
794480,mainnet,250,108000000,108189697,189698,177130,12568,0.0662526753049584,2021-11-22 17:49:44 UTC
794481,mainnet,250,108000000,108189967,189968,177390,12578,0.06621115135180662,2021-11-22 17:52:12 UTC
794483,mainnet,250,108000000,108190293,190294,177694,12600,0.06621333305306526,2021-11-22 17:54:45 UTC
794485,mainnet,250,108000000,108190577,190578,177970,12608,0.06615663927630681,2021-11-22 17:57:19 UTC
794486,mainnet,250,108000000,108190849,190850,178226,12624,0.06614618810584229,2021-11-22 17:59:56 UTC
794488,mainnet,250,108000000,108191133,191134,178497,12637,0.06611591867485639,2021-11-22 18:02:24 UTC
794489,mainnet,250,108000000,108191411,191412,178747,12665,0.06616617557937851,2021-11-22 18:04:45 UTC
794491,mainnet,250,108000000,108191676,191677,178992,12685,0.06617904078214913,2021-11-22 18:07:01 UTC
794492,mainnet,250,108000000,108191963,191964,179269,12695,0.06613219145256402,2021-11-22 18:09:29 UTC
794493,mainnet,250,108000000,108192252,192253,179550,12703,0.0660743915569588,2021-11-22 18:11:57 UTC
794495,mainnet,250,108000000,108192504,192505,179792,12713,0.0660398431209579,2021-11-22 18:14:13 UTC
794496,mainnet,250,108000000,108192766,192767,180036,12731,0.0660434617958468,2021-11-22 18:16:34 UTC
794498,mainnet,250,108000000,108193024,193025,180283,12742,0.06601217458878383,2021-11-22 18:19:02 UTC
794499,mainnet,250,108000000,108193347,193348,180584,12764,0.06601568156898442,2021-11-22 18:21:41 UTC
794501,mainnet,250,108000000,108193583,193584,180790,12794,0.0660901727415489,2021-11-22 18:23:55 UTC
794502,mainnet,250,108000000,108193844,193845,181027,12818,0.06612499677577446,2021-11-22 18:26:13 UTC
794504,mainnet,250,108000000,108194123,194124,181277,12847,0.06617934928190229,2021-11-22 18:28:30 UTC
794505,mainnet,250,108000000,108194400,194401,181550,12851,0.06610562702866755,2021-11-22 18:30:51 UTC
794506,mainnet,250,108000000,108194670,194671,181806,12865,0.06608585767782567,2021-11-22 18:33:14 UTC
794508,mainnet,250,108000000,108194955,194956,182074,12882,0.0660764480190402,2021-11-22 18:35:42 UTC
794509,mainnet,250,108000000,108195198,195199,182307,12892,0.06604542031465326,2021-11-22 18:38:10 UTC
794511,mainnet,250,108000000,108195475,195476,182572,12904,0.06601321901409891,2021-11-22 18:40:33 UTC
794512,mainnet,250,108000000,108195724,195725,182802,12923,0.06602631242815174,2021-11-22 18:42:58 UTC
794514,mainnet,250,108000000,108195999,196000,183059,12941,0.06602551020408164,2021-11-22 18:45:22 UTC
794515,mainnet,250,108000000,108196232,196233,183278,12955,0.06601845764983463,2021-11-22 18:47:38 UTC
794517,mainnet,250,108000000,108196489,196490,183516,12974,0.06602880553717747,2021-11-22 18:50:02 UTC
794518,mainnet,250,108000000,108196774,196775,183787,12988,0.06600431965442764,2021-11-22 18:52:31 UTC
794519,mainnet,250,108000000,108197041,197042,184045,12997,0.06596055663259609,2021-11-22 18:54:53 UTC
794521,mainnet,250,108000000,108197304,197305,184286,13019,0.06598413623577709,2021-11-22 18:57:11 UTC
794522,mainnet,250,108000000,108197546,197547,184512,13035,0.0659842974077055,2021-11-22 18:59:34 UTC
794524,mainnet,250,108000000,108197797,197798,184745,13053,0.06599156715436962,2021-11-22 19:02:06 UTC
794525,mainnet,250,108000000,108198047,198048,184973,13075,0.06601934884472452,2021-11-22 19:04:22 UTC
794527,mainnet,250,108000000,108198302,198303,185217,13086,0.0659899245094628,2021-11-22 19:07:05 UTC
794529,mainnet,250,108000000,108198576,198577,185469,13108,0.06600965872180564,2021-11-22 19:09:36 UTC
794530,mainnet,250,108000000,108198828,198829,185705,13124,0.0660064678693752,2021-11-22 19:11:53 UTC
794532,mainnet,250,108000000,108199116,199117,185976,13141,0.06599637399117102,2021-11-22 19:14:16 UTC
794533,mainnet,250,108000000,108199361,199362,186204,13158,0.06600054172811268,2021-11-22 19:16:35 UTC
794535,mainnet,250,108000000,108199628,199629,186459,13170,0.06597237876260463,2021-11-22 19:19:07 UTC
794536,mainnet,250,108000000,108199864,199865,186668,13197,0.06602956995972281,2021-11-22 19:21:25 UTC
794538,mainnet,250,108000000,108200128,200129,186883,13246,0.0661873091855753,2021-11-22 19:23:49 UTC
794539,mainnet,250,108000000,108200343,200344,187088,13256,0.06616619414606877,2021-11-22 19:26:10 UTC
794541,mainnet,250,108000000,108200617,200618,187332,13286,0.06622536362639445,2021-11-22 19:28:26 UTC
794542,mainnet,250,108000000,108200843,200844,187510,13334,0.06638983489673578,2021-11-22 19:30:38 UTC
794544,mainnet,250,108000000,108201060,201061,187684,13377,0.06653204748807576,2021-11-22 19:32:58 UTC
794545,mainnet,250,108000000,108201327,201328,187914,13414,0.06662759278391481,2021-11-22 19:35:24 UTC
794547,mainnet,250,108000000,108201569,201570,188141,13429,0.06662201716525276,2021-11-22 19:37:51 UTC
794548,mainnet,250,108000000,108201789,201790,188336,13454,0.06667327419594628,2021-11-22 19:40:12 UTC
794549,mainnet,250,108000000,108202060,202061,188574,13487,0.06674717040893592,2021-11-22 19:42:30 UTC
794551,mainnet,250,108000000,108202300,202301,188783,13518,0.06682122184269974,2021-11-22 19:44:55 UTC
794552,mainnet,250,108000000,108202539,202540,189009,13531,0.06680655672953491,2021-11-22 19:47:23 UTC
794554,mainnet,250,108000000,108202808,202809,189240,13569,0.06690531485289114,2021-11-22 19:49:46 UTC
794555,mainnet,250,108000000,108203062,203063,189472,13591,0.06692996754701742,2021-11-22 19:52:08 UTC
794556,mainnet,250,108000000,108203306,203307,189705,13602,0.06690374655078281,2021-11-22 19:54:29 UTC
794558,mainnet,250,108000000,108203542,203543,189933,13610,0.06686547805623382,2021-11-22 19:56:52 UTC
794559,mainnet,250,108000000,108203772,203773,190129,13644,0.06695685885765043,2021-11-22 19:59:17 UTC
794560,mainnet,250,108000000,108204026,204027,190350,13677,0.06703524533517623,2021-11-22 20:01:45 UTC
794562,mainnet,250,108000000,108204236,204237,190526,13711,0.0671327918055984,2021-11-22 20:04:04 UTC
794563,mainnet,250,108000000,108204479,204480,190749,13731,0.06715082159624414,2021-11-22 20:06:26 UTC
794564,mainnet,250,108000000,108204730,204731,190978,13753,0.06717595283567218,2021-11-22 20:08:48 UTC
794566,mainnet,250,108000000,108205020,205021,191237,13784,0.06723213719570191,2021-11-22 20:11:22 UTC
794567,mainnet,250,108000000,108205308,205309,191496,13813,0.0672790769035941,2021-11-22 20:13:50 UTC
794569,mainnet,250,108000000,108205577,205578,191751,13827,0.06725914251524968,2021-11-22 20:16:19 UTC
794570,mainnet,250,108000000,108205859,205860,192017,13843,0.06724472942776644,2021-11-22 20:19:02 UTC
794571,mainnet,250,108000000,108206112,206113,192263,13850,0.06719614968488159,2021-11-22 20:21:22 UTC
794573,mainnet,250,108000000,108206389,206390,192526,13864,0.06717379718009593,2021-11-22 20:24:04 UTC
794575,mainnet,250,108000000,108206672,206673,192788,13885,0.06718342502407185,2021-11-22 20:26:34 UTC
794576,mainnet,250,108000000,108206948,206949,193051,13898,0.06715664245780362,2021-11-22 20:28:57 UTC
794578,mainnet,250,108000000,108207199,207200,193289,13911,0.06713803088803089,2021-11-22 20:31:22 UTC
794579,mainnet,250,108000000,108207493,207494,193565,13929,0.06712965194174289,2021-11-22 20:34:01 UTC
794581,mainnet,250,108000000,108207738,207739,193782,13957,0.0671852661272077,2021-11-22 20:36:11 UTC
794582,mainnet,250,108000000,108208011,208012,194033,13979,0.06720285368151838,2021-11-22 20:38:53 UTC
794584,mainnet,250,108000000,108208308,208309,194312,13997,0.06719344819474915,2021-11-22 20:41:16 UTC
794585,mainnet,250,108000000,108208552,208553,194539,14014,0.06719634817048904,2021-11-22 20:43:38 UTC
794587,mainnet,250,108000000,108208745,208746,194688,14058,0.0673450030180219,2021-11-22 20:46:03 UTC
794588,mainnet,250,108000000,108209045,209046,194917,14129,0.06758799498674933,2021-11-22 20:48:29 UTC
794590,mainnet,250,108000000,108209249,209250,195079,14171,0.06772281959378734,2021-11-22 20:50:48 UTC
794591,mainnet,250,108000000,108209468,209469,195264,14205,0.06781433052146141,2021-11-22 20:53:25 UTC
794593,mainnet,250,108000000,108209641,209642,195402,14240,0.06792532030795356,2021-11-22 20:55:40 UTC
794594,mainnet,250,108000000,108209958,209959,195640,14319,0.0681990293342986,2021-11-22 20:58:43 UTC
794596,mainnet,250,108000000,108210179,210180,195814,14366,0.06835093729184509,2021-11-22 21:01:02 UTC
794597,mainnet,250,108000000,108210527,210528,196087,14441,0.06859420124639003,2021-11-22 21:05:02 UTC
794599,mainnet,250,108000000,108210768,210769,196270,14499,0.0687909512309685,2021-11-22 21:07:13 UTC
794600,mainnet,250,108000000,108210972,210973,196434,14539,0.06891403165333952,2021-11-22 21:09:23 UTC
794602,mainnet,250,108000000,108211241,211242,196672,14570,0.06897302619744179,2021-11-22 21:11:37 UTC
794603,mainnet,250,108000000,108211472,211473,196873,14600,0.0690395464196375,2021-11-22 21:13:49 UTC
794605,mainnet,250,108000000,108211676,211677,197066,14611,0.06902497673341931,2021-11-22 21:16:04 UTC
794606,mainnet,250,108000000,108211908,211909,197263,14646,0.06911457276472448,2021-11-22 21:18:08 UTC
794608,mainnet,250,108000000,108212142,212143,197480,14663,0.06911847197409295,2021-11-22 21:20:20 UTC
794609,mainnet,250,108000000,108212366,212367,197693,14674,0.06909736446811417,2021-11-22 21:22:38 UTC
794611,mainnet,250,108000000,108212668,212669,197966,14703,0.0691356050952419,2021-11-22 21:24:49 UTC
794612,mainnet,250,108000000,108212883,212884,198169,14715,0.06912215103060822,2021-11-22 21:27:08 UTC
794614,mainnet,250,108000000,108213100,213101,198376,14725,0.06909869029239657,2021-11-22 21:29:22 UTC
794615,mainnet,250,108000000,108213308,213309,198579,14730,0.06905475155759953,2021-11-22 21:31:39 UTC
794617,mainnet,250,108000000,108213547,213548,198789,14759,0.06911326727480473,2021-11-22 21:33:57 UTC
794618,mainnet,250,108000000,108213767,213768,198996,14772,0.06910295273380487,2021-11-22 21:36:14 UTC
794620,mainnet,250,108000000,108214156,214157,199373,14784,0.06903346610197192,2021-11-22 21:38:28 UTC
794621,mainnet,250,108000000,108214401,214402,199592,14810,0.06907584817305809,2021-11-22 21:40:47 UTC
794623,mainnet,250,108000000,108214682,214683,199860,14823,0.06904598873688182,2021-11-22 21:43:10 UTC
794624,mainnet,250,108000000,108214924,214925,200092,14833,0.06901477259509131,2021-11-22 21:45:32 UTC
794626,mainnet,250,108000000,108215212,215213,200357,14856,0.06902928726424519,2021-11-22 21:47:51 UTC
794627,mainnet,250,108000000,108215361,215362,200495,14867,0.06903260556644161,2021-11-22 21:50:13 UTC
794629,mainnet,250,108000000,108215743,215744,200833,14911,0.06911432067635716,2021-11-22 21:52:27 UTC
794630,mainnet,250,108000000,108216031,216032,201096,14936,0.06913790549548215,2021-11-22 21:54:51 UTC
794632,mainnet,250,108000000,108216300,216301,201356,14945,0.06909353169888258,2021-11-22 21:57:06 UTC
794633,mainnet,250,108000000,108216557,216558,201599,14959,0.06907618282400096,2021-11-22 21:59:25 UTC
794635,mainnet,250,108000000,108216847,216848,201876,14972,0.06904375415037262,2021-11-22 22:01:49 UTC
794636,mainnet,250,108000000,108217122,217123,202135,14988,0.0690299968220778,2021-11-22 22:04:10 UTC
794638,mainnet,250,108000000,108217378,217379,202361,15018,0.06908671030780342,2021-11-22 22:06:32 UTC
794639,mainnet,250,108000000,108217635,217636,202599,15037,0.06909242956128582,2021-11-22 22:08:53 UTC
794640,mainnet,250,108000000,108217940,217941,202893,15048,0.069046209754016,2021-11-22 22:11:25 UTC
794642,mainnet,250,108000000,108218249,218250,203174,15076,0.06907674684994272,2021-11-22 22:13:51 UTC
794643,mainnet,250,108000000,108218530,218531,203444,15087,0.06903826001802948,2021-11-22 22:16:11 UTC
794645,mainnet,250,108000000,108218807,218808,203702,15106,0.06903769514825783,2021-11-22 22:18:31 UTC
794646,mainnet,250,108000000,108219060,219061,203939,15122,0.06903100049757831,2021-11-22 22:20:53 UTC
794648,mainnet,250,108000000,108219316,219317,204182,15135,0.06900969829060219,2021-11-22 22:23:23 UTC
794650,mainnet,250,108000000,108219594,219595,204450,15145,0.0689678726746966,2021-11-22 22:25:48 UTC
794651,mainnet,250,108000000,108219889,219890,204714,15176,0.06901632634499068,2021-11-22 22:28:05 UTC
794652,mainnet,250,108000000,108220147,220148,204939,15209,0.06908534258771372,2021-11-22 22:30:27 UTC
794654,mainnet,250,108000000,108220396,220397,205181,15216,0.06903905225570221,2021-11-22 22:32:37 UTC
794656,mainnet,250,108000000,108220698,220699,205474,15225,0.0689853601511561,2021-11-22 22:35:06 UTC
794657,mainnet,250,108000000,108220971,220972,205731,15241,0.0689725395072679,2021-11-22 22:37:33 UTC
794659,mainnet,250,108000000,108221248,221249,205989,15260,0.0689720631505679,2021-11-22 22:39:58 UTC
794660,mainnet,250,108000000,108221466,221467,206187,15280,0.06899447773257415,2021-11-22 22:42:10 UTC
794662,mainnet,250,108000000,108221750,221751,206448,15303,0.06900983535587213,2021-11-22 22:44:30 UTC
794663,mainnet,250,108000000,108222018,222019,206710,15309,0.06895355802881735,2021-11-22 22:46:52 UTC
794665,mainnet,250,108000000,108222255,222256,206929,15327,0.06896101792527536,2021-11-22 22:49:08 UTC
794666,mainnet,250,108000000,108222526,222527,207175,15352,0.0689893810638709,2021-11-22 22:51:23 UTC
794668,mainnet,250,108000000,108222769,222770,207413,15357,0.06893657135161826,2021-11-22 22:53:29 UTC
794669,mainnet,250,108000000,108223005,223006,207632,15374,0.06893984915204075,2021-11-22 22:55:39 UTC
794671,mainnet,250,108000000,108223288,223289,207888,15401,0.06897339322581945,2021-11-22 22:58:10 UTC
794672,mainnet,250,108000000,108223522,223523,208116,15407,0.06892802977769626,2021-11-22 23:00:27 UTC
794674,mainnet,250,108000000,108223796,223797,208361,15436,0.06897322126748795,2021-11-22 23:02:50 UTC
794675,mainnet,250,108000000,108224063,224064,208615,15449,0.06894905027135104,2021-11-22 23:05:15 UTC
794677,mainnet,250,108000000,108224310,224311,208850,15461,0.06892662419587091,2021-11-22 23:07:22 UTC
794678,mainnet,250,108000000,108224584,224585,209104,15481,0.06893158492330298,2021-11-22 23:10:02 UTC
794680,mainnet,250,108000000,108224876,224877,209380,15497,0.0689132281202613,2021-11-22 23:12:19 UTC
794681,mainnet,250,108000000,108225124,225125,209621,15504,0.06886840644086618,2021-11-22 23:14:30 UTC
794683,mainnet,250,108000000,108225571,225572,210044,15528,0.06883833099852818,2021-11-22 23:17:00 UTC
794684,mainnet,250,108000000,108225852,225853,210312,15541,0.06881024383116452,2021-11-22 23:19:21 UTC
794686,mainnet,250,108000000,108226166,226167,210618,15549,0.06875008290334134,2021-11-22 23:21:55 UTC
794687,mainnet,250,108000000,108226384,226385,210829,15556,0.06871480000883451,2021-11-22 23:24:14 UTC
794689,mainnet,250,108000000,108226590,226591,211023,15568,0.06870528838303375,2021-11-22 23:26:26 UTC
794690,mainnet,250,108000000,108226872,226873,211252,15621,0.06885349953498213,2021-11-22 23:28:47 UTC
794692,mainnet,250,108000000,108227174,227175,211544,15631,0.06880598657422692,2021-11-22 23:31:12 UTC
794694,mainnet,250,108000000,108227427,227428,211792,15636,0.06875142902369101,2021-11-22 23:33:40 UTC
794695,mainnet,250,108000000,108227760,227761,212083,15678,0.0688353142109492,2021-11-22 23:35:58 UTC
794697,mainnet,250,108000000,108227998,227999,212316,15683,0.06878538940960267,2021-11-22 23:38:19 UTC
794698,mainnet,250,108000000,108228274,228275,212575,15700,0.06877669477603768,2021-11-22 23:40:32 UTC
794700,mainnet,250,108000000,108228560,228561,212852,15709,0.06873001080674306,2021-11-22 23:42:51 UTC
794701,mainnet,250,108000000,108228818,228819,213091,15728,0.06873555080653268,2021-11-22 23:45:08 UTC
794703,mainnet,250,108000000,108229096,229097,213343,15754,0.06876563202486283,2021-11-22 23:47:30 UTC
794704,mainnet,250,108000000,108229384,229385,213627,15758,0.06869673256751749,2021-11-22 23:50:07 UTC
794706,mainnet,250,108000000,108229643,229644,213876,15768,0.06866279981188274,2021-11-22 23:52:18 UTC
794707,mainnet,250,108000000,108229945,229946,214174,15772,0.06859001678654988,2021-11-22 23:54:46 UTC
794709,mainnet,250,108000000,108230202,230203,214420,15783,0.06856122639583324,2021-11-22 23:57:10 UTC
794710,mainnet,250,108000000,108230472,230473,214680,15793,0.06852429568756427,2021-11-22 23:59:25 UTC
794712,mainnet,250,108000000,108230778,230779,214984,15795,0.06844210261765585,2021-11-23 00:01:54 UTC
794713,mainnet,250,108000000,108231040,231041,215239,15802,0.06839478707242437,2021-11-23 00:04:29 UTC
794715,mainnet,250,108000000,108231439,231440,215585,15855,0.06850587625302454,2021-11-23 00:06:46 UTC
794716,mainnet,250,108000000,108231580,231581,215699,15882,0.06858075576148302,2021-11-23 00:09:00 UTC
794718,mainnet,250,108000000,108231884,231885,215976,15909,0.06860728378290963,2021-11-23 00:11:41 UTC
794719,mainnet,250,108000000,108232296,232297,216355,15942,0.06862766200166166,2021-11-23 00:14:06 UTC
794721,mainnet,250,108000000,108232575,232576,216628,15948,0.06857113373692901,2021-11-23 00:16:30 UTC
794723,mainnet,250,108000000,108232869,232870,216921,15949,0.06848885644350926,2021-11-23 00:19:00 UTC
794724,mainnet,250,108000000,108233164,233165,217196,15969,0.06848798061458623,2021-11-23 00:21:18 UTC
794726,mainnet,250,108000000,108233430,233431,217446,15985,0.0684784797220592,2021-11-23 00:23:40 UTC
794727,mainnet,250,108000000,108233698,233699,217694,16005,0.06848553053286492,2021-11-23 00:26:04 UTC
794729,mainnet,250,108000000,108233952,233953,217909,16044,0.06857787675302304,2021-11-23 00:28:22 UTC
794730,mainnet,250,108000000,108234239,234240,218161,16079,0.0686432718579235,2021-11-23 00:30:56 UTC
794732,mainnet,250,108000000,108234520,234521,218427,16094,0.06862498454296204,2021-11-23 00:33:15 UTC
794733,mainnet,250,108000000,108234827,234828,218718,16110,0.06860340334202054,2021-11-23 00:35:41 UTC
794735,mainnet,250,108000000,108235108,235109,218983,16126,0.06858946275982629,2021-11-23 00:38:05 UTC
794736,mainnet,250,108000000,108235400,235401,219250,16151,0.06861058364238044,2021-11-23 00:40:29 UTC
794737,mainnet,250,108000000,108235714,235715,219540,16175,0.06862100417877522,2021-11-23 00:43:16 UTC
794739,mainnet,250,108000000,108236013,236014,219833,16181,0.06855949223351157,2021-11-23 00:45:35 UTC
794740,mainnet,250,108000000,108236328,236329,220120,16209,0.0685865890347778,2021-11-23 00:48:06 UTC
794742,mainnet,250,108000000,108236626,236627,220408,16219,0.06854247402029354,2021-11-23 00:50:32 UTC
794744,mainnet,250,108000000,108236904,236905,220676,16229,0.06850425275954497,2021-11-23 00:52:59 UTC
794745,mainnet,250,108000000,108237196,237197,220942,16255,0.06852953452193745,2021-11-23 00:55:15 UTC
794747,mainnet,250,108000000,108237457,237458,221201,16257,0.06846263339201038,2021-11-23 00:57:31 UTC
794748,mainnet,250,108000000,108237764,237765,221490,16275,0.06844994006687276,2021-11-23 01:00:00 UTC
794750,mainnet,250,108000000,108238106,238107,221787,16320,0.06854061409366377,2021-11-23 01:02:54 UTC
794751,mainnet,250,108000000,108238386,238387,222049,16338,0.06853561645559532,2021-11-23 01:05:14 UTC
794753,mainnet,250,108000000,108238686,238687,222330,16357,0.06852907782996141,2021-11-23 01:07:42 UTC
794754,mainnet,250,108000000,108238982,238983,222620,16363,0.06846930534807916,2021-11-23 01:10:13 UTC
794756,mainnet,250,108000000,108239279,239280,222904,16376,0.06843864928117686,2021-11-23 01:12:51 UTC
794757,mainnet,250,108000000,108239582,239583,223199,16384,0.06838548644937245,2021-11-23 01:15:20 UTC
794759,mainnet,250,108000000,108239854,239855,223456,16399,0.0683704738279377,2021-11-23 01:17:40 UTC
794760,mainnet,250,108000000,108240143,240144,223736,16408,0.06832567126390832,2021-11-23 01:20:12 UTC
794762,mainnet,250,108000000,108240445,240446,224016,16430,0.06833135090623259,2021-11-23 01:22:47 UTC
794763,mainnet,250,108000000,108240740,240741,224292,16449,0.06832654180218575,2021-11-23 01:25:22 UTC
794765,mainnet,250,108000000,108241039,241040,224573,16467,0.06831646199800863,2021-11-23 01:28:00 UTC
794766,mainnet,250,108000000,108241316,241317,224820,16497,0.06836236154104353,2021-11-23 01:30:40 UTC
794768,mainnet,250,108000000,108241626,241627,225124,16503,0.06829948639845712,2021-11-23 01:33:13 UTC
794769,mainnet,250,108000000,108241912,241913,225393,16520,0.06828901299227408,2021-11-23 01:35:33 UTC
794771,mainnet,250,108000000,108242198,242199,225669,16530,0.06824966246764025,2021-11-23 01:37:54 UTC
794772,mainnet,250,108000000,108242466,242467,225910,16557,0.06828558113062809,2021-11-23 01:40:08 UTC
794774,mainnet,250,108000000,108242744,242745,226175,16570,0.0682609322540114,2021-11-23 01:42:26 UTC
794775,mainnet,250,108000000,108243032,243033,226454,16579,0.06821707340155451,2021-11-23 01:44:52 UTC
794777,mainnet,250,108000000,108243338,243339,226747,16592,0.06818471350667177,2021-11-23 01:47:17 UTC
794778,mainnet,250,108000000,108243641,243642,227033,16609,0.06816969159668694,2021-11-23 01:49:46 UTC
794780,mainnet,250,108000000,108243920,243921,227312,16609,0.06809171822024344,2021-11-23 01:52:06 UTC
794781,mainnet,250,108000000,108244200,244201,227587,16614,0.06803411943440035,2021-11-23 01:54:21 UTC
794783,mainnet,250,108000000,108244516,244517,227895,16622,0.0679789135315745,2021-11-23 01:56:58 UTC
794784,mainnet,250,108000000,108244804,244805,228174,16631,0.06793570392761586,2021-11-23 01:59:15 UTC
794786,mainnet,250,108000000,108245140,245141,228497,16644,0.06789561925585684,2021-11-23 02:02:18 UTC
794788,mainnet,250,108000000,108245463,245464,228815,16649,0.06782664667731317,2021-11-23 02:04:56 UTC
794790,mainnet,250,108000000,108245977,245978,229293,16685,0.06783126946312272,2021-11-23 02:09:18 UTC
794791,mainnet,250,108000000,108246264,246265,229571,16694,0.06778876413619475,2021-11-23 02:11:36 UTC
794793,mainnet,250,108000000,108246544,246545,229829,16716,0.06780100995761423,2021-11-23 02:13:53 UTC
794794,mainnet,250,108000000,108246822,246823,230093,16730,0.06778136559396815,2021-11-23 02:16:10 UTC
794796,mainnet,250,108000000,108247099,247100,230355,16745,0.06776608660461352,2021-11-23 02:18:30 UTC
794797,mainnet,250,108000000,108247416,247417,230648,16769,0.06777626436340267,2021-11-23 02:21:12 UTC
794799,mainnet,250,108000000,108247699,247700,230930,16770,0.06770286637060961,2021-11-23 02:23:36 UTC
794800,mainnet,250,108000000,108248005,248006,231232,16774,0.0676354604324089,2021-11-23 02:26:00 UTC
794802,mainnet,250,108000000,108248303,248304,231500,16804,0.06767510793221213,2021-11-23 02:28:23 UTC
794803,mainnet,250,108000000,108248595,248596,231780,16816,0.06764388807543162,2021-11-23 02:30:53 UTC
794805,mainnet,250,108000000,108248888,248889,232062,16827,0.06760845196051252,2021-11-23 02:33:13 UTC
794806,mainnet,250,108000000,108249166,249167,232334,16833,0.06755710025805986,2021-11-23 02:35:34 UTC
794808,mainnet,250,108000000,108249452,249453,232619,16834,0.0674836542354672,2021-11-23 02:37:58 UTC
794810,mainnet,250,108000000,108249738,249739,232886,16853,0.06748245167955345,2021-11-23 02:40:23 UTC
794811,mainnet,250,108000000,108250035,250036,233176,16860,0.06743029003823449,2021-11-23 02:42:47 UTC
794813,mainnet,250,108000000,108250316,250317,233448,16869,0.0673905487841417,2021-11-23 02:45:21 UTC
794814,mainnet,250,108000000,108250626,250627,233750,16877,0.06733911350333364,2021-11-23 02:47:43 UTC
794816,mainnet,250,108000000,108250948,250949,234063,16886,0.06728857257849205,2021-11-23 02:50:18 UTC
794817,mainnet,250,108000000,108251235,251236,234329,16907,0.06729529207597637,2021-11-23 02:52:40 UTC
794818,mainnet,250,108000000,108251530,251531,234600,16931,0.06731178264309369,2021-11-23 02:55:13 UTC
794820,mainnet,250,108000000,108251811,251812,234862,16950,0.06731212174161676,2021-11-23 02:57:29 UTC
794821,mainnet,250,108000000,108252086,252087,235123,16964,0.06729422778643881,2021-11-23 02:59:49 UTC
794823,mainnet,250,108000000,108252392,252393,235409,16984,0.06729188210449577,2021-11-23 03:02:26 UTC
794824,mainnet,250,108000000,108252675,252676,235671,17005,0.06729962481596986,2021-11-23 03:04:45 UTC
794826,mainnet,250,108000000,108252921,252922,235904,17018,0.06728556630107306,2021-11-23 03:07:23 UTC
794828,mainnet,250,108000000,108253277,253278,236225,17053,0.06732917979453407,2021-11-23 03:09:55 UTC
794829,mainnet,250,108000000,108253563,253564,236487,17077,0.0673478885015223,2021-11-23 03:12:12 UTC
794831,mainnet,250,108000000,108253858,253859,236768,17091,0.06732477477654919,2021-11-23 03:14:38 UTC
794832,mainnet,250,108000000,108254140,254141,237037,17104,0.06730122254968698,2021-11-23 03:17:00 UTC
794834,mainnet,250,108000000,108254419,254420,237301,17119,0.06728637685716532,2021-11-23 03:19:17 UTC
794835,mainnet,250,108000000,108254694,254695,237559,17136,0.06728047272227566,2021-11-23 03:21:33 UTC
794837,mainnet,250,108000000,108255000,255001,237840,17161,0.06729777530284195,2021-11-23 03:24:07 UTC
794838,mainnet,250,108000000,108255280,255281,238106,17175,0.067278802574418,2021-11-23 03:26:33 UTC
794839,mainnet,250,108000000,108255575,255576,238389,17187,0.06724809841299653,2021-11-23 03:28:52 UTC
794841,mainnet,250,108000000,108255847,255848,238640,17208,0.0672586848441262,2021-11-23 03:31:10 UTC
794842,mainnet,250,108000000,108256115,256116,238886,17230,0.06727420387636852,2021-11-23 03:33:30 UTC
794844,mainnet,250,108000000,108256405,256406,239162,17244,0.06725271639509216,2021-11-23 03:35:50 UTC
794845,mainnet,250,108000000,108256707,256708,239439,17269,0.06727098493229662,2021-11-23 03:38:21 UTC
794847,mainnet,250,108000000,108256995,256996,239703,17293,0.06728898504256875,2021-11-23 03:40:49 UTC
794849,mainnet,250,108000000,108257298,257299,239978,17321,0.06731856711452434,2021-11-23 03:43:08 UTC
794850,mainnet,250,108000000,108257586,257587,240247,17340,0.06731706180824343,2021-11-23 03:45:41 UTC
794852,mainnet,250,108000000,108257922,257923,240549,17374,0.06736118919212324,2021-11-23 03:48:10 UTC
794853,mainnet,250,108000000,108258210,258211,240831,17380,0.06730929356224173,2021-11-23 03:50:34 UTC
794855,mainnet,250,108000000,108258467,258468,241083,17385,0.06726171131436,2021-11-23 03:52:51 UTC
794856,mainnet,250,108000000,108258777,258778,241366,17412,0.06728547248993345,2021-11-23 03:55:15 UTC
794858,mainnet,250,108000000,108259045,259046,241622,17424,0.0672621850945392,2021-11-23 03:57:33 UTC
794859,mainnet,250,108000000,108259324,259325,241888,17437,0.06723994986985443,2021-11-23 04:00:02 UTC
794861,mainnet,250,108000000,108259645,259646,242182,17464,0.06726080894756707,2021-11-23 04:02:41 UTC
794862,mainnet,250,108000000,108259938,259939,242471,17468,0.06720038162799734,2021-11-23 04:05:03 UTC
794864,mainnet,250,108000000,108260229,260230,242749,17481,0.0671751911770357,2021-11-23 04:07:18 UTC
794865,mainnet,250,108000000,108260513,260514,243022,17492,0.06714418418971725,2021-11-23 04:09:36 UTC
794867,mainnet,250,108000000,108260795,260796,243290,17506,0.06712526265740272,2021-11-23 04:12:00 UTC
794868,mainnet,250,108000000,108261088,261089,243570,17519,0.06709972461497804,2021-11-23 04:14:20 UTC
794870,mainnet,250,108000000,108261364,261365,243834,17531,0.0670747804794062,2021-11-23 04:16:31 UTC
794871,mainnet,250,108000000,108261673,261674,244139,17535,0.06701086084211652,2021-11-23 04:18:57 UTC
794873,mainnet,250,108000000,108261972,261973,244434,17539,0.06694964748275585,2021-11-23 04:21:16 UTC
794874,mainnet,250,108000000,108262258,262259,244707,17552,0.06692620653628664,2021-11-23 04:23:47 UTC
794876,mainnet,250,108000000,108262535,262536,244979,17557,0.06687463814486394,2021-11-23 04:26:03 UTC
794877,mainnet,250,108000000,108262812,262813,245229,17584,0.0669068881676325,2021-11-23 04:28:16 UTC
794879,mainnet,250,108000000,108263091,263092,245499,17593,0.06687014428412874,2021-11-23 04:30:31 UTC
794880,mainnet,250,108000000,108263353,263354,245747,17607,0.06685677832878939,2021-11-23 04:32:47 UTC
794882,mainnet,250,108000000,108263629,263630,246012,17618,0.0668285096536813,2021-11-23 04:35:10 UTC
794883,mainnet,250,108000000,108263914,263915,246297,17618,0.06675634200405434,2021-11-23 04:37:28 UTC
794885,mainnet,250,108000000,108264187,264188,246556,17632,0.06674035156782292,2021-11-23 04:39:47 UTC
794886,mainnet,250,108000000,108264496,264497,246861,17636,0.06667750484882626,2021-11-23 04:42:16 UTC
794887,mainnet,250,108000000,108264790,264791,247149,17642,0.06662613155280958,2021-11-23 04:44:38 UTC
794889,mainnet,250,108000000,108265040,265041,247389,17652,0.06660101644651205,2021-11-23 04:46:53 UTC
794890,mainnet,250,108000000,108265316,265317,247657,17660,0.06656188634727514,2021-11-23 04:49:16 UTC
794891,mainnet,250,108000000,108265570,265571,247884,17687,0.06659989230751852,2021-11-23 04:51:30 UTC
794893,mainnet,250,108000000,108265865,265866,248149,17717,0.06663883309637186,2021-11-23 04:53:58 UTC
794894,mainnet,250,108000000,108266157,266158,248438,17720,0.06657699561914351,2021-11-23 04:56:21 UTC
794896,mainnet,250,108000000,108266423,266424,248692,17732,0.06655556556466384,2021-11-23 04:58:44 UTC
794898,mainnet,250,108000000,108266724,266725,248975,17750,0.06654794263754804,2021-11-23 05:01:04 UTC
794899,mainnet,250,108000000,108267029,267030,249256,17774,0.06656180953450923,2021-11-23 05:03:33 UTC
794901,mainnet,250,108000000,108267252,267253,249471,17782,0.06653620352250489,2021-11-23 05:06:04 UTC
794902,mainnet,250,108000000,108267600,267601,249776,17825,0.06661036393735449,2021-11-23 05:08:19 UTC
794903,mainnet,250,108000000,108267867,267868,250037,17831,0.06656636850986307,2021-11-23 05:10:29 UTC
794905,mainnet,250,108000000,108268145,268146,250295,17851,0.06657194215091779,2021-11-23 05:12:48 UTC
794907,mainnet,250,108000000,108268436,268437,250565,17872,0.06657800526753019,2021-11-23 05:15:13 UTC
794908,mainnet,250,108000000,108268706,268707,250822,17885,0.06655948672717868,2021-11-23 05:17:28 UTC
794910,mainnet,250,108000000,108268988,268989,251093,17896,0.0665306016231147,2021-11-23 05:19:48 UTC
794911,mainnet,250,108000000,108269264,269265,251357,17908,0.0665069726849015,2021-11-23 05:22:11 UTC
794913,mainnet,250,108000000,108269555,269556,251625,17931,0.06652050037840003,2021-11-23 05:24:38 UTC
794914,mainnet,250,108000000,108269864,269865,251918,17947,0.0665036221814611,2021-11-23 05:27:16 UTC
794916,mainnet,250,108000000,108270161,270162,252208,17954,0.06645642244283059,2021-11-23 05:29:45 UTC
794918,mainnet,250,108000000,108270536,270537,252556,17981,0.06646410657322288,2021-11-23 05:32:49 UTC
794919,mainnet,250,108000000,108270808,270809,252822,17987,0.0664195059986928,2021-11-23 05:35:10 UTC
794920,mainnet,250,108000000,108271134,271135,253126,18009,0.06642078669297583,2021-11-23 05:38:12 UTC
794921,mainnet,250,108000000,108271421,271422,253375,18047,0.06649055713980444,2021-11-23 05:40:31 UTC
794923,mainnet,250,108000000,108271712,271713,253655,18058,0.06645983077732755,2021-11-23 05:43:02 UTC
794924,mainnet,250,108000000,108272006,272007,253933,18074,0.0664468193833247,2021-11-23 05:45:32 UTC
794926,mainnet,250,108000000,108272280,272281,254182,18099,0.06647176997293237,2021-11-23 05:48:00 UTC
794927,mainnet,250,108000000,108272545,272546,254433,18113,0.06645850608704586,2021-11-23 05:50:10 UTC
794929,mainnet,250,108000000,108272808,272809,254686,18123,0.06643109281585285,2021-11-23 05:52:33 UTC
794930,mainnet,250,108000000,108273097,273098,254969,18129,0.0663827636965485,2021-11-23 05:55:05 UTC
794932,mainnet,250,108000000,108273426,273427,255281,18146,0.06636506270412212,2021-11-23 05:57:35 UTC
794934,mainnet,250,108000000,108273703,273704,255549,18155,0.06633078069739573,2021-11-23 05:59:53 UTC
794935,mainnet,250,108000000,108273990,273991,255819,18172,0.0663233463872901,2021-11-23 06:02:18 UTC
794937,mainnet,250,108000000,108274267,274268,256076,18192,0.06632928376624324,2021-11-23 06:04:36 UTC
794938,mainnet,250,108000000,108274557,274558,256355,18203,0.0662992883106666,2021-11-23 06:07:07 UTC
794940,mainnet,250,108000000,108274830,274831,256606,18225,0.06631347992038744,2021-11-23 06:09:21 UTC
794941,mainnet,250,108000000,108275090,275091,256848,18243,0.06631623717242657,2021-11-23 06:11:53 UTC
794943,mainnet,250,108000000,108275385,275386,257125,18261,0.06631056044969606,2021-11-23 06:14:18 UTC
794944,mainnet,250,108000000,108275662,275663,257381,18282,0.06632010824811455,2021-11-23 06:16:33 UTC
794946,mainnet,250,108000000,108275972,275973,257678,18295,0.06629271704115983,2021-11-23 06:19:05 UTC
794947,mainnet,250,108000000,108276270,276271,257960,18311,0.06627912448284475,2021-11-23 06:21:21 UTC
794949,mainnet,250,108000000,108276717,276718,258384,18334,0.06625517675033789,2021-11-23 06:25:31 UTC
794951,mainnet,250,108000000,108277013,277014,258651,18363,0.0662890684225346,2021-11-23 06:27:46 UTC
794952,mainnet,250,108000000,108277270,277271,258903,18368,0.06624565857951246,2021-11-23 06:30:03 UTC
794954,mainnet,250,108000000,108277548,277549,259163,18386,0.06624415868909633,2021-11-23 06:32:26 UTC
794955,mainnet,250,108000000,108277836,277837,259450,18387,0.06617909061788027,2021-11-23 06:34:48 UTC
794957,mainnet,250,108000000,108278101,278102,259710,18392,0.06613400838541254,2021-11-23 06:36:58 UTC
794958,mainnet,250,108000000,108278358,278359,259949,18410,0.06613761365718371,2021-11-23 06:39:12 UTC
794960,mainnet,250,108000000,108278613,278614,260191,18423,0.06612374108982319,2021-11-23 06:41:34 UTC
794961,mainnet,250,108000000,108278926,278927,260482,18445,0.0661284135275538,2021-11-23 06:43:52 UTC
794963,mainnet,250,108000000,108279195,279196,260743,18453,0.06609335377297669,2021-11-23 06:46:12 UTC
794964,mainnet,250,108000000,108279473,279474,261014,18460,0.06605265606102893,2021-11-23 06:48:30 UTC
794965,mainnet,250,108000000,108279748,279749,261280,18469,0.0660198964071364,2021-11-23 06:50:50 UTC
794967,mainnet,250,108000000,108280246,280247,261752,18495,0.06599535409834896,2021-11-23 06:54:55 UTC
794969,mainnet,250,108000000,108280550,280551,262027,18524,0.06602721073886744,2021-11-23 06:57:18 UTC
794970,mainnet,250,108000000,108280842,280843,262311,18532,0.0659870461432188,2021-11-23 06:59:37 UTC
794971,mainnet,250,108000000,108281160,281161,262616,18545,0.06595865002614161,2021-11-23 07:02:14 UTC
794973,mainnet,250,108017025,108281441,264417,247193,17224,0.06513953338854915,2021-11-23 07:04:37 UTC
794974,mainnet,250,108000000,108281753,281754,263165,18589,0.06597599324233196,2021-11-23 07:06:58 UTC
794976,mainnet,250,108000000,108282030,282031,263438,18593,0.0659253769975641,2021-11-23 07:09:08 UTC
794977,mainnet,250,108000000,108282298,282299,263683,18616,0.06594426476891523,2021-11-23 07:11:27 UTC
794979,mainnet,250,108000000,108282590,282591,263955,18636,0.06594689852118432,2021-11-23 07:13:52 UTC
794980,mainnet,250,108000000,108282848,282849,264202,18647,0.06592563523293347,2021-11-23 07:16:02 UTC
794982,mainnet,250,108000000,108283118,283119,264455,18664,0.0659228098432108,2021-11-23 07:18:19 UTC
794983,mainnet,250,108000000,108283361,283362,264682,18680,0.06592274193434547,2021-11-23 07:20:46 UTC
794985,mainnet,250,108000000,108283692,283693,264988,18705,0.0659339497273461,2021-11-23 07:23:14 UTC
794986,mainnet,250,108000000,108283983,283984,265272,18712,0.06589103611471069,2021-11-23 07:25:44 UTC
794988,mainnet,250,108000000,108284248,284249,265523,18726,0.06587885973213627,2021-11-23 07:28:07 UTC
794989,mainnet,250,108000000,108284562,284563,265826,18737,0.06584482170907673,2021-11-23 07:30:39 UTC
794991,mainnet,250,108000000,108284868,284869,266127,18742,0.06579164458049139,2021-11-23 07:33:10 UTC
794992,mainnet,250,108000000,108285154,285155,266400,18755,0.06577124721642616,2021-11-23 07:35:33 UTC
794994,mainnet,250,108000000,108285454,285455,266674,18781,0.0657932073356571,2021-11-23 07:38:07 UTC
794995,mainnet,250,108000000,108285718,285719,266932,18787,0.06575341506865137,2021-11-23 07:40:26 UTC
794997,mainnet,250,108000000,108286021,286022,267213,18809,0.06576067575221486,2021-11-23 07:42:56 UTC
794999,mainnet,250,108000000,108286296,286297,267477,18820,0.06573593156756795,2021-11-23 07:45:19 UTC
795000,mainnet,250,108000000,108286557,286558,267726,18832,0.0657179349381277,2021-11-23 07:47:33 UTC
795001,mainnet,250,108000000,108286840,286841,268001,18840,0.06568098702765644,2021-11-23 07:49:48 UTC
795003,mainnet,250,108000000,108287121,287122,268252,18870,0.0657211916885505,2021-11-23 07:52:07 UTC
795005,mainnet,250,108000000,108287385,287386,268507,18879,0.06569213531626454,2021-11-23 07:54:23 UTC
795006,mainnet,250,108000000,108287649,287650,268754,18896,0.0656909438553798,2021-11-23 07:56:36 UTC
795008,mainnet,250,108000000,108287963,287964,269058,18906,0.06565404008834437,2021-11-23 07:59:15 UTC
795009,mainnet,250,108000000,108288254,288255,269341,18914,0.06561551404138696,2021-11-23 08:01:42 UTC
795010,mainnet,250,108000000,108288534,288535,269604,18931,0.06561075779368188,2021-11-23 08:04:11 UTC
795012,mainnet,250,108000000,108288858,288859,269912,18947,0.06559255553747677,2021-11-23 08:06:39 UTC
795013,mainnet,250,108000000,108289158,289159,270204,18955,0.06555217025926913,2021-11-23 08:08:54 UTC
795015,mainnet,250,108000000,108289419,289420,270450,18970,0.06554488286918665,2021-11-23 08:11:18 UTC
795016,mainnet,250,108000000,108289705,289706,270730,18976,0.06550088710623873,2021-11-23 08:13:43 UTC
795018,mainnet,250,108000000,108289979,289980,270989,18991,0.06549072349817228,2021-11-23 08:16:07 UTC
795019,mainnet,250,108000000,108290274,290275,271262,19013,0.06549995693738696,2021-11-23 08:18:28 UTC
795021,mainnet,250,108000000,108290582,290583,271559,19024,0.06546838596889701,2021-11-23 08:20:58 UTC
795022,mainnet,250,108000000,108290889,290890,271853,19037,0.0654439822613359,2021-11-23 08:23:31 UTC
795024,mainnet,250,108000000,108291122,291123,272082,19041,0.06540534413289228,2021-11-23 08:25:42 UTC
795025,mainnet,250,108000000,108291405,291406,272352,19054,0.06538643679265355,2021-11-23 08:27:55 UTC
795027,mainnet,250,108000000,108291676,291677,272611,19066,0.06536682700384329,2021-11-23 08:30:06 UTC
795028,mainnet,250,108000000,108291961,291962,272888,19074,0.06533041971215432,2021-11-23 08:32:31 UTC
795030,mainnet,250,108000000,108292247,292248,273159,19089,0.06531781226903179,2021-11-23 08:34:50 UTC
795031,mainnet,250,108000000,108292522,292523,273420,19103,0.06530426667304794,2021-11-23 08:37:12 UTC
795033,mainnet,250,108000000,108292788,292789,273667,19122,0.06530983062888292,2021-11-23 08:39:24 UTC
795034,mainnet,250,108000000,108293072,293073,273945,19128,0.06526701538524532,2021-11-23 08:41:41 UTC
795036,mainnet,250,108000000,108293351,293352,274201,19151,0.06528334560527967,2021-11-23 08:44:00 UTC
795037,mainnet,250,108000000,108293615,293616,274437,19179,0.06532000980872978,2021-11-23 08:46:17 UTC
795039,mainnet,250,108000000,108293929,293930,274714,19216,0.06537610995815331,2021-11-23 08:48:46 UTC
795040,mainnet,250,108000000,108294219,294220,274999,19221,0.06532866562436272,2021-11-23 08:51:06 UTC
795042,mainnet,250,108000000,108294490,294491,275251,19240,0.0653330662057584,2021-11-23 08:53:26 UTC
795043,mainnet,250,108000000,108294801,294802,275548,19254,0.06531163289258553,2021-11-23 08:55:51 UTC
795045,mainnet,250,108000000,108295065,295066,275797,19269,0.06530403367382213,2021-11-23 08:58:01 UTC
795046,mainnet,250,108000000,108295384,295385,276091,19294,0.06531814411699985,2021-11-23 09:00:32 UTC
795048,mainnet,250,108000000,108295684,295685,276386,19299,0.06526878265721968,2021-11-23 09:03:01 UTC
795049,mainnet,250,108000000,108295983,295984,276675,19309,0.06523663441267095,2021-11-23 09:05:28 UTC
795051,mainnet,250,108000000,108296221,296222,276894,19328,0.0652483610265274,2021-11-23 09:07:34 UTC
795052,mainnet,250,108000000,108296496,296497,277154,19343,0.06523843411569089,2021-11-23 09:09:58 UTC
795054,mainnet,250,108000000,108296766,296767,277414,19353,0.06521277635316595,2021-11-23 09:12:16 UTC
795055,mainnet,250,108000000,108297078,297079,277710,19369,0.06519814594771088,2021-11-23 09:14:47 UTC
795057,mainnet,250,108000000,108297387,297388,278002,19386,0.06518756641155662,2021-11-23 09:17:18 UTC
795059,mainnet,250,108000000,108297707,297708,278306,19402,0.06517124161930482,2021-11-23 09:19:54 UTC
795060,mainnet,250,108000000,108297996,297997,278571,19426,0.06518857572391669,2021-11-23 09:22:13 UTC
795062,mainnet,250,108000000,108298321,298322,278881,19441,0.06516783877823291,2021-11-23 09:24:40 UTC
795063,mainnet,250,108000000,108298621,298622,279173,19449,0.0651291599413305,2021-11-23 09:27:19 UTC
795065,mainnet,250,108000000,108298962,298963,279501,19462,0.06509835665282995,2021-11-23 09:29:49 UTC
795066,mainnet,250,108000000,108299251,299252,279780,19472,0.06506890513680777,2021-11-23 09:32:08 UTC
795068,mainnet,250,108000000,108299501,299502,280011,19491,0.06507802952901817,2021-11-23 09:34:20 UTC
795069,mainnet,250,108000000,108299693,299694,280197,19497,0.06505635748463433,2021-11-23 09:36:52 UTC
795071,mainnet,250,108000000,108300425,300426,280881,19545,0.06505761818218131,2021-11-23 09:42:33 UTC
795073,mainnet,250,108000000,108300719,300720,281152,19568,0.06507049747273211,2021-11-23 09:45:07 UTC
795074,mainnet,250,108000000,108301012,301013,281406,19607,0.06513672166982822,2021-11-23 09:47:31 UTC
795076,mainnet,250,108000000,108301284,301285,281648,19637,0.06517748975222795,2021-11-23 09:49:55 UTC
795077,mainnet,250,108000000,108301563,301564,281906,19658,0.06518682601371517,2021-11-23 09:52:15 UTC
795079,mainnet,250,108000000,108301857,301858,282180,19678,0.06518959245738062,2021-11-23 09:54:41 UTC
795080,mainnet,250,108000000,108302141,302142,282450,19692,0.06517465297773894,2021-11-23 09:56:57 UTC
795082,mainnet,250,108000000,108302430,302431,282713,19718,0.06519834276248136,2021-11-23 09:59:25 UTC
795084,mainnet,250,108000000,108302820,302821,283084,19737,0.06517711783528883,2021-11-23 10:02:35 UTC
795085,mainnet,250,108000000,108303139,303140,283376,19764,0.06519759846935409,2021-11-23 10:05:15 UTC
795087,mainnet,250,108000000,108303537,303538,283753,19785,0.06518129525792488,2021-11-23 10:08:33 UTC
795088,mainnet,250,108000000,108303899,303900,284096,19804,0.06516617308325107,2021-11-23 10:11:29 UTC
795090,mainnet,250,108039460,108304291,264832,247577,17255,0.06515451304978251,2021-11-23 10:14:42 UTC
795092,mainnet,250,108000000,108304581,304582,284742,19840,0.06513845204247132,2021-11-23 10:16:57 UTC
795093,mainnet,250,108000000,108304841,304842,284996,19846,0.06510257772879065,2021-11-23 10:19:13 UTC
795094,mainnet,250,108000000,108305106,305107,285244,19863,0.06510175118892716,2021-11-23 10:21:29 UTC
795096,mainnet,250,108000000,108305369,305370,285491,19879,0.0650980777417559,2021-11-23 10:23:47 UTC
795097,mainnet,250,108000000,108305606,305607,285718,19889,0.06508031556868789,2021-11-23 10:26:02 UTC
795099,mainnet,250,108000000,108305829,305830,285930,19900,0.06506882908805546,2021-11-23 10:28:16 UTC
795100,mainnet,250,108000000,108306103,306104,286172,19932,0.06511512427148942,2021-11-23 10:30:24 UTC
795101,mainnet,250,108000000,108306360,306361,286394,19967,0.06517474482718101,2021-11-23 10:32:48 UTC
795103,mainnet,250,108000000,108306669,306670,286687,19983,0.06516124824730166,2021-11-23 10:35:11 UTC
795104,mainnet,250,108000000,108306941,306942,286940,20002,0.06516540584214607,2021-11-23 10:37:25 UTC
795106,mainnet,250,108000000,108307207,307208,287197,20011,0.06513827764901955,2021-11-23 10:39:46 UTC
795107,mainnet,250,108000000,108307514,307515,287489,20026,0.0651220265678097,2021-11-23 10:42:06 UTC
795108,mainnet,250,108000000,108307822,307823,287772,20051,0.06513808259941589,2021-11-23 10:44:39 UTC
795110,mainnet,250,108000000,108308123,308124,288032,20092,0.06520751385805715,2021-11-23 10:46:49 UTC
795111,mainnet,250,108000000,108308381,308382,288285,20097,0.06516917329805241,2021-11-23 10:49:02 UTC
795113,mainnet,250,108000000,108308646,308647,288537,20110,0.06515533927107667,2021-11-23 10:51:22 UTC
795114,mainnet,250,108000000,108308924,308925,288792,20133,0.06517115804806992,2021-11-23 10:53:38 UTC
795115,mainnet,250,108000000,108309173,309174,289028,20146,0.0651607185597754,2021-11-23 10:55:51 UTC
795117,mainnet,250,108000000,108309439,309440,289266,20174,0.06519519131334023,2021-11-23 10:58:06 UTC
795118,mainnet,250,108000000,108309684,309685,289494,20191,0.06519850816151897,2021-11-23 11:00:30 UTC
795119,mainnet,250,108000000,108309952,309953,289727,20226,0.06525505479863077,2021-11-23 11:02:55 UTC
795120,mainnet,250,108000000,108310209,310210,289973,20237,0.065236452725573,2021-11-23 11:05:13 UTC
795121,mainnet,250,108000000,108310473,310474,290207,20267,0.0652776077868034,2021-11-23 11:07:33 UTC
795123,mainnet,250,108000000,108310752,310753,290458,20295,0.06530910401508594,2021-11-23 11:09:54 UTC
795124,mainnet,250,108000000,108311058,311059,290746,20313,0.0653027239205424,2021-11-23 11:12:30 UTC
795126,mainnet,250,108000000,108311335,311336,290998,20338,0.06532492227047305,2021-11-23 11:14:52 UTC
795127,mainnet,250,108000000,108311615,311616,291269,20347,0.0652951067981105,2021-11-23 11:17:09 UTC
795129,mainnet,250,108000000,108311916,311917,291552,20365,0.0652898046595729,2021-11-23 11:19:45 UTC
795130,mainnet,250,108000000,108312203,312204,291828,20376,0.06526501902602144,2021-11-23 11:22:24 UTC
795132,mainnet,250,108000000,108312524,312525,292120,20405,0.06529077673786098,2021-11-23 11:24:57 UTC
795133,mainnet,250,108000000,108312777,312778,292366,20412,0.06526034439762388,2021-11-23 11:27:12 UTC
795135,mainnet,250,108000000,108313036,313037,292604,20433,0.06527343413078965,2021-11-23 11:29:36 UTC
795136,mainnet,250,108000000,108313325,313326,292864,20462,0.06530578375238569,2021-11-23 11:31:58 UTC
795138,mainnet,250,108000000,108313620,313621,293129,20492,0.06534001230784928,2021-11-23 11:34:20 UTC
795139,mainnet,250,108000000,108313908,313909,293400,20509,0.06533422106406633,2021-11-23 11:36:50 UTC
795141,mainnet,250,108000000,108314379,314380,293840,20540,0.06533494497105413,2021-11-23 11:40:31 UTC
795142,mainnet,250,108000000,108314642,314643,294085,20558,0.06533754127693926,2021-11-23 11:42:42 UTC
795144,mainnet,250,108000000,108314892,314893,294326,20567,0.06531424960224584,2021-11-23 11:44:54 UTC
795145,mainnet,250,108000000,108315147,315148,294571,20577,0.06529313211570437,2021-11-23 11:47:00 UTC
795146,mainnet,250,108000000,108315388,315389,294791,20598,0.06530982374147482,2021-11-23 11:49:05 UTC
795148,mainnet,250,108000000,108315652,315653,295033,20620,0.0653248979100468,2021-11-23 11:51:15 UTC
795149,mainnet,250,108000000,108315883,315884,295252,20632,0.0653151156753745,2021-11-23 11:53:17 UTC
795151,mainnet,250,108000000,108316126,316127,295473,20654,0.0653345016401636,2021-11-23 11:55:19 UTC
795152,mainnet,250,108000000,108316371,316372,295709,20663,0.06531235381133602,2021-11-23 11:57:23 UTC
795154,mainnet,250,108000000,108316587,316588,295916,20672,0.06529622095594274,2021-11-23 11:59:40 UTC
795155,mainnet,250,108000000,108316888,316889,296191,20698,0.06531624638280281,2021-11-23 12:01:54 UTC
795157,mainnet,250,108000000,108317148,317149,296438,20711,0.06530369006366094,2021-11-23 12:04:03 UTC
795158,mainnet,250,108000000,108317396,317397,296680,20717,0.06527156841432023,2021-11-23 12:06:03 UTC
795160,mainnet,250,108000000,108317624,317625,296897,20728,0.06525934671389216,2021-11-23 12:08:09 UTC
795161,mainnet,250,108000000,108317898,317899,297154,20745,0.06525657520155773,2021-11-23 12:10:36 UTC
795163,mainnet,250,108000000,108318196,318197,297422,20775,0.06528974188945842,2021-11-23 12:12:48 UTC
795165,mainnet,250,108000000,108318485,318486,297685,20801,0.06531213302939533,2021-11-23 12:15:21 UTC
795166,mainnet,250,108000000,108318729,318730,297914,20816,0.06530919587111349,2021-11-23 12:17:27 UTC
795168,mainnet,250,108000000,108319322,319323,298473,20850,0.06529438844054453,2021-11-23 12:22:16 UTC
795170,mainnet,250,108000000,108319742,319743,298879,20864,0.065252405838439,2021-11-23 12:25:40 UTC
795172,mainnet,250,108000000,108319988,319989,299107,20882,0.06525849326070583,2021-11-23 12:27:49 UTC
795173,mainnet,250,108000000,108320220,320221,299315,20906,0.06528616174454517,2021-11-23 12:29:45 UTC
795175,mainnet,250,108000000,108320453,320454,299534,20920,0.06528238062249184,2021-11-23 12:31:45 UTC
795176,mainnet,250,108000000,108320706,320707,299757,20950,0.06532442385105408,2021-11-23 12:33:46 UTC
795177,mainnet,250,108000000,108320959,320960,299997,20963,0.06531343469591226,2021-11-23 12:36:03 UTC
795179,mainnet,250,108000000,108321258,321259,300258,21001,0.06537093124239321,2021-11-23 12:38:26 UTC
795180,mainnet,250,108000000,108321524,321525,300519,21006,0.06533240027991602,2021-11-23 12:40:44 UTC
795182,mainnet,250,108000000,108321767,321768,300742,21026,0.0653452176723602,2021-11-23 12:42:55 UTC
795183,mainnet,250,108000000,108322019,322020,300981,21039,0.06533445127631825,2021-11-23 12:45:06 UTC
795185,mainnet,250,108000000,108322306,322307,301256,21051,0.06531350544667042,2021-11-23 12:47:25 UTC
795186,mainnet,250,108000000,108322557,322558,301492,21066,0.06530918470476628,2021-11-23 12:49:28 UTC
795188,mainnet,250,108000000,108322806,322807,301719,21088,0.0653269600721174,2021-11-23 12:51:35 UTC
795189,mainnet,250,108000000,108323052,323053,301954,21099,0.06531126471507771,2021-11-23 12:53:40 UTC
795191,mainnet,250,108000000,108323349,323350,302241,21109,0.06528220194835317,2021-11-23 12:56:07 UTC
795192,mainnet,250,108000000,108323595,323596,302470,21126,0.0652851085921952,2021-11-23 12:58:11 UTC
795194,mainnet,250,108000000,108323851,323852,302708,21144,0.06528908266739128,2021-11-23 13:00:42 UTC
795195,mainnet,250,108000000,108324141,324142,302983,21159,0.06527694652343725,2021-11-23 13:03:06 UTC
795197,mainnet,250,108000000,108324384,324385,303186,21199,0.06535135718359357,2021-11-23 13:05:08 UTC
795198,mainnet,250,108000000,108324808,324809,303564,21245,0.06540767035396186,2021-11-23 13:09:04 UTC
795199,mainnet,250,108000000,108325034,325035,303768,21267,0.06542987678250034,2021-11-23 13:11:22 UTC
795201,mainnet,250,108000000,108325368,325369,304044,21325,0.06554097040590837,2021-11-23 13:13:47 UTC
795202,mainnet,250,108000000,108325647,325648,304303,21345,0.06554623397042206,2021-11-23 13:16:22 UTC
795204,mainnet,250,108000000,108325924,325925,304548,21377,0.06558870905883256,2021-11-23 13:18:44 UTC
795205,mainnet,250,108000000,108326178,326179,304779,21400,0.06560814767351669,2021-11-23 13:20:52 UTC
795207,mainnet,250,108000000,108326410,326411,304969,21442,0.06569018813704194,2021-11-23 13:23:00 UTC
795208,mainnet,250,108000000,108326653,326654,305176,21478,0.06575152914092587,2021-11-23 13:25:00 UTC
795210,mainnet,250,108000000,108326860,326861,305357,21504,0.06578943342888874,2021-11-23 13:27:02 UTC
795211,mainnet,250,108000000,108327111,327112,305588,21524,0.06580009293453007,2021-11-23 13:29:21 UTC
795212,mainnet,250,108000000,108327362,327363,305835,21528,0.06576186068676057,2021-11-23 13:31:39 UTC
795214,mainnet,250,108000000,108327618,327619,306078,21541,0.06575015490554577,2021-11-23 13:33:45 UTC
795215,mainnet,250,108000000,108327869,327870,306320,21550,0.06572726995455516,2021-11-23 13:36:00 UTC
795217,mainnet,250,108000000,108328092,328093,306525,21568,0.06573745858643738,2021-11-23 13:38:10 UTC
795218,mainnet,250,108000000,108328353,328354,306765,21589,0.06574916096651784,2021-11-23 13:40:15 UTC
795220,mainnet,250,108000000,108328568,328569,306953,21616,0.06578831234839562,2021-11-23 13:42:14 UTC
795221,mainnet,250,108000000,108328790,328791,307155,21636,0.0658047209321423,2021-11-23 13:44:17 UTC
795223,mainnet,250,108000000,108329019,329020,307371,21649,0.06579843170627925,2021-11-23 13:46:22 UTC
795224,mainnet,250,108000000,108329272,329273,307597,21676,0.06582987369143538,2021-11-23 13:48:29 UTC
795226,mainnet,250,108000000,108329541,329542,307851,21691,0.0658216555097681,2021-11-23 13:50:48 UTC
795227,mainnet,250,108000000,108329800,329801,308089,21712,0.06583363907325933,2021-11-23 13:52:56 UTC
795229,mainnet,250,108000000,108330045,330046,308330,21716,0.06579688891851439,2021-11-23 13:54:59 UTC
795230,mainnet,250,108000000,108330406,330407,308666,21741,0.06580066402951511,2021-11-23 13:58:11 UTC
795231,mainnet,250,108000000,108330608,330609,308856,21753,0.06579675689409545,2021-11-23 14:00:06 UTC
795233,mainnet,250,108000000,108330868,330869,309072,21797,0.06587803632253249,2021-11-23 14:02:15 UTC
795234,mainnet,250,108000000,108331129,331130,309314,21816,0.06588348986802767,2021-11-23 14:04:35 UTC
795236,mainnet,250,108000000,108331485,331486,309644,21842,0.06589116885780999,2021-11-23 14:07:43 UTC
795238,mainnet,250,108000000,108331738,331739,309888,21851,0.06586804686817047,2021-11-23 14:09:57 UTC
795239,mainnet,250,108000000,108331960,331961,310101,21860,0.06585110901581813,2021-11-23 14:11:53 UTC
795241,mainnet,250,108000000,108332204,332205,310319,21886,0.06588100720940383,2021-11-23 14:13:56 UTC
795242,mainnet,250,108000000,108332422,332423,310529,21894,0.06586186876359337,2021-11-23 14:16:02 UTC
795243,mainnet,250,108000000,108332690,332691,310774,21917,0.06587794680349032,2021-11-23 14:18:02 UTC
795245,mainnet,250,108000000,108332913,332914,310986,21928,0.06586686051052223,2021-11-23 14:19:58 UTC
795246,mainnet,250,108000000,108333115,333116,311183,21933,0.06584192893766735,2021-11-23 14:22:07 UTC
795248,mainnet,250,108000000,108333389,333390,311426,21964,0.06588080026395512,2021-11-23 14:24:22 UTC
795250,mainnet,250,108000000,108333631,333632,311652,21980,0.06588097065029733,2021-11-23 14:26:27 UTC
795251,mainnet,250,108000000,108333910,333911,311901,22010,0.06591576797410088,2021-11-23 14:28:50 UTC
795253,mainnet,250,108000000,108334136,334137,312110,22027,0.06592206190873803,2021-11-23 14:30:51 UTC
795254,mainnet,250,108000000,108334366,334367,312337,22030,0.06588568848002345,2021-11-23 14:32:46 UTC
795256,mainnet,250,108000000,108334618,334619,312565,22054,0.06590779363993078,2021-11-23 14:34:51 UTC
795257,mainnet,250,108000000,108334904,334905,312835,22070,0.06589928487182932,2021-11-23 14:37:20 UTC
795259,mainnet,250,108000000,108335180,335181,313091,22090,0.06590469030165791,2021-11-23 14:39:25 UTC
795260,mainnet,250,108000000,108335344,335345,313247,22098,0.06589631573454204,2021-11-23 14:41:30 UTC
795262,mainnet,250,108000000,108335666,335667,313535,22132,0.06593439331241975,2021-11-23 14:43:37 UTC
795263,mainnet,250,108000000,108335907,335908,313760,22148,0.06593472022101289,2021-11-23 14:45:43 UTC
795265,mainnet,250,108000000,108336144,336145,313979,22166,0.06594178107661872,2021-11-23 14:48:05 UTC
795266,mainnet,250,108000000,108336384,336385,314203,22182,0.06594229825943487,2021-11-23 14:50:05 UTC
795267,mainnet,250,108000000,108336585,336586,314384,22202,0.06596233949124444,2021-11-23 14:52:16 UTC
795269,mainnet,250,108000000,108336838,336839,314604,22235,0.06601076478673788,2021-11-23 14:54:39 UTC
795270,mainnet,250,108000000,108337066,337067,314804,22263,0.06604918310009583,2021-11-23 14:56:39 UTC
795272,mainnet,250,108000000,108337283,337284,314997,22287,0.06607784537659658,2021-11-23 14:58:40 UTC
795273,mainnet,250,108000000,108337518,337519,315215,22304,0.06608220574249153,2021-11-23 15:00:55 UTC
795275,mainnet,250,108000000,108337709,337710,315391,22319,0.0660892481715081,2021-11-23 15:02:59 UTC
795276,mainnet,250,108000000,108337912,337913,315579,22334,0.06609393542124749,2021-11-23 15:04:58 UTC
795278,mainnet,250,108000000,108338087,338088,315741,22347,0.06609817562291474,2021-11-23 15:06:52 UTC
795279,mainnet,250,108000000,108338300,338301,315926,22375,0.06613932563013411,2021-11-23 15:09:12 UTC
795281,mainnet,250,108000000,108338516,338517,316112,22405,0.0661857454721624,2021-11-23 15:11:19 UTC
795282,mainnet,250,108000000,108338733,338734,316312,22422,0.06619353238824564,2021-11-23 15:13:18 UTC
795284,mainnet,250,108000000,108338967,338968,316519,22449,0.06622749050057823,2021-11-23 15:15:30 UTC
795285,mainnet,250,108000000,108339172,339173,316710,22463,0.06622873872625475,2021-11-23 15:17:38 UTC
795287,mainnet,250,108000000,108339425,339426,316927,22499,0.06628543482231768,2021-11-23 15:19:53 UTC
795288,mainnet,250,108000000,108339556,339557,317050,22507,0.066283422223662,2021-11-23 15:22:05 UTC
795289,mainnet,250,108000000,108339922,339923,317371,22552,0.06634443682834054,2021-11-23 15:24:16 UTC
795291,mainnet,250,108000000,108340130,340131,317571,22560,0.06632738562495039,2021-11-23 15:26:20 UTC
795292,mainnet,250,108000000,108340359,340360,317791,22569,0.06630920202138912,2021-11-23 15:28:21 UTC
795294,mainnet,250,108000000,108340744,340745,318149,22596,0.06631351890710062,2021-11-23 15:31:41 UTC
795296,mainnet,250,108000000,108340978,340979,318366,22613,0.06631786708272357,2021-11-23 15:33:40 UTC
795297,mainnet,250,108000000,108341229,341230,318596,22634,0.06633062743604021,2021-11-23 15:35:51 UTC
795299,mainnet,250,108000000,108341442,341443,318789,22654,0.06634782379489403,2021-11-23 15:37:50 UTC
795300,mainnet,250,108000000,108341652,341653,318990,22663,0.06633338504271878,2021-11-23 15:39:42 UTC
795302,mainnet,250,108000000,108341952,341953,319270,22683,0.06633367743520309,2021-11-23 15:42:18 UTC
795303,mainnet,250,108000000,108342193,342194,319497,22697,0.06632787249338094,2021-11-23 15:44:21 UTC
795305,mainnet,250,108000000,108342433,342434,319706,22728,0.06637191400386644,2021-11-23 15:46:31 UTC
795306,mainnet,250,108000000,108342695,342696,319954,22742,0.066362023484371,2021-11-23 15:48:39 UTC
795308,mainnet,250,108000000,108342919,342920,320164,22756,0.06635950075819433,2021-11-23 15:50:35 UTC
795309,mainnet,250,108000000,108343134,343135,320366,22769,0.06635580748102059,2021-11-23 15:52:37 UTC
795310,mainnet,250,108000000,108343366,343367,320584,22783,0.0663517460909173,2021-11-23 15:54:38 UTC
795312,mainnet,250,108000000,108343591,343592,320802,22790,0.06632866888635358,2021-11-23 15:56:34 UTC
795313,mainnet,250,108000000,108343812,343813,321007,22806,0.06633257032165742,2021-11-23 15:58:40 UTC
795315,mainnet,250,108000000,108344066,344067,321231,22836,0.06637079406045915,2021-11-23 16:00:51 UTC
795316,mainnet,250,108000000,108344285,344286,321442,22844,0.06635181215617249,2021-11-23 16:02:44 UTC
795317,mainnet,250,108000000,108344511,344512,321662,22850,0.06632570128181312,2021-11-23 16:04:44 UTC
795318,mainnet,250,108000000,108344708,344709,321857,22852,0.06629359836847892,2021-11-23 16:06:43 UTC
795320,mainnet,250,108000000,108344943,344944,322061,22883,0.06633830418850596,2021-11-23 16:08:43 UTC
795321,mainnet,250,108000000,108345164,345165,322272,22893,0.06632480118204337,2021-11-23 16:10:42 UTC
795323,mainnet,250,108000000,108345369,345370,322457,22913,0.06634334192315487,2021-11-23 16:12:40 UTC
795324,mainnet,250,108000000,108345572,345573,322645,22928,0.06634777601259358,2021-11-23 16:14:42 UTC
795326,mainnet,250,108000000,108345758,345759,322811,22948,0.06636992818697417,2021-11-23 16:16:40 UTC
795327,mainnet,250,108000000,108345964,345965,322986,22979,0.06642001358518926,2021-11-23 16:18:33 UTC
795329,mainnet,250,108000000,108346196,346197,323193,23004,0.06644771618471564,2021-11-23 16:20:30 UTC
795330,mainnet,250,108000000,108346416,346417,323388,23029,0.06647768440925243,2021-11-23 16:22:37 UTC
795332,mainnet,250,108000000,108346627,346628,323580,23048,0.06649203180354732,2021-11-23 16:24:40 UTC
795333,mainnet,250,108000000,108346869,346870,323777,23093,0.0665753740594459,2021-11-23 16:26:39 UTC
795334,mainnet,250,108000000,108347100,347101,323986,23115,0.06659444945419345,2021-11-23 16:28:37 UTC
795336,mainnet,250,108000000,108347310,347311,324181,23130,0.0665973723838289,2021-11-23 16:30:35 UTC
795337,mainnet,250,108000000,108347532,347533,324392,23141,0.06658648243476159,2021-11-23 16:32:38 UTC
795339,mainnet,250,108000000,108347742,347743,324580,23163,0.06660953635299632,2021-11-23 16:34:37 UTC
795340,mainnet,250,108000000,108347974,347975,324799,23176,0.06660248581076227,2021-11-23 16:36:46 UTC
795342,mainnet,250,108000000,108348193,348194,325003,23191,0.06660367496280808,2021-11-23 16:38:50 UTC
795343,mainnet,250,108000000,108348434,348435,325219,23216,0.06662935698193351,2021-11-23 16:40:43 UTC
795345,mainnet,250,108000000,108348621,348622,325399,23223,0.06661369620964827,2021-11-23 16:43:14 UTC
795346,mainnet,250,108000000,108348927,348928,325657,23271,0.06669284207630227,2021-11-23 16:45:30 UTC
795348,mainnet,250,108000000,108349175,349176,325889,23287,0.06669129607991385,2021-11-23 16:47:40 UTC
795349,mainnet,250,108000000,108349387,349388,326081,23307,0.06670807240088383,2021-11-23 16:49:37 UTC
795351,mainnet,250,108000000,108349654,349655,326332,23323,0.06670289285152507,2021-11-23 16:52:08 UTC
795352,mainnet,250,108000000,108349825,349826,326496,23330,0.06669029746216691,2021-11-23 16:54:05 UTC
795354,mainnet,250,108000000,108350070,350071,326720,23351,0.06670361155308495,2021-11-23 16:56:17 UTC
795355,mainnet,250,108000000,108350301,350302,326920,23382,0.0667481201934331,2021-11-23 16:58:34 UTC
795357,mainnet,250,108000000,108350515,350516,327111,23405,0.06677298611190359,2021-11-23 17:00:45 UTC
795358,mainnet,250,108000000,108350782,350783,327326,23457,0.0668704013592449,2021-11-23 17:03:10 UTC
795359,mainnet,250,108000000,108350955,350956,327490,23466,0.0668630825516589,2021-11-23 17:05:07 UTC
795360,mainnet,250,108000000,108351196,351197,327695,23502,0.06691970603393536,2021-11-23 17:07:20 UTC
795361,mainnet,250,108000000,108351408,351409,327889,23520,0.06693055670173502,2021-11-23 17:09:23 UTC
795362,mainnet,250,108000000,108351645,351646,328103,23543,0.06695085398383602,2021-11-23 17:11:40 UTC
795364,mainnet,250,108000000,108351861,351862,328305,23557,0.06694954271845212,2021-11-23 17:13:33 UTC
795365,mainnet,250,108000000,108352067,352068,328498,23570,0.06694729427269731,2021-11-23 17:15:34 UTC
795367,mainnet,250,108000000,108352318,352319,328725,23594,0.06696771959502609,2021-11-23 17:17:41 UTC
795369,mainnet,250,108000000,108352552,352553,328954,23599,0.06693745337580449,2021-11-23 17:19:44 UTC
795370,mainnet,250,108000000,108352785,352786,329175,23611,0.066927259018215,2021-11-23 17:21:41 UTC
795372,mainnet,250,108000000,108352985,352986,329358,23628,0.06693749893763493,2021-11-23 17:23:47 UTC
795373,mainnet,250,108000000,108353220,353221,329542,23679,0.06703735055390252,2021-11-23 17:25:52 UTC
795374,mainnet,250,108000000,108353431,353432,329728,23704,0.06706806401231354,2021-11-23 17:27:51 UTC
795376,mainnet,250,108000000,108353654,353655,329925,23730,0.067099291682572,2021-11-23 17:30:03 UTC
795377,mainnet,250,108000000,108353840,353841,330087,23754,0.067131847355168,2021-11-23 17:31:58 UTC
795379,mainnet,250,108000000,108354042,354043,330256,23787,0.0671867541513319,2021-11-23 17:34:06 UTC
795380,mainnet,250,108000000,108354255,354256,330439,23817,0.0672310419583578,2021-11-23 17:36:14 UTC
795382,mainnet,250,108000000,108354418,354419,330586,23833,0.06724526619622537,2021-11-23 17:38:27 UTC
795383,mainnet,250,108000000,108354667,354668,330780,23888,0.06735313025139003,2021-11-23 17:40:33 UTC
795385,mainnet,250,108000000,108354874,354875,330938,23937,0.0674519196900317,2021-11-23 17:42:39 UTC
795387,mainnet,250,108000000,108355150,355151,331168,23983,0.0675290228663301,2021-11-23 17:45:08 UTC
795388,mainnet,250,108000000,108355381,355382,331361,24021,0.06759205587227265,2021-11-23 17:47:35 UTC
795390,mainnet,250,108000000,108355613,355614,331552,24062,0.06766325285281231,2021-11-23 17:49:54 UTC
795391,mainnet,250,108000000,108355787,355788,331694,24094,0.06772010298267507,2021-11-23 17:51:58 UTC
795393,mainnet,250,108000000,108355995,355996,331852,24144,0.06782098675266014,2021-11-23 17:53:57 UTC
795395,mainnet,250,108000000,108356210,356211,332036,24175,0.06786707878195788,2021-11-23 17:56:16 UTC
795396,mainnet,250,108000000,108356404,356405,332193,24212,0.06793395154388968,2021-11-23 17:58:18 UTC
795398,mainnet,250,108000000,108356622,356623,332374,24249,0.06799617523266867,2021-11-23 18:00:20 UTC
795399,mainnet,250,108000000,108356811,356812,332529,24283,0.06805544656569847,2021-11-23 18:02:21 UTC
795401,mainnet,250,108000000,108357003,357004,332694,24310,0.0680944751319313,2021-11-23 18:04:24 UTC
795402,mainnet,250,108000000,108357210,357211,332864,24347,0.06815859534000912,2021-11-23 18:06:36 UTC
795403,mainnet,250,108000000,108357401,357402,333029,24373,0.06819491776766778,2021-11-23 18:08:46 UTC
795405,mainnet,250,108000000,108357577,357578,333163,24415,0.06827880909899378,2021-11-23 18:10:44 UTC
795406,mainnet,250,108000000,108357747,357748,333298,24450,0.06834419759160079,2021-11-23 18:12:45 UTC
795408,mainnet,250,108000000,108357955,357956,333477,24479,0.0683854998938417,2021-11-23 18:14:50 UTC
795409,mainnet,250,108000000,108358142,358143,333633,24510,0.06843635084309899,2021-11-23 18:16:55 UTC
795410,mainnet,250,108000000,108358333,358334,333786,24548,0.06850591905875524,2021-11-23 18:19:00 UTC
795412,mainnet,250,108000000,108358551,358552,333972,24580,0.0685535152502287,2021-11-23 18:20:58 UTC
795413,mainnet,250,108000000,108358728,358729,334119,24610,0.06860331893992401,2021-11-23 18:22:56 UTC
795415,mainnet,250,108000000,108358918,358919,334274,24645,0.06866451762096741,2021-11-23 18:25:02 UTC
795416,mainnet,250,108000000,108359098,359099,334429,24670,0.06869971790509025,2021-11-23 18:26:59 UTC
795417,mainnet,250,108000000,108359226,359227,334532,24695,0.06874483265456105,2021-11-23 18:29:02 UTC
795419,mainnet,250,108000000,108359498,359499,334758,24741,0.06882077557934793,2021-11-23 18:31:06 UTC
795420,mainnet,250,108000000,108359708,359709,334944,24765,0.06884731824891788,2021-11-23 18:33:22 UTC
795422,mainnet,250,108000000,108359862,359863,335080,24783,0.06886787471899028,2021-11-23 18:35:24 UTC
795423,mainnet,250,108000000,108360107,360108,335268,24840,0.06897930620813755,2021-11-23 18:37:35 UTC
795425,mainnet,250,108000000,108360343,360344,335450,24894,0.06908398641298315,2021-11-23 18:39:47 UTC
795426,mainnet,250,108000000,108360544,360545,335615,24930,0.06914532166581148,2021-11-23 18:41:55 UTC
795428,mainnet,250,108000000,108360763,360764,335797,24967,0.06920590746305064,2021-11-23 18:44:13 UTC
795430,mainnet,250,108000000,108360913,360914,335942,24972,0.06919099840959342,2021-11-23 18:46:12 UTC
795431,mainnet,250,108000000,108361130,361131,336120,25011,0.06925741628384159,2021-11-23 18:48:14 UTC
795433,mainnet,250,108000000,108361368,361369,336310,25059,0.06934463111113572,2021-11-23 18:50:40 UTC
795434,mainnet,250,108000000,108361548,361549,336463,25086,0.06938478601793947,2021-11-23 18:52:46 UTC
795436,mainnet,250,108000000,108361736,361737,336624,25113,0.06942336559434063,2021-11-23 18:54:48 UTC
795437,mainnet,250,108000000,108361945,361946,336777,25169,0.06953799738082476,2021-11-23 18:57:01 UTC
795439,mainnet,250,108000000,108362102,362103,336914,25189,0.06956308011808794,2021-11-23 18:59:04 UTC
795440,mainnet,250,108000000,108362286,362287,337061,25226,0.06962987907377301,2021-11-23 19:01:11 UTC
795441,mainnet,250,108000000,108362450,362451,337202,25249,0.06966183015083419,2021-11-23 19:03:12 UTC
795443,mainnet,250,108000000,108362682,362683,337381,25302,0.0697634021997171,2021-11-23 19:05:37 UTC
795444,mainnet,250,108000000,108362856,362857,337533,25324,0.06979057865770813,2021-11-23 19:07:44 UTC
795446,mainnet,250,108000000,108363066,363067,337705,25362,0.0698548752709555,2021-11-23 19:09:44 UTC
795447,mainnet,250,108000000,108363268,363269,337879,25390,0.0698931095138864,2021-11-23 19:11:51 UTC
795449,mainnet,250,108000000,108363488,363489,338055,25434,0.06997185609468237,2021-11-23 19:14:24 UTC
795450,mainnet,250,108000000,108363663,363664,338207,25457,0.07000142989132827,2021-11-23 19:16:31 UTC
795452,mainnet,250,108000000,108363839,363840,338348,25492,0.07006376429199648,2021-11-23 19:18:42 UTC
795453,mainnet,250,108000000,108364050,364051,338514,25537,0.07014676515103653,2021-11-23 19:20:50 UTC
795455,mainnet,250,108000000,108364259,364260,338674,25586,0.07024103662219294,2021-11-23 19:23:05 UTC
795456,mainnet,250,108000000,108364370,364371,338748,25623,0.07032118362877397,2021-11-23 19:25:25 UTC
795458,mainnet,250,108000000,108364659,364660,338982,25678,0.07041627817693194,2021-11-23 19:27:27 UTC
795459,mainnet,250,108000000,108364951,364952,339187,25765,0.07059832525921217,2021-11-23 19:30:14 UTC
795461,mainnet,250,108000000,108365168,365169,339357,25812,0.07068508005882208,2021-11-23 19:32:24 UTC
795462,mainnet,250,108000000,108365352,365353,339493,25860,0.07078086124925757,2021-11-23 19:34:28 UTC
795464,mainnet,250,108000000,108365513,365514,339611,25903,0.070867326559311,2021-11-23 19:36:28 UTC
795465,mainnet,250,108000000,108365747,365748,339779,25969,0.07100243883766966,2021-11-23 19:38:39 UTC
795466,mainnet,250,108000000,108365936,365937,339917,26020,0.07110513558344743,2021-11-23 19:40:40 UTC
795468,mainnet,250,108000000,108366140,366141,340080,26061,0.07117749719370406,2021-11-23 19:42:49 UTC
795469,mainnet,250,108000000,108366327,366328,340226,26102,0.0712530846672927,2021-11-23 19:45:00 UTC
795470,mainnet,250,108000000,108366536,366537,340387,26150,0.07134341144277385,2021-11-23 19:47:13 UTC
795472,mainnet,250,108000000,108366699,366700,340514,26186,0.07140987182983365,2021-11-23 19:49:18 UTC
795473,mainnet,250,108000000,108366887,366888,340657,26231,0.07149593336386036,2021-11-23 19:51:28 UTC
795475,mainnet,250,108000000,108367079,367080,340800,26280,0.07159202353710363,2021-11-23 19:53:35 UTC
795476,mainnet,250,108000000,108367247,367248,340941,26307,0.07163279309894131,2021-11-23 19:55:42 UTC
795478,mainnet,250,108000000,108367451,367452,341104,26348,0.0717046035944831,2021-11-23 19:57:59 UTC
795479,mainnet,250,108000000,108367654,367655,341262,26393,0.07178740939195713,2021-11-23 20:00:12 UTC
795481,mainnet,250,108000000,108367804,367805,341394,26411,0.07180707168200541,2021-11-23 20:02:19 UTC
795482,mainnet,250,108000000,108368013,368014,341565,26449,0.07186954844109192,2021-11-23 20:04:23 UTC
795483,mainnet,250,108000000,108368176,368177,341690,26487,0.07194094144935724,2021-11-23 20:06:32 UTC
795485,mainnet,250,108000000,108368355,368356,341798,26558,0.07209873057585596,2021-11-23 20:08:40 UTC
795486,mainnet,250,108000000,108368587,368588,341957,26631,0.0722514026501134,2021-11-23 20:10:49 UTC
795487,mainnet,250,108000000,108368732,368733,342065,26668,0.07232333422828985,2021-11-23 20:12:58 UTC
795489,mainnet,250,108000000,108368954,368955,342238,26717,0.07241262484584841,2021-11-23 20:14:28 UTC
795490,mainnet,250,108000000,108369112,369113,342372,26741,0.07244664912912847,2021-11-23 20:16:21 UTC
795492,mainnet,250,108000000,108369303,369304,342536,26768,0.07248229101228257,2021-11-23 20:18:30 UTC
795493,mainnet,250,108000000,108369522,369523,342714,26809,0.07255028780346555,2021-11-23 20:20:48 UTC
795495,mainnet,250,108000000,108369709,369710,342869,26841,0.07260014606042574,2021-11-23 20:22:55 UTC
795496,mainnet,250,108000000,108369897,369898,343030,26868,0.07263624026082866,2021-11-23 20:25:04 UTC
795498,mainnet,250,108000000,108370110,370111,343214,26897,0.07267279275676757,2021-11-23 20:27:25 UTC
795499,mainnet,250,108000000,108370285,370286,343363,26923,0.07270866303343902,2021-11-23 20:29:40 UTC
795501,mainnet,250,108000000,108370477,370478,343511,26967,0.07278974729943478,2021-11-23 20:31:47 UTC
795502,mainnet,250,108000000,108370709,370710,343695,27015,0.07287367484017156,2021-11-23 20:34:15 UTC
795504,mainnet,250,108000000,108370922,370923,343867,27056,0.07294236270061441,2021-11-23 20:36:44 UTC
795505,mainnet,250,108000000,108371072,371073,343997,27076,0.07296677473165658,2021-11-23 20:38:40 UTC
795507,mainnet,250,108000000,108371275,371276,344161,27115,0.07303192234348571,2021-11-23 20:40:46 UTC
795508,mainnet,250,108000000,108371516,371517,344373,27144,0.07306260547969541,2021-11-23 20:43:10 UTC
795510,mainnet,250,108000000,108371731,371732,344551,27181,0.07311988206557413,2021-11-23 20:45:36 UTC
795511,mainnet,250,108000000,108371944,371945,344710,27235,0.07322319160090873,2021-11-23 20:47:43 UTC
795513,mainnet,250,108000000,108372143,372144,344868,27276,0.073294208693409,2021-11-23 20:50:09 UTC
795514,mainnet,250,108000000,108372279,372280,344982,27298,0.07332652841946921,2021-11-23 20:52:16 UTC
795516,mainnet,250,108000000,108372560,372561,345230,27331,0.07335979879804917,2021-11-23 20:54:23 UTC
795517,mainnet,250,108000000,108372764,372765,345395,27370,0.0734242753477392,2021-11-23 20:56:25 UTC
795519,mainnet,250,108000000,108372968,372969,345569,27400,0.07346455067311224,2021-11-23 20:58:35 UTC
795520,mainnet,250,108000000,108373179,373180,345745,27435,0.07351680154349108,2021-11-23 21:00:59 UTC
795522,mainnet,250,108000000,108373371,373372,345906,27466,0.07356202393323549,2021-11-23 21:03:16 UTC
795523,mainnet,250,108000000,108373576,373577,346078,27499,0.07360999204983176,2021-11-23 21:05:21 UTC
795525,mainnet,250,108000000,108373754,373755,346240,27515,0.07361774424422415,2021-11-23 21:07:37 UTC
795526,mainnet,250,108000000,108373973,373974,346422,27552,0.07367357088995492,2021-11-23 21:09:50 UTC
795528,mainnet,250,108000000,108374170,374171,346586,27585,0.07372297692766142,2021-11-23 21:12:21 UTC
795529,mainnet,250,108000000,108374296,374297,346693,27604,0.07374892131115131,2021-11-23 21:14:33 UTC
795531,mainnet,250,108000000,108374592,374593,346938,27655,0.07382679334637861,2021-11-23 21:16:45 UTC
795532,mainnet,250,108000000,108374826,374827,347132,27695,0.07388742006312245,2021-11-23 21:19:25 UTC
795534,mainnet,250,108000000,108375028,375029,347293,27736,0.07395694732940652,2021-11-23 21:21:49 UTC
795535,mainnet,250,108000000,108375238,375239,347457,27782,0.07403814635472325,2021-11-23 21:24:09 UTC
795537,mainnet,250,108000000,108375419,375420,347610,27810,0.0740770337222311,2021-11-23 21:26:24 UTC
795538,mainnet,250,108000000,108375629,375630,347785,27845,0.07412879695444986,2021-11-23 21:28:30 UTC
795540,mainnet,250,108000000,108375834,375835,347943,27892,0.07421341812231431,2021-11-23 21:30:37 UTC
795541,mainnet,250,108000000,108376041,376042,348120,27922,0.07425234415304674,2021-11-23 21:32:47 UTC
795543,mainnet,250,108000000,108376253,376254,348297,27957,0.07430352899902726,2021-11-23 21:35:19 UTC
795544,mainnet,250,108000000,108376382,376383,348399,27984,0.07434979794517818,2021-11-23 21:37:28 UTC
795546,mainnet,250,108000000,108376674,376675,348638,28037,0.07443286652950155,2021-11-23 21:39:36 UTC
795547,mainnet,250,108000000,108376859,376860,348806,28054,0.07444143713845991,2021-11-23 21:41:43 UTC
795549,mainnet,250,108000000,108377072,377073,348984,28089,0.07449220707926582,2021-11-23 21:43:59 UTC
795550,mainnet,250,108000000,108377269,377270,349133,28137,0.0745805391364275,2021-11-23 21:46:09 UTC
795552,mainnet,250,108000000,108377436,377437,349272,28165,0.07462172495012413,2021-11-23 21:48:17 UTC
795553,mainnet,250,108000000,108377613,377614,349404,28210,0.074705916623854,2021-11-23 21:50:23 UTC
795555,mainnet,250,108000000,108377841,377842,349582,28260,0.07479316751446372,2021-11-23 21:52:38 UTC
795557,mainnet,250,108000000,108378032,378033,349739,28294,0.07484531773681134,2021-11-23 21:54:58 UTC
795558,mainnet,250,108000000,108378279,378280,349934,28346,0.07493391138838955,2021-11-23 21:57:24 UTC
795560,mainnet,250,108000000,108378475,378476,350094,28382,0.07499022395079212,2021-11-23 21:59:42 UTC
795561,mainnet,250,108000000,108378658,378659,350255,28404,0.07501208211081739,2021-11-23 22:02:00 UTC
795563,mainnet,250,108000000,108378872,378873,350417,28456,0.07510696196350757,2021-11-23 22:04:09 UTC
795564,mainnet,250,108000000,108379085,379086,350586,28500,0.0751808296798088,2021-11-23 22:06:16 UTC
795565,mainnet,250,108000000,108379291,379292,350755,28537,0.07523754785231432,2021-11-23 22:08:21 UTC
795566,mainnet,250,108000000,108379512,379513,350950,28563,0.0752622439811021,2021-11-23 22:10:23 UTC
795567,mainnet,250,108000000,108379712,379713,351106,28607,0.07533847932517454,2021-11-23 22:12:27 UTC
795569,mainnet,250,108000000,108379893,379894,351268,28626,0.07535259835638362,2021-11-23 22:14:32 UTC
795570,mainnet,250,108000000,108380096,380097,351449,28648,0.07537023444015606,2021-11-23 22:16:39 UTC
795572,mainnet,250,108000000,108380289,380290,351599,28691,0.07544505508953693,2021-11-23 22:18:41 UTC
795573,mainnet,250,108000000,108380479,380480,351765,28715,0.07547045836837679,2021-11-23 22:20:52 UTC
795575,mainnet,250,108000000,108380701,380702,351953,28749,0.0755157577317692,2021-11-23 22:23:07 UTC
795576,mainnet,250,108000000,108380896,380897,352111,28786,0.0755742366046464,2021-11-23 22:25:23 UTC
795578,mainnet,250,108000000,108381192,381193,352382,28811,0.07558113606493298,2021-11-23 22:27:38 UTC
795579,mainnet,250,108000000,108381454,381455,352620,28835,0.07559214061947019,2021-11-23 22:30:09 UTC
795581,mainnet,250,108000000,108381709,381710,352863,28847,0.07557307903906106,2021-11-23 22:32:30 UTC
795582,mainnet,250,108000000,108381962,381963,353070,28893,0.07564345237627729,2021-11-23 22:35:07 UTC
795584,mainnet,250,108000000,108382182,382183,353252,28931,0.07569933775181,2021-11-23 22:37:31 UTC
795585,mainnet,250,108000000,108382380,382381,353411,28970,0.07576213253273567,2021-11-23 22:39:49 UTC
795587,mainnet,250,108000000,108382597,382598,353579,29019,0.07584723391131161,2021-11-23 22:41:58 UTC
795588,mainnet,250,108000000,108382757,382758,353728,29030,0.07584426713484761,2021-11-23 22:43:43 UTC
795590,mainnet,250,108000000,108382984,382985,353917,29068,0.0758985338851391,2021-11-23 22:45:57 UTC
795591,mainnet,250,108000000,108383215,383216,354098,29118,0.0759832574840299,2021-11-23 22:48:14 UTC
795593,mainnet,250,108000000,108383453,383454,354313,29141,0.07599607775639321,2021-11-23 22:50:50 UTC
795594,mainnet,250,108000000,108383625,383626,354439,29187,0.07608191311329264,2021-11-23 22:53:02 UTC
795596,mainnet,250,108000000,108383884,383885,354655,29230,0.07614259478750146,2021-11-23 22:55:23 UTC
795597,mainnet,250,108000000,108384075,384076,354815,29261,0.07618544246451223,2021-11-23 22:57:55 UTC
795599,mainnet,250,108000000,108384302,384303,354983,29320,0.07629396595915203,2021-11-23 23:00:04 UTC
795600,mainnet,250,108000000,108384516,384517,355177,29340,0.07630351844001695,2021-11-23 23:02:19 UTC
795602,mainnet,250,108000000,108384710,384711,355330,29381,0.07637161401675543,2021-11-23 23:04:24 UTC
795603,mainnet,250,108000000,108384928,384929,355509,29420,0.07642967923954808,2021-11-23 23:06:54 UTC
795605,mainnet,250,108000000,108385162,385163,355728,29435,0.0764221900857559,2021-11-23 23:09:12 UTC
795606,mainnet,250,108000000,108385398,385399,355949,29450,0.07641431347772049,2021-11-23 23:11:27 UTC
795608,mainnet,250,108000000,108385633,385634,356142,29492,0.07647665921573306,2021-11-23 23:13:31 UTC
795609,mainnet,250,108000000,108385839,385840,356339,29501,0.07645915405349367,2021-11-23 23:15:40 UTC
795611,mainnet,250,108000000,108386061,386062,356529,29533,0.07649807543866011,2021-11-23 23:17:44 UTC
795612,mainnet,250,108000000,108386267,386268,356686,29582,0.07658413329605351,2021-11-23 23:19:49 UTC
795614,mainnet,250,108000000,108386488,386489,356878,29611,0.07661537585804512,2021-11-23 23:22:03 UTC
795615,mainnet,250,108000000,108386701,386702,357068,29634,0.07663265253347538,2021-11-23 23:24:08 UTC
795617,mainnet,250,108000000,108386931,386932,357279,29653,0.07663620481118129,2021-11-23 23:26:17 UTC
795618,mainnet,250,108000000,108387154,387155,357460,29695,0.07670054629282845,2021-11-23 23:28:32 UTC
795620,mainnet,250,108000000,108387369,387370,357666,29704,0.07668120917985388,2021-11-23 23:30:49 UTC
795621,mainnet,250,108000000,108387592,387593,357864,29729,0.07670159161801168,2021-11-23 23:33:21 UTC
795623,mainnet,250,108000000,108387869,387870,358102,29768,0.07674736380746126,2021-11-23 23:35:47 UTC
795624,mainnet,250,108000000,108388104,388105,358312,29793,0.07676530835727445,2021-11-23 23:37:53 UTC
795626,mainnet,250,108000000,108388377,388378,358559,29819,0.07677829331218555,2021-11-23 23:40:13 UTC
795627,mainnet,250,108000000,108388645,388646,358821,29825,0.07674078724597706,2021-11-23 23:42:25 UTC
795629,mainnet,250,108000000,108388890,388891,359065,29826,0.07669501222707648,2021-11-23 23:44:31 UTC
795630,mainnet,250,108000000,108389137,389138,359306,29832,0.07666174981626056,2021-11-23 23:46:36 UTC
795632,mainnet,250,108000000,108389411,389412,359573,29839,0.07662578451614228,2021-11-23 23:48:58 UTC
795633,mainnet,250,108000000,108389715,389716,359833,29883,0.07667891490213387,2021-11-23 23:51:32 UTC
795635,mainnet,250,108000000,108389968,389969,360074,29895,0.0766599396362275,2021-11-23 23:53:34 UTC
795636,mainnet,250,108000000,108390220,390221,360317,29904,0.07663349742838033,2021-11-23 23:55:45 UTC
795638,mainnet,250,108000000,108390448,390449,360533,29916,0.07661948167366288,2021-11-23 23:57:51 UTC
795639,mainnet,250,108000000,108390707,390708,360772,29936,0.07661987980793841,2021-11-24 00:00:01 UTC
795641,mainnet,250,108000000,108390977,390978,361029,29949,0.0766002179150745,2021-11-24 00:02:28 UTC
795643,mainnet,250,108000000,108391278,391279,361301,29978,0.07661540742028067,2021-11-24 00:05:05 UTC
795644,mainnet,250,108000000,108391506,391507,361507,30000,0.07662698240389061,2021-11-24 00:07:22 UTC
795646,mainnet,250,108000000,108391758,391759,361738,30021,0.07663129628164254,2021-11-24 00:09:29 UTC
795647,mainnet,250,108000000,108392070,392071,362034,30037,0.07661112400560102,2021-11-24 00:12:11 UTC
795649,mainnet,250,108000000,108392344,392345,362294,30051,0.07659330436223222,2021-11-24 00:14:27 UTC
795650,mainnet,250,108000000,108392631,392632,362577,30055,0.07654750504289004,2021-11-24 00:16:46 UTC
795652,mainnet,250,108000000,108392922,392923,362861,30062,0.07650862891711607,2021-11-24 00:19:12 UTC
795654,mainnet,250,108000000,108393234,393235,363150,30085,0.07650641473927804,2021-11-24 00:21:53 UTC
795655,mainnet,250,108000000,108393482,393483,363379,30104,0.0765064818556329,2021-11-24 00:24:07 UTC
795657,mainnet,250,108000000,108393766,393767,363650,30117,0.0764843168675892,2021-11-24 00:26:30 UTC
795658,mainnet,250,108000000,108394001,394002,363863,30139,0.0764945355607332,2021-11-24 00:28:38 UTC
795660,mainnet,250,108000000,108394274,394275,364132,30143,0.07645171517341957,2021-11-24 00:30:56 UTC
795661,mainnet,250,108000000,108394544,394545,364396,30149,0.07641460416429051,2021-11-24 00:33:12 UTC
795663,mainnet,250,108000000,108394812,394813,364662,30151,0.0763677994392282,2021-11-24 00:35:22 UTC
795664,mainnet,250,108000000,108395068,395069,364873,30196,0.07643221816948431,2021-11-24 00:37:33 UTC
795666,mainnet,250,108000000,108395316,395317,365109,30208,0.07641462421297339,2021-11-24 00:39:41 UTC
795667,mainnet,250,108000000,108395590,395591,365375,30216,0.0763819197100035,2021-11-24 00:41:48 UTC
795669,mainnet,250,108000000,108395848,395849,365621,30228,0.07636245133876807,2021-11-24 00:43:55 UTC
795670,mainnet,250,108000000,108396113,396114,365873,30241,0.07634418374508349,2021-11-24 00:46:08 UTC
795671,mainnet,250,108000000,108396321,396322,366068,30254,0.07633691796064816,2021-11-24 00:48:17 UTC
795672,mainnet,250,108000000,108396568,396569,366282,30287,0.07637258585517274,2021-11-24 00:50:24 UTC
795674,mainnet,250,108000000,108396818,396819,366516,30303,0.07636479100043092,2021-11-24 00:52:27 UTC
795675,mainnet,250,108000000,108397060,397061,366736,30325,0.07637365543329615,2021-11-24 00:54:34 UTC
795676,mainnet,250,108000000,108397332,397333,367000,30333,0.07634150699790855,2021-11-24 00:56:51 UTC
795678,mainnet,250,108000000,108397605,397606,367264,30342,0.07631172567818394,2021-11-24 00:59:02 UTC
795679,mainnet,250,108000000,108397880,397881,367533,30348,0.07627406184261123,2021-11-24 01:01:25 UTC
795681,mainnet,250,108000000,108398155,398156,367802,30354,0.07623645003465979,2021-11-24 01:03:45 UTC
795682,mainnet,250,108000000,108398302,398303,367936,30367,0.07624095223987769,2021-11-24 01:06:00 UTC
795684,mainnet,250,108000000,108398594,398595,368183,30412,0.07629799671345601,2021-11-24 01:07:40 UTC
795685,mainnet,250,108000000,108398868,398869,368442,30427,0.07628319072176579,2021-11-24 01:09:55 UTC
795687,mainnet,250,108000000,108399139,399140,368711,30429,0.07623640827779726,2021-11-24 01:12:08 UTC
795688,mainnet,250,108000000,108399416,399417,368979,30438,0.07620607034753153,2021-11-24 01:14:24 UTC
795690,mainnet,250,108000000,108399668,399669,369207,30462,0.0762180704533001,2021-11-24 01:16:40 UTC
795691,mainnet,250,108000000,108399962,399963,369488,30475,0.0761945479956896,2021-11-24 01:19:01 UTC
795693,mainnet,250,108000000,108400213,400214,369713,30501,0.07621172672620148,2021-11-24 01:21:18 UTC
795694,mainnet,250,108000000,108400498,400499,369963,30536,0.07624488450657804,2021-11-24 01:23:42 UTC
795696,mainnet,250,108000000,108400777,400778,370215,30563,0.07625917590286892,2021-11-24 01:26:31 UTC
795697,mainnet,250,108000000,108401081,401082,370506,30576,0.07623378760452974,2021-11-24 01:28:38 UTC
795699,mainnet,250,108000000,108401327,401328,370706,30622,0.0763016784276203,2021-11-24 01:30:54 UTC
795700,mainnet,250,108000000,108401591,401592,370932,30660,0.07634614235343333,2021-11-24 01:33:29 UTC
795702,mainnet,250,108000000,108401845,401846,371179,30667,0.07631530486803402,2021-11-24 01:35:37 UTC
795703,mainnet,250,108000000,108402105,402106,371435,30671,0.07627590734781375,2021-11-24 01:37:40 UTC
795705,mainnet,250,108000000,108402371,402372,371674,30698,0.07629258497112125,2021-11-24 01:39:54 UTC
795706,mainnet,250,108000000,108402589,402590,371875,30715,0.07629349959015376,2021-11-24 01:42:18 UTC
795708,mainnet,250,108000000,108402831,402832,372070,30762,0.07636434046947611,2021-11-24 01:44:27 UTC
795709,mainnet,250,108000000,108403068,403069,372272,30797,0.07640627287139423,2021-11-24 01:46:45 UTC
795711,mainnet,250,108000000,108403339,403340,372518,30822,0.07641691872861606,2021-11-24 01:49:15 UTC
795713,mainnet,250,108000000,108403590,403591,372753,30838,0.07640903786258861,2021-11-24 01:51:39 UTC
795714,mainnet,250,108000000,108403885,403886,373022,30864,0.07641760298698147,2021-11-24 01:54:06 UTC
795716,mainnet,250,108000000,108404191,404192,373323,30869,0.07637212018050828,2021-11-24 01:56:34 UTC
795717,mainnet,250,108000000,108404442,404443,373553,30890,0.07637664640011077,2021-11-24 01:58:44 UTC
795719,mainnet,250,108000000,108404703,404704,373810,30894,0.07633727366173797,2021-11-24 02:01:01 UTC
795720,mainnet,250,108000000,108405023,405024,374102,30922,0.0763460930710279,2021-11-24 02:03:52 UTC
795722,mainnet,250,108000000,108405295,405296,374352,30944,0.0763491374205519,2021-11-24 02:06:12 UTC
795724,mainnet,250,108000000,108405579,405580,374633,30947,0.07630307214359683,2021-11-24 02:09:09 UTC
795725,mainnet,250,108000000,108405877,405878,374926,30952,0.07625936857873548,2021-11-24 02:11:21 UTC
795726,mainnet,250,108000000,108406111,406112,375130,30982,0.07628929950358522,2021-11-24 02:13:43 UTC
795728,mainnet,250,108000000,108406389,406390,375375,31015,0.07631831491916632,2021-11-24 02:15:51 UTC
795729,mainnet,250,108000000,108406648,406649,375630,31019,0.0762795432916348,2021-11-24 02:17:59 UTC
795730,mainnet,250,108000000,108406836,406837,375794,31043,0.07630328608263261,2021-11-24 02:20:17 UTC
795732,mainnet,250,108000000,108407160,407161,376089,31072,0.07631379233276271,2021-11-24 02:22:32 UTC
795733,mainnet,250,108000000,108407425,407426,376335,31091,0.07631079018030268,2021-11-24 02:24:48 UTC
795734,mainnet,250,108000000,108407673,407674,376568,31106,0.07630116220313289,2021-11-24 02:26:52 UTC
795736,mainnet,250,108000000,108407887,407888,376774,31114,0.07628074373357392,2021-11-24 02:28:58 UTC
795737,mainnet,250,108000000,108408148,408149,377015,31134,0.07628096601976239,2021-11-24 02:31:09 UTC
795739,mainnet,250,108000000,108408412,408413,377265,31148,0.07626593668663828,2021-11-24 02:33:23 UTC
795740,mainnet,250,108000000,108408644,408645,377484,31161,0.07625445068457952,2021-11-24 02:35:38 UTC
795742,mainnet,250,108000000,108408866,408867,377670,31197,0.07630109546625186,2021-11-24 02:37:46 UTC
795743,mainnet,250,108000000,108409086,409087,377864,31223,0.07632361820346284,2021-11-24 02:39:54 UTC
795745,mainnet,250,108000000,108409341,409342,378099,31243,0.07632493123109771,2021-11-24 02:42:07 UTC
795746,mainnet,250,108000000,108409614,409615,378362,31253,0.07629847539762948,2021-11-24 02:44:31 UTC
795748,mainnet,250,108000000,108409854,409855,378598,31257,0.07626355662368399,2021-11-24 02:46:40 UTC
795749,mainnet,250,108000000,108410141,410142,378877,31265,0.07622969605648776,2021-11-24 02:48:59 UTC
795751,mainnet,250,108000000,108410432,410433,379150,31283,0.07621950476691688,2021-11-24 02:51:26 UTC
795752,mainnet,250,108000000,108410718,410719,379431,31288,0.07617860386298175,2021-11-24 02:53:51 UTC
795754,mainnet,250,108000000,108410965,410966,379669,31297,0.0761547183951957,2021-11-24 02:56:03 UTC
795755,mainnet,250,108000000,108411233,411234,379928,31306,0.07612697393697992,2021-11-24 02:58:31 UTC
795757,mainnet,250,108000000,108411522,411523,380214,31309,0.07608080228808596,2021-11-24 03:01:19 UTC
795759,mainnet,250,108000000,108411732,411733,380386,31347,0.07613429091182879,2021-11-24 03:03:35 UTC
795760,mainnet,250,108000000,108411974,411975,380560,31415,0.07625462710115904,2021-11-24 03:05:52 UTC
795762,mainnet,250,108000000,108412069,412070,380650,31420,0.07624918096439925,2021-11-24 03:08:08 UTC
795763,mainnet,250,108000000,108412355,412356,380903,31453,0.07627632434110332,2021-11-24 03:10:08 UTC
795765,mainnet,250,108000000,108412656,412657,381181,31476,0.07627642327647417,2021-11-24 03:12:32 UTC
795766,mainnet,250,108000000,108412926,412927,381436,31491,0.0762628745516762,2021-11-24 03:14:47 UTC
795768,mainnet,250,108000000,108413160,413161,381657,31504,0.07625114664743284,2021-11-24 03:16:54 UTC
795769,mainnet,250,108000000,108413431,413432,381924,31508,0.07621083999303392,2021-11-24 03:19:04 UTC
795771,mainnet,250,108000000,108413688,413689,382176,31513,0.07617558117329686,2021-11-24 03:21:16 UTC
795772,mainnet,250,108000000,108413958,413959,382428,31531,0.0761693790930986,2021-11-24 03:23:27 UTC
795774,mainnet,250,108000000,108414229,414230,382691,31539,0.07613886005359341,2021-11-24 03:25:41 UTC
795775,mainnet,250,108000000,108414466,414467,382919,31548,0.07611703706205801,2021-11-24 03:27:45 UTC
795777,mainnet,250,108000000,108414728,414729,383173,31556,0.07608824075480615,2021-11-24 03:29:51 UTC
795778,mainnet,250,108000000,108414982,414983,383418,31565,0.07606335681220676,2021-11-24 03:32:00 UTC
795780,mainnet,250,108000000,108415257,415258,383679,31579,0.0760466986788936,2021-11-24 03:34:11 UTC
795781,mainnet,250,108000000,108415530,415531,383944,31587,0.07601598918010931,2021-11-24 03:36:23 UTC
795782,mainnet,250,108000000,108415777,415778,384186,31592,0.07598285623577967,2021-11-24 03:38:28 UTC
795784,mainnet,250,108000000,108416005,416006,384396,31610,0.0759844809930626,2021-11-24 03:40:35 UTC
795786,mainnet,250,108000000,108416291,416292,384665,31627,0.07597311502503051,2021-11-24 03:42:59 UTC
795787,mainnet,250,108000000,108416536,416537,384904,31633,0.07594283340975712,2021-11-24 03:45:07 UTC
795788,mainnet,250,108000000,108416795,416796,385138,31658,0.07595562337450455,2021-11-24 03:47:19 UTC
795790,mainnet,250,108000000,108417081,417082,385415,31667,0.07592511784253456,2021-11-24 03:49:56 UTC
795791,mainnet,250,108000000,108417391,417392,385711,31681,0.07590226932955112,2021-11-24 03:52:03 UTC
795793,mainnet,250,108000000,108417587,417588,385898,31690,0.07588819602095846,2021-11-24 03:53:45 UTC
795794,mainnet,250,108000000,108417862,417863,386158,31705,0.0758741501401177,2021-11-24 03:55:57 UTC
795795,mainnet,250,108000000,108418145,418146,386431,31715,0.07584671382722781,2021-11-24 03:58:23 UTC
795797,mainnet,250,108000000,108418408,418409,386682,31727,0.07582771881101984,2021-11-24 04:00:49 UTC
795798,mainnet,250,108000000,108418729,418730,386974,31756,0.07583884603443747,2021-11-24 04:03:11 UTC
795800,mainnet,250,108000000,108419008,419009,387240,31769,0.07581937380819982,2021-11-24 04:05:19 UTC
795801,mainnet,250,108000000,108419275,419276,387477,31799,0.07584264303227468,2021-11-24 04:08:00 UTC
795803,mainnet,250,108000000,108419532,419533,387695,31838,0.07588914340469045,2021-11-24 04:10:58 UTC
795804,mainnet,250,108000000,108419820,419821,387938,31883,0.0759442714871338,2021-11-24 04:13:25 UTC
795806,mainnet,250,108000000,108420077,420078,388174,31904,0.07594780017044454,2021-11-24 04:15:33 UTC
795807,mainnet,250,108000000,108420342,420343,388439,31904,0.07589991982737906,2021-11-24 04:17:42 UTC
795809,mainnet,250,108000000,108420563,420564,388646,31918,0.07589332420273728,2021-11-24 04:19:47 UTC
795810,mainnet,250,108000000,108420825,420826,388866,31960,0.07594587786876286,2021-11-24 04:21:57 UTC
795812,mainnet,250,108000000,108421069,421070,389105,31965,0.07591374355807823,2021-11-24 04:24:02 UTC
795813,mainnet,250,108000000,108421327,421328,389347,31981,0.07590523297763263,2021-11-24 04:26:17 UTC
795815,mainnet,250,108000000,108421594,421595,389608,31987,0.0758713931616836,2021-11-24 04:28:31 UTC
795816,mainnet,250,108000000,108421865,421866,389865,32001,0.07585584048015247,2021-11-24 04:30:42 UTC
795817,mainnet,250,108000000,108422085,422086,390084,32002,0.07581867202418464,2021-11-24 04:32:47 UTC
795819,mainnet,250,108000000,108422338,422339,390304,32035,0.07585138952358177,2021-11-24 04:35:01 UTC
795820,mainnet,250,108000000,108422551,422552,390487,32065,0.07588415153637895,2021-11-24 04:37:10 UTC
795822,mainnet,250,108000000,108422827,422828,390751,32077,0.07586299866612428,2021-11-24 04:39:19 UTC
795823,mainnet,250,108000000,108423100,423101,391020,32081,0.07582350313518521,2021-11-24 04:41:29 UTC
795825,mainnet,250,108000000,108423349,423350,391269,32081,0.07577890634226998,2021-11-24 04:43:33 UTC
795826,mainnet,250,108000000,108423621,423622,391529,32093,0.07575857722214616,2021-11-24 04:45:43 UTC
795827,mainnet,250,108000000,108423899,423900,391802,32098,0.07572068884170795,2021-11-24 04:47:59 UTC
795829,mainnet,250,108000000,108424180,424181,392078,32103,0.07568231486087307,2021-11-24 04:50:27 UTC
795831,mainnet,250,108000000,108424467,424468,392342,32126,0.07568532845821122,2021-11-24 04:52:52 UTC
795832,mainnet,250,108000000,108424780,424781,392637,32144,0.07567193447917868,2021-11-24 04:55:32 UTC
795834,mainnet,250,108000000,108425073,425074,392906,32168,0.07567623519669517,2021-11-24 04:57:53 UTC
795835,mainnet,250,108000000,108425357,425358,393186,32172,0.07563511207030313,2021-11-24 05:00:07 UTC
795837,mainnet,250,108000000,108425636,425637,393453,32184,0.07561372719007041,2021-11-24 05:02:23 UTC
795838,mainnet,250,108000000,108425932,425933,393744,32189,0.0755729187454365,2021-11-24 05:04:53 UTC
795840,mainnet,250,108000000,108426202,426203,393975,32228,0.07561654892152331,2021-11-24 05:07:06 UTC
795841,mainnet,250,108000000,108426447,426448,394215,32233,0.07558483097587514,2021-11-24 05:09:25 UTC
795843,mainnet,250,108000000,108426694,426695,394427,32268,0.07562310315330623,2021-11-24 05:11:37 UTC
795844,mainnet,250,108000000,108426830,426831,394535,32296,0.07566460730359323,2021-11-24 05:13:46 UTC
795846,mainnet,250,108000000,108427121,427122,394740,32382,0.07581440431539467,2021-11-24 05:15:51 UTC
795847,mainnet,250,108000000,108427350,427351,394945,32406,0.07582993838788256,2021-11-24 05:17:58 UTC
795849,mainnet,250,108000000,108427623,427624,395201,32423,0.07582128224795615,2021-11-24 05:20:06 UTC
795850,mainnet,250,108000000,108427880,427881,395447,32434,0.07580144946842697,2021-11-24 05:22:15 UTC
795852,mainnet,250,108000000,108428177,428178,395736,32442,0.07576755461513669,2021-11-24 05:24:45 UTC
795853,mainnet,250,108000000,108428447,428448,396001,32447,0.07573147733213832,2021-11-24 05:26:57 UTC
795855,mainnet,250,108000000,108428708,428709,396238,32471,0.07574135369213149,2021-11-24 05:29:05 UTC
795856,mainnet,250,108000000,108428958,428959,396479,32480,0.07571819218153716,2021-11-24 05:31:13 UTC
795858,mainnet,250,108000000,108429275,429276,396782,32494,0.07569489093264008,2021-11-24 05:33:47 UTC
795859,mainnet,250,108000000,108429554,429555,397051,32504,0.07566900629721456,2021-11-24 05:36:11 UTC
795861,mainnet,250,108000000,108429853,429854,397340,32514,0.07563963578331247,2021-11-24 05:38:43 UTC
795863,mainnet,250,108000000,108430110,430111,397569,32542,0.07565953904922218,2021-11-24 05:41:00 UTC
795864,mainnet,250,108000000,108430354,430355,397805,32550,0.07563523137874545,2021-11-24 05:43:09 UTC
795866,mainnet,250,108000000,108430666,430667,398100,32567,0.07561991051090518,2021-11-24 05:45:39 UTC
795867,mainnet,250,108000000,108430945,430946,398367,32579,0.0755987989214426,2021-11-24 05:47:57 UTC
795869,mainnet,250,108000000,108431222,431223,398631,32592,0.07558038416318238,2021-11-24 05:50:17 UTC
795870,mainnet,250,108000000,108431498,431499,398899,32600,0.07555058065024485,2021-11-24 05:52:38 UTC
795872,mainnet,250,108000000,108431759,431760,399147,32613,0.07553501945525291,2021-11-24 05:54:47 UTC
795873,mainnet,250,108000000,108431966,431967,399352,32615,0.07550345281005262,2021-11-24 05:57:03 UTC
795877,mainnet,251,108432000,108433202,1203,758,445,0.36990856192851207,2021-11-24 06:07:50 UTC
795879,mainnet,251,108432000,108433438,1439,968,471,0.3273106323835997,2021-11-24 06:09:51 UTC
795880,mainnet,251,108432000,108433674,1675,1189,486,0.29014925373134326,2021-11-24 06:12:05 UTC
795882,mainnet,251,108432000,108433948,1949,1457,492,0.25243714725500255,2021-11-24 06:14:19 UTC
795883,mainnet,251,108432000,108434201,2202,1704,498,0.22615803814713897,2021-11-24 06:16:34 UTC
795885,mainnet,251,108432000,108434457,2458,1946,512,0.2082994304312449,2021-11-24 06:18:46 UTC
795886,mainnet,251,108432000,108434702,2703,2185,518,0.19163891971883093,2021-11-24 06:20:45 UTC
795888,mainnet,251,108432000,108434949,2950,2415,535,0.18135593220338983,2021-11-24 06:23:04 UTC
795889,mainnet,251,108432000,108435211,3212,2667,545,0.16967621419676215,2021-11-24 06:25:23 UTC
795891,mainnet,251,108432000,108435456,3457,2905,552,0.15967601967023431,2021-11-24 06:27:35 UTC
795892,mainnet,251,108432000,108435713,3714,3157,557,0.1499730748519117,2021-11-24 06:29:47 UTC
795894,mainnet,251,108432000,108436005,4006,3437,569,0.14203694458312532,2021-11-24 06:32:13 UTC
795895,mainnet,251,108432000,108436304,4305,3714,591,0.1372822299651568,2021-11-24 06:34:47 UTC
795897,mainnet,251,108432000,108436602,4603,3981,622,0.13512926352378885,2021-11-24 06:37:14 UTC
795899,mainnet,251,108432000,108436843,4844,4222,622,0.12840627580511974,2021-11-24 06:39:29 UTC
795900,mainnet,251,108432000,108437180,5181,4545,636,0.12275622466705269,2021-11-24 06:42:07 UTC
795902,mainnet,251,108432000,108437461,5462,4806,656,0.12010252654705236,2021-11-24 06:44:26 UTC
795903,mainnet,251,108432000,108437704,5705,5042,663,0.11621384750219106,2021-11-24 06:46:33 UTC
795905,mainnet,251,108432000,108437898,5899,5225,674,0.11425665367011358,2021-11-24 06:48:40 UTC
795906,mainnet,251,108432000,108438173,6174,5472,702,0.11370262390670553,2021-11-24 06:50:47 UTC
795908,mainnet,251,108432000,108438434,6435,5707,728,0.11313131313131314,2021-11-24 06:53:13 UTC
795909,mainnet,251,108432000,108438742,6743,6001,742,0.11004004152454397,2021-11-24 06:55:48 UTC
795911,mainnet,251,108432000,108439004,7005,6241,764,0.10906495360456817,2021-11-24 06:57:59 UTC
795912,mainnet,251,108432000,108439247,7248,6478,770,0.10623620309050773,2021-11-24 07:00:04 UTC
795914,mainnet,251,108432000,108439525,7526,6742,784,0.10417220302949774,2021-11-24 07:02:20 UTC
795915,mainnet,251,108432000,108439768,7769,6975,794,0.10220105547689536,2021-11-24 07:04:25 UTC
795917,mainnet,251,108432000,108440040,8041,7229,812,0.10098246486755379,2021-11-24 07:06:48 UTC
795918,mainnet,251,108432000,108440312,8313,7480,833,0.10020449897750511,2021-11-24 07:09:06 UTC
795920,mainnet,251,108432000,108440606,8607,7767,840,0.09759498082955734,2021-11-24 07:11:35 UTC
795921,mainnet,251,108432000,108440841,8842,7987,855,0.09669757973309207,2021-11-24 07:13:33 UTC
795923,mainnet,251,108432000,108441073,9074,8210,864,0.09521710381309235,2021-11-24 07:15:34 UTC
795924,mainnet,251,108432000,108441353,9354,8484,870,0.09300833867864015,2021-11-24 07:17:53 UTC
795926,mainnet,251,108432000,108441617,9618,8730,888,0.09232688708671241,2021-11-24 07:20:10 UTC
795927,mainnet,251,108432000,108441840,9841,8930,911,0.09257189310029469,2021-11-24 07:22:15 UTC
795929,mainnet,251,108432000,108442113,10114,9192,922,0.09116076725331224,2021-11-24 07:24:44 UTC
795930,mainnet,251,108432000,108442416,10417,9489,928,0.0890851492752232,2021-11-24 07:27:02 UTC
795932,mainnet,251,108432000,108442720,10721,9782,939,0.0875851133289805,2021-11-24 07:29:37 UTC
795933,mainnet,251,108432000,108443006,11007,10056,951,0.08639956391387299,2021-11-24 07:32:03 UTC
795935,mainnet,251,108432000,108443246,11247,10275,972,0.08642304614563884,2021-11-24 07:34:03 UTC
795936,mainnet,251,108432000,108443494,11495,10514,981,0.08534145280556764,2021-11-24 07:36:16 UTC
795938,mainnet,251,108432000,108443756,11757,10748,1009,0.08582121289444586,2021-11-24 07:38:21 UTC
795939,mainnet,251,108432000,108444029,12030,11000,1030,0.085619285120532,2021-11-24 07:40:38 UTC
795941,mainnet,251,108432000,108444293,12294,11250,1044,0.0849194729136164,2021-11-24 07:42:52 UTC
795942,mainnet,251,108432000,108444546,12547,11501,1046,0.0833665418028214,2021-11-24 07:44:55 UTC
795944,mainnet,251,108432000,108444784,12785,11736,1049,0.08204927649589362,2021-11-24 07:46:57 UTC
795945,mainnet,251,108432000,108445038,13039,11987,1052,0.08068103382161208,2021-11-24 07:49:12 UTC
795947,mainnet,251,108432000,108445292,13293,12232,1061,0.0798164447453547,2021-11-24 07:51:25 UTC
795948,mainnet,251,108432000,108445562,13563,12489,1074,0.07918602079186021,2021-11-24 07:53:38 UTC
795950,mainnet,251,108432000,108445838,13839,12751,1088,0.07861839728304068,2021-11-24 07:55:57 UTC
795951,mainnet,251,108432000,108446116,14117,12997,1120,0.07933696961110717,2021-11-24 07:58:13 UTC
795953,mainnet,251,108432000,108446388,14389,13263,1126,0.07825422197511989,2021-11-24 08:00:26 UTC
795954,mainnet,251,108432000,108446640,14641,13502,1139,0.07779523256608155,2021-11-24 08:02:31 UTC
795955,mainnet,251,108432000,108446879,14880,13736,1144,0.07688172043010753,2021-11-24 08:04:40 UTC
795957,mainnet,251,108432000,108447148,15149,14001,1148,0.07578057957620965,2021-11-24 08:06:54 UTC
795958,mainnet,251,108432000,108447402,15403,14242,1161,0.07537492696228007,2021-11-24 08:09:17 UTC
795960,mainnet,251,108432000,108447676,15677,14491,1186,0.07565222938062129,2021-11-24 08:11:33 UTC
795961,mainnet,251,108432000,108447956,15957,14761,1196,0.07495143197342859,2021-11-24 08:13:45 UTC
795963,mainnet,251,108432000,108448209,16210,15008,1202,0.07415175817396669,2021-11-24 08:15:56 UTC
795964,mainnet,251,108432000,108448457,16458,15250,1208,0.07339895491554259,2021-11-24 08:18:04 UTC
795966,mainnet,251,108432000,108448727,16728,15498,1230,0.07352941176470588,2021-11-24 08:20:22 UTC
795967,mainnet,251,108432000,108448972,16973,15731,1242,0.07317504271490013,2021-11-24 08:22:24 UTC
795969,mainnet,251,108432000,108449244,17245,15990,1255,0.07277471730936504,2021-11-24 08:24:38 UTC
795970,mainnet,251,108432000,108449495,17496,16222,1274,0.07281664380429813,2021-11-24 08:26:44 UTC
795972,mainnet,251,108432000,108449718,17719,16431,1288,0.07269033241153564,2021-11-24 08:28:43 UTC
795973,mainnet,251,108432000,108449934,17935,16643,1292,0.07203791469194312,2021-11-24 08:30:43 UTC
795975,mainnet,251,108432000,108450188,18189,16870,1319,0.07251635603936445,2021-11-24 08:32:53 UTC
795976,mainnet,251,108432000,108450460,18461,17117,1344,0.07280212339526569,2021-11-24 08:35:35 UTC
795978,mainnet,251,108432000,108450694,18695,17334,1361,0.07280021396095213,2021-11-24 08:37:52 UTC
795979,mainnet,251,108432000,108450942,18943,17559,1384,0.07306128913054954,2021-11-24 08:39:53 UTC
795981,mainnet,251,108432000,108451191,19192,17808,1384,0.07211338057523968,2021-11-24 08:42:05 UTC
795982,mainnet,251,108432000,108451479,19480,18077,1403,0.07202258726899384,2021-11-24 08:44:37 UTC
795983,mainnet,251,108432000,108451724,19725,18316,1409,0.07143219264892268,2021-11-24 08:46:45 UTC
795985,mainnet,251,108432000,108451965,19966,18535,1431,0.07167184213162377,2021-11-24 08:48:53 UTC
795986,mainnet,251,108432000,108452197,20198,18759,1439,0.07124467769086049,2021-11-24 08:50:51 UTC
795988,mainnet,251,108432000,108452437,20438,18982,1456,0.07123984734318427,2021-11-24 08:52:55 UTC
795989,mainnet,251,108432000,108452688,20689,19228,1461,0.07061723621248006,2021-11-24 08:55:07 UTC
795991,mainnet,251,108432000,108452959,20960,19493,1467,0.06999045801526718,2021-11-24 08:57:29 UTC
795992,mainnet,251,108432000,108453225,21226,19741,1485,0.06996136813342127,2021-11-24 08:59:57 UTC
795994,mainnet,251,108432000,108453503,21504,20009,1495,0.0695219494047619,2021-11-24 09:02:18 UTC
795995,mainnet,251,108432000,108453814,21815,20310,1505,0.06898922759569104,2021-11-24 09:04:55 UTC
795997,mainnet,251,108432000,108454067,22068,20542,1526,0.06914990030813849,2021-11-24 09:07:07 UTC
795998,mainnet,251,108432000,108454292,22293,20752,1541,0.06912483739290361,2021-11-24 09:09:31 UTC
796000,mainnet,251,108432000,108454614,22615,21057,1558,0.06889232810081804,2021-11-24 09:11:54 UTC
796001,mainnet,251,108432000,108454873,22874,21293,1581,0.06911777564046516,2021-11-24 09:14:07 UTC
796003,mainnet,251,108432000,108455111,23112,21514,1598,0.06914157147802008,2021-11-24 09:16:15 UTC
796004,mainnet,251,108432000,108455352,23353,21733,1620,0.06937010234231147,2021-11-24 09:18:22 UTC
796006,mainnet,251,108432000,108455596,23597,21965,1632,0.06916133406788999,2021-11-24 09:20:28 UTC
796007,mainnet,251,108432000,108455832,23833,22193,1640,0.06881215121889817,2021-11-24 09:22:29 UTC
796008,mainnet,251,108432000,108456083,24084,22442,1642,0.06817804351436639,2021-11-24 09:24:38 UTC
796010,mainnet,251,108432000,108456320,24321,22672,1649,0.06780148842564039,2021-11-24 09:26:38 UTC
796011,mainnet,251,108432000,108456552,24553,22899,1654,0.0673644768460066,2021-11-24 09:28:44 UTC
796013,mainnet,251,108432000,108456843,24844,23181,1663,0.0669376911930446,2021-11-24 09:31:12 UTC
796014,mainnet,251,108432000,108457124,25125,23442,1683,0.06698507462686568,2021-11-24 09:33:22 UTC
796015,mainnet,251,108432000,108457396,25397,23700,1697,0.06681891561995511,2021-11-24 09:35:38 UTC
796017,mainnet,251,108432000,108457677,25678,23972,1706,0.06643819612119324,2021-11-24 09:38:00 UTC
796018,mainnet,251,108432000,108457965,25966,24245,1721,0.0662789802048833,2021-11-24 09:40:11 UTC
796020,mainnet,251,108432000,108458236,26237,24500,1737,0.06620421542097038,2021-11-24 09:42:22 UTC
796021,mainnet,251,108432000,108458522,26523,24781,1742,0.06567884477623195,2021-11-24 09:44:41 UTC
796023,mainnet,251,108432000,108458760,26761,25015,1746,0.06524419864728523,2021-11-24 09:46:47 UTC
796024,mainnet,251,108432000,108459016,27017,25264,1753,0.06488507236184625,2021-11-24 09:48:51 UTC
796026,mainnet,251,108432000,108459271,27272,25514,1758,0.06446171897917277,2021-11-24 09:50:58 UTC
796027,mainnet,251,108432000,108459565,27566,25791,1775,0.06439091634622361,2021-11-24 09:53:25 UTC
796029,mainnet,251,108432000,108459804,27805,26014,1791,0.06441287538212552,2021-11-24 09:55:31 UTC
796030,mainnet,251,108432000,108460094,28095,26277,1818,0.06470902295782167,2021-11-24 09:57:40 UTC
796032,mainnet,251,108432000,108460369,28370,26534,1836,0.06471624955939373,2021-11-24 09:59:55 UTC
796033,mainnet,251,108432000,108460628,28629,26776,1853,0.06472457997135772,2021-11-24 10:02:05 UTC
796035,mainnet,251,108432000,108460881,28882,26996,1886,0.06530018696766152,2021-11-24 10:04:12 UTC
796036,mainnet,251,108432000,108461168,29169,27262,1907,0.06537762693270252,2021-11-24 10:06:44 UTC
796038,mainnet,251,108432000,108461497,29498,27557,1941,0.06580107125906841,2021-11-24 10:09:24 UTC
796040,mainnet,251,108432000,108461796,29797,27832,1965,0.065946236198275,2021-11-24 10:11:52 UTC
796041,mainnet,251,108432000,108462099,30100,28113,1987,0.06601328903654485,2021-11-24 10:14:23 UTC
796042,mainnet,251,108432000,108462379,30380,28372,2008,0.06609611586570112,2021-11-24 10:16:34 UTC
796044,mainnet,251,108432000,108462647,30648,28629,2019,0.06587705559906029,2021-11-24 10:19:10 UTC
796045,mainnet,251,108432000,108462945,30946,28909,2037,0.06582433917145997,2021-11-24 10:21:19 UTC
796047,mainnet,251,108432000,108463215,31216,29171,2045,0.06551127626858022,2021-11-24 10:23:35 UTC
796048,mainnet,251,108432000,108463492,31493,29429,2064,0.06553837360683326,2021-11-24 10:26:00 UTC
796050,mainnet,251,108432000,108463761,31762,29685,2077,0.06539260751841823,2021-11-24 10:28:05 UTC
796051,mainnet,251,108432000,108464048,32049,29951,2098,0.06546226091297701,2021-11-24 10:30:21 UTC
796053,mainnet,251,108432000,108464324,32325,30219,2106,0.0651508120649652,2021-11-24 10:32:37 UTC
796054,mainnet,251,108432000,108464596,32597,30477,2120,0.06503665981532043,2021-11-24 10:34:48 UTC
796056,mainnet,251,108432000,108464951,32952,30806,2146,0.06512503034717164,2021-11-24 10:37:40 UTC
796057,mainnet,251,108432000,108465250,33251,31095,2156,0.06484015518330276,2021-11-24 10:40:15 UTC
796059,mainnet,251,108432000,108465511,33512,31339,2173,0.06484244449749343,2021-11-24 10:42:20 UTC
796060,mainnet,251,108432000,108465810,33811,31622,2189,0.06474224364851676,2021-11-24 10:44:50 UTC
796062,mainnet,251,108432000,108466049,34050,31845,2205,0.06475770925110132,2021-11-24 10:46:49 UTC
796063,mainnet,251,108432000,108466284,34285,32067,2218,0.06469301443780079,2021-11-24 10:48:48 UTC
796065,mainnet,251,108432000,108466548,34549,32325,2224,0.06437234073345104,2021-11-24 10:51:00 UTC
796066,mainnet,251,108432000,108466796,34797,32562,2235,0.06422967497198034,2021-11-24 10:53:08 UTC
796068,mainnet,251,108432000,108467052,35053,32807,2246,0.06407440162040338,2021-11-24 10:55:18 UTC
796070,mainnet,251,108432000,108467332,35333,33072,2261,0.0639911697280163,2021-11-24 10:57:41 UTC
796071,mainnet,251,108432000,108467569,35570,33283,2287,0.06429575484959235,2021-11-24 10:59:45 UTC
796073,mainnet,251,108432000,108467832,35833,33540,2293,0.06399129294225993,2021-11-24 11:01:57 UTC
796074,mainnet,251,108432000,108468045,36046,33749,2297,0.06372413027797814,2021-11-24 11:03:56 UTC
796076,mainnet,251,108432000,108468310,36311,34004,2307,0.06353446613973728,2021-11-24 11:05:59 UTC
796077,mainnet,251,108432000,108468536,36537,34212,2325,0.06363412431234092,2021-11-24 11:07:56 UTC
796078,mainnet,251,108432000,108468778,36779,34448,2331,0.06337855841648767,2021-11-24 11:09:57 UTC
796080,mainnet,251,108432000,108469020,37021,34685,2336,0.06309932200642879,2021-11-24 11:11:57 UTC
796081,mainnet,251,108432000,108469238,37239,34903,2336,0.06272993367168829,2021-11-24 11:13:51 UTC
796082,mainnet,251,108432000,108469455,37456,35116,2340,0.062473302007689024,2021-11-24 11:15:47 UTC
796084,mainnet,251,108432000,108469688,37689,35335,2354,0.06245854228024092,2021-11-24 11:17:44 UTC
796085,mainnet,251,108432000,108469918,37919,35559,2360,0.062237928215406524,2021-11-24 11:19:38 UTC
796087,mainnet,251,108432000,108470141,38142,35758,2384,0.06250327722720361,2021-11-24 11:21:34 UTC
796088,mainnet,251,108432000,108470386,38387,35987,2400,0.06252116601974626,2021-11-24 11:23:37 UTC
796090,mainnet,251,108432000,108470642,38643,36243,2400,0.06210697927179567,2021-11-24 11:25:40 UTC
796091,mainnet,251,108432000,108470920,38921,36512,2409,0.061894607024485494,2021-11-24 11:28:02 UTC
796093,mainnet,251,108432000,108471156,39157,36739,2418,0.06175141098654136,2021-11-24 11:29:56 UTC
796094,mainnet,251,108432000,108471406,39407,36984,2423,0.061486537924734186,2021-11-24 11:32:07 UTC
796096,mainnet,251,108432000,108471695,39696,37261,2435,0.06134119306731157,2021-11-24 11:34:28 UTC
796097,mainnet,251,108432000,108471930,39931,37491,2440,0.06110540682677619,2021-11-24 11:36:33 UTC
796099,mainnet,251,108432000,108472177,40178,37722,2456,0.06112798048683359,2021-11-24 11:38:41 UTC
796100,mainnet,251,108432000,108472417,40418,37950,2468,0.06106190311247464,2021-11-24 11:40:37 UTC
796102,mainnet,251,108432000,108472671,40672,38192,2480,0.06097560975609756,2021-11-24 11:42:50 UTC
796103,mainnet,251,108432000,108472936,40937,38455,2482,0.06062974814959572,2021-11-24 11:45:01 UTC
796105,mainnet,251,108432000,108473179,41180,38684,2496,0.060611947547353086,2021-11-24 11:46:57 UTC
796106,mainnet,251,108432000,108473420,41421,38917,2504,0.06045242751261438,2021-11-24 11:48:58 UTC
796108,mainnet,251,108432000,108473669,41670,39166,2504,0.060091192704583636,2021-11-24 11:51:08 UTC
796109,mainnet,251,108432000,108473921,41922,39398,2524,0.0602070511903058,2021-11-24 11:53:04 UTC
796111,mainnet,251,108432000,108474187,42188,39656,2532,0.06001706646439746,2021-11-24 11:55:18 UTC
796112,mainnet,251,108432000,108474435,42436,39901,2535,0.059737015741351686,2021-11-24 11:57:18 UTC
796114,mainnet,251,108432000,108474668,42669,40133,2536,0.05943424968947011,2021-11-24 11:59:14 UTC
796115,mainnet,251,108432000,108474939,42940,40385,2555,0.059501630181648814,2021-11-24 12:01:35 UTC
796117,mainnet,251,108432000,108475181,43182,40614,2568,0.059469223287480895,2021-11-24 12:03:34 UTC
796118,mainnet,251,108432000,108475433,43434,40849,2585,0.059515586867431046,2021-11-24 12:05:45 UTC
796120,mainnet,251,108432000,108475678,43679,41085,2594,0.059387806497401496,2021-11-24 12:07:53 UTC
796121,mainnet,251,108432000,108475925,43926,41327,2599,0.05916769111687838,2021-11-24 12:09:51 UTC
796123,mainnet,251,108432000,108476166,44167,41560,2607,0.05902596961532366,2021-11-24 12:11:50 UTC
796124,mainnet,251,108432000,108476410,44411,41790,2621,0.05901691022494427,2021-11-24 12:13:46 UTC
796126,mainnet,251,108432000,108476634,44635,42008,2627,0.05885515850789739,2021-11-24 12:15:46 UTC
796127,mainnet,251,108432000,108476873,44874,42238,2636,0.05874225609484334,2021-11-24 12:17:51 UTC
796129,mainnet,251,108432000,108477123,45124,42483,2641,0.058527612800283665,2021-11-24 12:19:53 UTC
796130,mainnet,251,108432000,108477354,45355,42688,2667,0.05880277808400397,2021-11-24 12:21:51 UTC
796131,mainnet,251,108432000,108477590,45591,42911,2680,0.058783531837424054,2021-11-24 12:23:50 UTC
796133,mainnet,251,108432000,108477824,45825,43145,2680,0.058483360611020184,2021-11-24 12:25:53 UTC
796135,mainnet,251,108432000,108478068,46069,43382,2687,0.05832555514554256,2021-11-24 12:28:08 UTC
796136,mainnet,251,108432000,108478341,46342,43638,2704,0.058348798066548704,2021-11-24 12:30:25 UTC
796138,mainnet,251,108432000,108478626,46627,43914,2713,0.05818517168164368,2021-11-24 12:32:44 UTC
796139,mainnet,251,108432000,108478870,46871,44149,2722,0.05807428900599518,2021-11-24 12:34:46 UTC
796141,mainnet,251,108432000,108479140,47141,44406,2735,0.05801743705055048,2021-11-24 12:37:17 UTC
796142,mainnet,251,108432000,108479404,47405,44660,2745,0.05790528425271596,2021-11-24 12:39:21 UTC
796144,mainnet,251,108432000,108479663,47664,44912,2752,0.057737495803961064,2021-11-24 12:41:35 UTC
796145,mainnet,251,108432000,108479902,47903,45146,2757,0.05755380665094044,2021-11-24 12:43:33 UTC
796147,mainnet,251,108432000,108480136,48137,45359,2778,0.057710285227579615,2021-11-24 12:45:40 UTC
796148,mainnet,251,108432000,108480405,48406,45624,2782,0.05747221418832376,2021-11-24 12:47:52 UTC
796150,mainnet,251,108432000,108480632,48633,45840,2793,0.05743014002837579,2021-11-24 12:49:55 UTC
796151,mainnet,251,108432000,108480898,48899,46102,2797,0.057199533732796175,2021-11-24 12:52:13 UTC
796153,mainnet,251,108432000,108481127,49128,46319,2809,0.05717716984204527,2021-11-24 12:54:13 UTC
796154,mainnet,251,108432000,108481382,49383,46554,2829,0.05728692060020655,2021-11-24 12:56:09 UTC
796155,mainnet,251,108432000,108481614,49615,46773,2842,0.05728106419429608,2021-11-24 12:58:06 UTC
796156,mainnet,251,108432000,108481849,49850,46997,2853,0.05723169508525577,2021-11-24 13:00:08 UTC
796158,mainnet,251,108432000,108482112,50113,47246,2867,0.05721070380939078,2021-11-24 13:02:25 UTC
796159,mainnet,251,108432000,108482365,50366,47480,2886,0.057300559901520866,2021-11-24 13:04:35 UTC
796161,mainnet,251,108432000,108482585,50586,47695,2891,0.057150199659984975,2021-11-24 13:06:41 UTC
796162,mainnet,251,108432000,108482823,50824,47921,2903,0.05711868408625846,2021-11-24 13:08:41 UTC
796164,mainnet,251,108432000,108483031,51032,48117,2915,0.05712102210377802,2021-11-24 13:10:43 UTC
796165,mainnet,251,108432000,108483282,51283,48350,2933,0.05719244193982411,2021-11-24 13:12:53 UTC
796167,mainnet,251,108432000,108483511,51512,48571,2941,0.05709349277838174,2021-11-24 13:14:57 UTC
796168,mainnet,251,108432000,108483759,51760,48807,2953,0.05705177743431221,2021-11-24 13:17:07 UTC
796170,mainnet,251,108432000,108484018,52019,49063,2956,0.05682539072262058,2021-11-24 13:19:20 UTC
796171,mainnet,251,108432000,108484246,52247,49287,2960,0.05665397056290313,2021-11-24 13:21:28 UTC
796173,mainnet,251,108432000,108484504,52505,49509,2996,0.05706123226359394,2021-11-24 13:23:45 UTC
796174,mainnet,251,108432000,108484767,52768,49767,3001,0.056871588841722255,2021-11-24 13:25:49 UTC
796176,mainnet,251,108432000,108485055,53056,50032,3024,0.056996381182147164,2021-11-24 13:28:13 UTC
796177,mainnet,251,108432000,108485294,53295,50265,3030,0.05685336335491134,2021-11-24 13:30:12 UTC
796179,mainnet,251,108432000,108485544,53545,50500,3045,0.0568680549070875,2021-11-24 13:32:19 UTC
796180,mainnet,251,108432000,108485802,53803,50741,3062,0.0569113246473245,2021-11-24 13:34:28 UTC
796181,mainnet,251,108432000,108485998,53999,50933,3066,0.056778829237578474,2021-11-24 13:36:25 UTC
796183,mainnet,251,108432000,108486259,54260,51163,3097,0.05707703649096941,2021-11-24 13:38:24 UTC
796184,mainnet,251,108432000,108486482,54483,51372,3111,0.057100379935025605,2021-11-24 13:40:34 UTC
796186,mainnet,251,108432000,108486744,54745,51618,3127,0.057119371632112524,2021-11-24 13:42:38 UTC
796187,mainnet,251,108432000,108486983,54984,51844,3140,0.057107522188272954,2021-11-24 13:44:45 UTC
796189,mainnet,251,108432000,108487211,55212,52066,3146,0.05698036658697385,2021-11-24 13:46:46 UTC
796191,mainnet,251,108432000,108487466,55467,52301,3166,0.05707898390033714,2021-11-24 13:49:04 UTC
796192,mainnet,251,108432000,108487704,55705,52523,3182,0.05712234090297101,2021-11-24 13:51:34 UTC
796194,mainnet,251,108432000,108487936,55937,52731,3206,0.05731447878863722,2021-11-24 13:53:41 UTC
796195,mainnet,251,108432000,108488170,56171,52948,3223,0.05737836250022253,2021-11-24 13:55:44 UTC
796197,mainnet,251,108432000,108488428,56429,53170,3259,0.05775399174183487,2021-11-24 13:58:05 UTC
796198,mainnet,251,108432000,108488637,56638,53371,3267,0.05768212154383982,2021-11-24 14:00:08 UTC
796200,mainnet,251,108432000,108488862,56863,53585,3278,0.05764732778784095,2021-11-24 14:02:25 UTC
796201,mainnet,251,108432000,108489092,57093,53809,3284,0.057520186362601367,2021-11-24 14:04:31 UTC
796203,mainnet,251,108432000,108489346,57347,54037,3310,0.05771879958847019,2021-11-24 14:06:39 UTC
796204,mainnet,251,108432000,108489608,57609,54287,3322,0.05766460101720217,2021-11-24 14:08:49 UTC
796206,mainnet,251,108432000,108489862,57863,54536,3327,0.05749788293037001,2021-11-24 14:11:22 UTC
796207,mainnet,251,108432000,108490111,58112,54752,3360,0.05781938325991189,2021-11-24 14:13:23 UTC
796209,mainnet,251,108432000,108490335,58336,54945,3391,0.05812877125617115,2021-11-24 14:15:35 UTC
796210,mainnet,251,108432000,108490544,58545,55146,3399,0.05805790417627466,2021-11-24 14:17:37 UTC
796212,mainnet,251,108432000,108490787,58788,55356,3432,0.05837926107368851,2021-11-24 14:19:46 UTC
796213,mainnet,251,108432000,108491004,59005,55537,3468,0.05877468011185493,2021-11-24 14:22:03 UTC
796215,mainnet,251,108432000,108491226,59227,55749,3478,0.05872321745150016,2021-11-24 14:24:21 UTC
796216,mainnet,251,108432000,108491479,59480,55980,3500,0.05884330867518493,2021-11-24 14:26:43 UTC
796218,mainnet,251,108432000,108491700,59701,56181,3520,0.058960486424013,2021-11-24 14:28:53 UTC
796220,mainnet,251,108432000,108491944,59945,56413,3532,0.05892067728751355,2021-11-24 14:30:56 UTC
796221,mainnet,251,108432000,108492164,60165,56612,3553,0.05905426743123078,2021-11-24 14:33:00 UTC
796222,mainnet,251,108432000,108492383,60384,56806,3578,0.059254107048224695,2021-11-24 14:35:01 UTC
796224,mainnet,251,108432000,108492579,60580,56981,3599,0.05940904588973259,2021-11-24 14:37:02 UTC
796225,mainnet,251,108432000,108492767,60768,57139,3629,0.05971893101632438,2021-11-24 14:38:58 UTC
796227,mainnet,251,108432000,108492973,60974,57310,3664,0.060091186407321154,2021-11-24 14:41:00 UTC
796228,mainnet,251,108432000,108493193,61194,57513,3681,0.06015295617217374,2021-11-24 14:43:17 UTC
796230,mainnet,251,108432000,108493436,61437,57735,3702,0.060256848478929634,2021-11-24 14:45:26 UTC
796231,mainnet,251,108432000,108493656,61657,57945,3712,0.06020403198339199,2021-11-24 14:47:42 UTC
796232,mainnet,251,108432000,108493912,61913,58179,3734,0.06031043561126096,2021-11-24 14:50:02 UTC
796234,mainnet,251,108432000,108494114,62115,58372,3743,0.06025919665137246,2021-11-24 14:52:08 UTC
796235,mainnet,251,108432000,108494344,62345,58562,3783,0.06067848263693961,2021-11-24 14:54:37 UTC
796237,mainnet,251,108432000,108494616,62617,58804,3813,0.06089400641998179,2021-11-24 14:56:41 UTC
796238,mainnet,251,108432000,108494846,62847,59024,3823,0.060830270339077445,2021-11-24 14:58:42 UTC
796240,mainnet,251,108432000,108495124,63125,59290,3835,0.06075247524752475,2021-11-24 15:01:09 UTC
796241,mainnet,251,108432000,108495348,63349,59494,3855,0.060853367851110514,2021-11-24 15:03:15 UTC
796243,mainnet,251,108432000,108495561,63562,59699,3863,0.06077530600044052,2021-11-24 15:05:14 UTC
796244,mainnet,251,108432000,108495845,63846,59949,3897,0.061037496475895126,2021-11-24 15:07:40 UTC
796246,mainnet,251,108432000,108496069,64070,60158,3912,0.06105821757452786,2021-11-24 15:09:55 UTC
796247,mainnet,251,108432000,108496296,64297,60369,3928,0.06109149727047918,2021-11-24 15:11:54 UTC
796249,mainnet,251,108432000,108496522,64523,60579,3944,0.06112549013530059,2021-11-24 15:14:06 UTC
796250,mainnet,251,108432000,108496752,64753,60763,3990,0.061618766698068046,2021-11-24 15:16:05 UTC
796252,mainnet,251,108432000,108496961,64962,60958,4004,0.061636033373356734,2021-11-24 15:18:13 UTC
796253,mainnet,251,108432000,108497185,65186,61160,4026,0.06176172797840027,2021-11-24 15:20:15 UTC
796254,mainnet,251,108432000,108497404,65405,61363,4042,0.06179955660882196,2021-11-24 15:22:33 UTC
796256,mainnet,251,108432000,108497637,65638,61583,4055,0.061778238215667754,2021-11-24 15:24:36 UTC
796257,mainnet,251,108432000,108497846,65847,61762,4085,0.06203775418773824,2021-11-24 15:26:44 UTC
796259,mainnet,251,108432000,108498101,66102,61982,4120,0.06232791746089377,2021-11-24 15:28:47 UTC
796260,mainnet,251,108432000,108498311,66312,62168,4144,0.06249245988659669,2021-11-24 15:30:57 UTC
796261,mainnet,251,108432000,108498540,66541,62371,4170,0.06266812942396417,2021-11-24 15:32:58 UTC
796263,mainnet,251,108432000,108498768,66769,62589,4180,0.06260390300888137,2021-11-24 15:35:22 UTC
796265,mainnet,251,108432000,108499032,67033,62827,4206,0.06274521504333687,2021-11-24 15:37:23 UTC
796266,mainnet,251,108432000,108499232,67233,63008,4225,0.0628411643091934,2021-11-24 15:39:29 UTC
796267,mainnet,251,108432000,108499399,67400,63154,4246,0.06299703264094955,2021-11-24 15:41:32 UTC
796268,mainnet,251,108432000,108499649,67650,63357,4293,0.0634589800443459,2021-11-24 15:43:33 UTC
796269,mainnet,251,108432000,108499856,67857,63544,4313,0.06356013381080802,2021-11-24 15:45:31 UTC
796271,mainnet,251,108432000,108500067,68068,63745,4323,0.06351001939237233,2021-11-24 15:47:28 UTC
796272,mainnet,251,108432000,108500296,68297,63952,4345,0.06361919264389358,2021-11-24 15:49:32 UTC
796274,mainnet,251,108432000,108500481,68482,64111,4371,0.06382699103414036,2021-11-24 15:51:39 UTC
796275,mainnet,251,108432000,108500672,68673,64262,4411,0.06423193977254525,2021-11-24 15:53:39 UTC
796277,mainnet,251,108432000,108500852,68853,64405,4448,0.06460139717949835,2021-11-24 15:55:41 UTC
796278,mainnet,251,108432000,108501032,69033,64548,4485,0.06496892790404589,2021-11-24 15:57:48 UTC
796280,mainnet,251,108432000,108501190,69191,64659,4532,0.06549984824615918,2021-11-24 15:59:48 UTC
796281,mainnet,251,108432000,108501382,69383,64817,4566,0.06580862747358864,2021-11-24 16:01:59 UTC
796282,mainnet,251,108432000,108501558,69559,64970,4589,0.0659727713164364,2021-11-24 16:04:02 UTC
796283,mainnet,251,108432000,108501732,69733,65104,4629,0.06638177046735405,2021-11-24 16:06:08 UTC
796285,mainnet,251,108432000,108501904,69905,65234,4671,0.06681925470281096,2021-11-24 16:08:10 UTC
796286,mainnet,251,108432000,108502095,70096,65363,4733,0.0675216845469071,2021-11-24 16:10:34 UTC
796288,mainnet,251,108432000,108502229,70230,65464,4766,0.06786273672219849,2021-11-24 16:12:36 UTC
796289,mainnet,251,108432000,108502435,70436,65626,4810,0.06828894315406894,2021-11-24 16:14:45 UTC
796291,mainnet,251,108432000,108502575,70576,65725,4851,0.06873441396508728,2021-11-24 16:16:45 UTC
796292,mainnet,251,108432000,108502772,70773,65851,4922,0.06954629590380512,2021-11-24 16:18:45 UTC
796294,mainnet,251,108432000,108502952,70953,65985,4968,0.07001818104942709,2021-11-24 16:20:56 UTC
796295,mainnet,251,108432000,108503176,71177,66160,5017,0.07048625258159237,2021-11-24 16:23:00 UTC
796297,mainnet,251,108432000,108503333,71334,66277,5057,0.07089186082373061,2021-11-24 16:25:07 UTC
796298,mainnet,251,108432000,108503559,71560,66455,5105,0.07133873672442706,2021-11-24 16:27:13 UTC
796300,mainnet,251,108432000,108503777,71778,66646,5132,0.07149823065563264,2021-11-24 16:29:23 UTC
796301,mainnet,251,108432000,108503963,71964,66791,5173,0.07188316380412428,2021-11-24 16:31:24 UTC
796303,mainnet,251,108432000,108504194,72195,66975,5220,0.07230417618948681,2021-11-24 16:33:50 UTC
796304,mainnet,251,108432000,108504394,72395,67149,5246,0.07246356792596174,2021-11-24 16:35:53 UTC
796306,mainnet,251,108432000,108504605,72606,67325,5281,0.07273503567198303,2021-11-24 16:37:58 UTC
796307,mainnet,251,108432000,108504787,72788,67495,5293,0.07271803044457878,2021-11-24 16:39:59 UTC
796309,mainnet,251,108432000,108505000,73001,67689,5312,0.07276612649141792,2021-11-24 16:41:57 UTC
796310,mainnet,251,108432000,108505160,73161,67846,5315,0.07264799551673706,2021-11-24 16:43:36 UTC
796312,mainnet,251,108432000,108505252,73253,67937,5316,0.07257040667276425,2021-11-24 16:45:37 UTC
796313,mainnet,251,108432000,108505573,73574,68160,5414,0.07358577758447278,2021-11-24 16:47:41 UTC
796315,mainnet,251,108432000,108505757,73758,68302,5456,0.07397163697497221,2021-11-24 16:49:51 UTC
796316,mainnet,251,108432000,108505990,73991,68504,5487,0.07415766782446513,2021-11-24 16:51:58 UTC
796318,mainnet,251,108432000,108506231,74232,68729,5503,0.07413244961741566,2021-11-24 16:54:19 UTC
796319,mainnet,251,108432000,108506404,74405,68893,5512,0.07408104294066259,2021-11-24 16:56:23 UTC
796321,mainnet,251,108432000,108506663,74664,69129,5535,0.0741321118611379,2021-11-24 16:58:16 UTC
796322,mainnet,251,108432000,108506908,74909,69352,5557,0.07418334245551268,2021-11-24 17:00:33 UTC
796324,mainnet,251,108432000,108507127,75128,69552,5576,0.07421999787030135,2021-11-24 17:02:41 UTC
796325,mainnet,251,108432000,108507340,75341,69747,5594,0.07424908084575464,2021-11-24 17:04:44 UTC
796327,mainnet,251,108432000,108507552,75553,69935,5618,0.0743583974163832,2021-11-24 17:06:54 UTC
796328,mainnet,251,108432000,108507770,75771,70144,5627,0.07426324055377387,2021-11-24 17:08:55 UTC
796329,mainnet,251,108432000,108508016,76017,70379,5638,0.07416762040069984,2021-11-24 17:11:19 UTC
796331,mainnet,251,108432000,108508284,76285,70631,5654,0.07411679884643115,2021-11-24 17:13:31 UTC
796332,mainnet,251,108432000,108508502,76503,70840,5663,0.07402324091865678,2021-11-24 17:15:30 UTC
796334,mainnet,251,108432000,108508705,76706,71029,5677,0.07400985581310458,2021-11-24 17:17:39 UTC
796335,mainnet,251,108432000,108508935,76936,71241,5695,0.07402256420921285,2021-11-24 17:19:41 UTC
796337,mainnet,251,108432000,108509154,77155,71451,5704,0.07392910375218716,2021-11-24 17:21:58 UTC
796338,mainnet,251,108432000,108509385,77386,71673,5713,0.07382472281808079,2021-11-24 17:24:02 UTC
796340,mainnet,251,108432000,108509610,77611,71889,5722,0.07372666245764131,2021-11-24 17:26:02 UTC
796341,mainnet,251,108432000,108509818,77819,72090,5729,0.07361955306544674,2021-11-24 17:28:05 UTC
796343,mainnet,251,108432000,108510047,78048,72281,5767,0.07389042640426405,2021-11-24 17:30:13 UTC
796344,mainnet,251,108432000,108510266,78267,72479,5788,0.07395198487229611,2021-11-24 17:32:18 UTC
796346,mainnet,251,108432000,108510483,78484,72662,5822,0.07418072473370368,2021-11-24 17:34:17 UTC
796347,mainnet,251,108432000,108510641,78642,72806,5836,0.07420970982426693,2021-11-24 17:36:21 UTC
796348,mainnet,251,108432000,108510901,78902,73024,5878,0.07449747788395732,2021-11-24 17:38:27 UTC
796350,mainnet,251,108432000,108511123,79124,73232,5892,0.07446539608715434,2021-11-24 17:40:29 UTC
796351,mainnet,251,108432000,108511340,79341,73418,5923,0.07465244955319444,2021-11-24 17:42:48 UTC
796352,mainnet,251,108432000,108511591,79592,73635,5957,0.0748442054477837,2021-11-24 17:44:47 UTC
796354,mainnet,251,108432000,108511815,79816,73846,5970,0.0747970331763055,2021-11-24 17:47:04 UTC
796355,mainnet,251,108432000,108512070,80071,74082,5989,0.07479611844488017,2021-11-24 17:49:14 UTC
796357,mainnet,251,108432000,108512304,80305,74303,6002,0.07474005354585642,2021-11-24 17:51:16 UTC
796358,mainnet,251,108432000,108512560,80561,74558,6003,0.07451496381623862,2021-11-24 17:53:39 UTC
796360,mainnet,251,108432000,108512795,80796,74761,6035,0.0746942917966236,2021-11-24 17:55:45 UTC
796361,mainnet,251,108432000,108513003,81004,74958,6046,0.0746382894671868,2021-11-24 17:57:45 UTC
796363,mainnet,251,108432000,108513225,81226,75164,6062,0.07463127569989905,2021-11-24 17:59:48 UTC
796364,mainnet,251,108432000,108513468,81469,75361,6108,0.07497330272864525,2021-11-24 18:02:02 UTC
796365,mainnet,251,108432000,108513684,81685,75557,6128,0.07501989349329742,2021-11-24 18:04:09 UTC
796366,mainnet,251,108432000,108513890,81891,75754,6137,0.0749410802163852,2021-11-24 18:06:11 UTC
796368,mainnet,251,108432000,108514066,82067,75921,6146,0.0748900288788429,2021-11-24 18:08:11 UTC
796369,mainnet,251,108432000,108514210,82211,76059,6152,0.07483183515587938,2021-11-24 18:10:13 UTC
796371,mainnet,251,108432000,108514503,82504,76318,6186,0.07497818287598176,2021-11-24 18:12:16 UTC
796372,mainnet,251,108432000,108514754,82755,76540,6215,0.07510120234426923,2021-11-24 18:14:32 UTC
796374,mainnet,251,108432000,108515001,83002,76770,6232,0.07508252813185225,2021-11-24 18:16:58 UTC
796375,mainnet,251,108432000,108515240,83241,76991,6250,0.07508319217693205,2021-11-24 18:19:00 UTC
796377,mainnet,251,108432000,108515464,83465,77204,6261,0.07501347870364823,2021-11-24 18:20:56 UTC
796378,mainnet,251,108432000,108515710,83711,77428,6283,0.07505584690184086,2021-11-24 18:23:11 UTC
796380,mainnet,251,108432000,108515931,83932,77636,6296,0.07501310584759091,2021-11-24 18:25:12 UTC
796381,mainnet,251,108432000,108516160,84161,77854,6307,0.0749396989104217,2021-11-24 18:27:16 UTC
796383,mainnet,251,108432000,108516380,84381,78069,6312,0.07480356952394496,2021-11-24 18:29:16 UTC
796384,mainnet,251,108432000,108516629,84630,78299,6331,0.07480798771121351,2021-11-24 18:31:26 UTC
796386,mainnet,251,108432000,108516884,84885,78520,6365,0.07498380161394828,2021-11-24 18:33:44 UTC
796387,mainnet,251,108432000,108517113,85114,78743,6371,0.07485255069671265,2021-11-24 18:35:48 UTC
796389,mainnet,251,108432000,108517302,85303,78929,6374,0.07472187379107417,2021-11-24 18:37:49 UTC
796390,mainnet,251,108432000,108517615,85616,79211,6405,0.07481078303120912,2021-11-24 18:40:33 UTC
796392,mainnet,251,108432000,108517843,85844,79432,6412,0.07469363030613671,2021-11-24 18:42:33 UTC
796393,mainnet,251,108432000,108518071,86072,79641,6431,0.07471651640487034,2021-11-24 18:44:33 UTC
796395,mainnet,251,108432000,108518292,86293,79840,6453,0.07478010962650505,2021-11-24 18:46:49 UTC
796396,mainnet,251,108432000,108518545,86546,80072,6474,0.07480415039401012,2021-11-24 18:49:04 UTC
796398,mainnet,251,108432000,108518767,86768,80284,6484,0.07472801032638761,2021-11-24 18:51:06 UTC
796399,mainnet,251,108432000,108518985,86986,80486,6500,0.07472466833743362,2021-11-24 18:53:04 UTC
796401,mainnet,251,108432000,108519208,87209,80696,6513,0.07468265889988418,2021-11-24 18:55:09 UTC
796402,mainnet,251,108432000,108519472,87473,80936,6537,0.07473163147485509,2021-11-24 18:57:27 UTC
796404,mainnet,251,108432000,108519721,87722,81175,6547,0.07463350128816032,2021-11-24 18:59:44 UTC
796405,mainnet,251,108432000,108519965,87966,81392,6574,0.07473341973035036,2021-11-24 19:02:00 UTC
796407,mainnet,251,108432000,108520218,88219,81630,6589,0.0746891259252542,2021-11-24 19:04:09 UTC
796408,mainnet,251,108432000,108520434,88435,81833,6602,0.07465370045796348,2021-11-24 19:06:10 UTC
796410,mainnet,251,108432000,108520661,88662,82050,6612,0.07457535359003857,2021-11-24 19:08:23 UTC
796411,mainnet,251,108432000,108520888,88889,82268,6621,0.07448615689230388,2021-11-24 19:10:32 UTC
796412,mainnet,251,108432000,108521119,89120,82488,6632,0.0744165170556553,2021-11-24 19:12:44 UTC
796414,mainnet,251,108432000,108521352,89353,82703,6650,0.07442391413830537,2021-11-24 19:14:58 UTC
796415,mainnet,251,108432000,108521597,89598,82931,6667,0.07441014308355097,2021-11-24 19:17:15 UTC
796417,mainnet,251,108432000,108521870,89871,83181,6690,0.07444003071068532,2021-11-24 19:19:38 UTC
796418,mainnet,251,108432000,108522095,90096,83394,6702,0.07438732019179542,2021-11-24 19:21:45 UTC
796420,mainnet,251,108432000,108522380,90381,83658,6723,0.07438510306369701,2021-11-24 19:24:12 UTC
796421,mainnet,251,108432000,108522570,90571,83828,6743,0.07444987910037429,2021-11-24 19:26:10 UTC
796423,mainnet,251,108432000,108522676,90677,83925,6752,0.07446210174575692,2021-11-24 19:28:12 UTC
796424,mainnet,251,108432000,108523033,91034,84236,6798,0.0746753960058879,2021-11-24 19:30:13 UTC
796426,mainnet,251,108432000,108523256,91257,84442,6815,0.07467920269130039,2021-11-24 19:32:22 UTC
796427,mainnet,251,108432000,108523508,91509,84693,6816,0.07448447693669476,2021-11-24 19:34:33 UTC
796429,mainnet,251,108432000,108523749,91750,84923,6827,0.07440871934604905,2021-11-24 19:36:51 UTC
796430,mainnet,251,108432000,108524009,92010,85159,6851,0.07445929790240191,2021-11-24 19:39:07 UTC
796432,mainnet,251,108432000,108524272,92273,85414,6859,0.0743337704420578,2021-11-24 19:41:29 UTC
796433,mainnet,251,108432000,108524558,92559,85675,6884,0.07437418295357556,2021-11-24 19:43:50 UTC
796435,mainnet,251,108432000,108524783,92784,85874,6910,0.07447404724952578,2021-11-24 19:45:57 UTC
796436,mainnet,251,108432000,108525016,93017,86102,6915,0.07434124944902545,2021-11-24 19:48:17 UTC
796438,mainnet,251,108432000,108525249,93250,86320,6930,0.07431635388739946,2021-11-24 19:50:26 UTC
796439,mainnet,251,108432000,108525496,93497,86565,6932,0.07414141630212734,2021-11-24 19:52:36 UTC
796440,mainnet,251,108432000,108525739,93740,86797,6943,0.07406656710049071,2021-11-24 19:54:51 UTC
796441,mainnet,251,108432000,108525952,93953,86988,6965,0.07413281108639426,2021-11-24 19:56:59 UTC
796443,mainnet,251,108432000,108526198,94199,87221,6978,0.07407721950339176,2021-11-24 19:59:09 UTC
796444,mainnet,251,108432000,108526463,94464,87461,7003,0.07413406165311653,2021-11-24 20:01:28 UTC
796445,mainnet,251,108432000,108526701,94702,87680,7022,0.07414838123798864,2021-11-24 20:03:39 UTC
796447,mainnet,251,108432000,108526942,94943,87909,7034,0.07408655719747638,2021-11-24 20:05:47 UTC
796448,mainnet,251,108432000,108527168,95169,88133,7036,0.07393163740293583,2021-11-24 20:07:57 UTC
796449,mainnet,251,108432000,108527385,95386,88336,7050,0.07391021743232759,2021-11-24 20:10:05 UTC
796451,mainnet,251,108432000,108527624,95625,88554,7071,0.07394509803921569,2021-11-24 20:12:20 UTC
796452,mainnet,251,108432000,108527869,95870,88796,7074,0.0737874204652133,2021-11-24 20:14:29 UTC
796453,mainnet,251,108432000,108528107,96108,89021,7087,0.07373995921255254,2021-11-24 20:16:33 UTC
796455,mainnet,251,108432000,108528340,96341,89230,7111,0.07381073478581289,2021-11-24 20:18:44 UTC
796456,mainnet,251,108432000,108528594,96595,89473,7122,0.07373052435426264,2021-11-24 20:20:56 UTC
796458,mainnet,251,108432000,108528818,96819,89680,7139,0.07373552711761121,2021-11-24 20:23:03 UTC
796459,mainnet,251,108432000,108529119,97120,89940,7180,0.07392915980230642,2021-11-24 20:25:42 UTC
796461,mainnet,251,108432000,108529372,97373,90183,7190,0.07383977077834718,2021-11-24 20:27:57 UTC
796462,mainnet,251,108432000,108529616,97617,90422,7195,0.07370642408596863,2021-11-24 20:30:12 UTC
796464,mainnet,251,108432000,108529892,97893,90690,7203,0.07358033771566914,2021-11-24 20:32:44 UTC
796466,mainnet,251,108432000,108530137,98138,90929,7209,0.07345778393690518,2021-11-24 20:35:07 UTC
796467,mainnet,251,108432000,108530359,98360,91145,7215,0.0733529890199268,2021-11-24 20:37:06 UTC
796469,mainnet,251,108432000,108530582,98583,91355,7228,0.0733189292271487,2021-11-24 20:39:04 UTC
796470,mainnet,251,108432000,108530822,98823,91584,7239,0.0732521781366686,2021-11-24 20:41:07 UTC
796471,mainnet,251,108432000,108531056,99057,91811,7246,0.07314980263888468,2021-11-24 20:43:13 UTC
796472,mainnet,251,108432000,108531274,99275,92019,7256,0.07308990178796274,2021-11-24 20:45:12 UTC
796474,mainnet,251,108432000,108531495,99496,92234,7262,0.07298785880839431,2021-11-24 20:47:18 UTC
796475,mainnet,251,108432000,108531745,99746,92475,7271,0.07289515369037355,2021-11-24 20:49:31 UTC
796477,mainnet,251,108432000,108531961,99962,92672,7290,0.07292771253076169,2021-11-24 20:51:34 UTC
796478,mainnet,251,108432000,108532205,100206,92902,7304,0.07288984691535437,2021-11-24 20:53:53 UTC
796479,mainnet,251,108432000,108532439,100440,93120,7320,0.07287933094384708,2021-11-24 20:55:54 UTC
796481,mainnet,251,108432000,108532639,100640,93317,7323,0.07276430842607313,2021-11-24 20:57:51 UTC
796482,mainnet,251,108432000,108532874,100875,93543,7332,0.07268401486988847,2021-11-24 20:59:57 UTC
796484,mainnet,251,108432000,108533118,101119,93775,7344,0.07262730050732305,2021-11-24 21:02:14 UTC
796485,mainnet,251,108432000,108533382,101383,94030,7353,0.07252695225037728,2021-11-24 21:04:31 UTC
796487,mainnet,251,108432000,108533624,101625,94255,7370,0.07252152521525215,2021-11-24 21:06:50 UTC
796488,mainnet,251,108432000,108533843,101844,94466,7378,0.07244413023840383,2021-11-24 21:08:51 UTC
796490,mainnet,251,108432000,108534105,102106,94712,7394,0.0724149413354749,2021-11-24 21:11:29 UTC
796492,mainnet,251,108432000,108534380,102381,94980,7401,0.07228880358660299,2021-11-24 21:14:17 UTC
796493,mainnet,251,108432000,108534540,102541,95132,7409,0.07225402521918062,2021-11-24 21:16:18 UTC
796495,mainnet,251,108432000,108534906,102907,95449,7458,0.07247320396085787,2021-11-24 21:18:40 UTC
796496,mainnet,251,108432000,108535160,103161,95682,7479,0.07249832785645738,2021-11-24 21:20:57 UTC
796498,mainnet,251,108432000,108535388,103389,95905,7484,0.07238681097602259,2021-11-24 21:23:05 UTC
796499,mainnet,251,108432000,108535599,103600,96101,7499,0.07238416988416989,2021-11-24 21:25:08 UTC
796501,mainnet,251,108432000,108535840,103841,96325,7516,0.07237988848335436,2021-11-24 21:27:12 UTC
796502,mainnet,251,108432000,108536054,104055,96533,7522,0.07228869347940993,2021-11-24 21:29:10 UTC
796503,mainnet,251,108432000,108536286,104287,96754,7533,0.07223335602711747,2021-11-24 21:31:14 UTC
796505,mainnet,251,108432000,108536535,104536,96989,7547,0.07219522461161705,2021-11-24 21:33:25 UTC
796506,mainnet,251,108432000,108536776,104777,97225,7552,0.0720768871030856,2021-11-24 21:35:31 UTC
796507,mainnet,251,108432000,108536998,104999,97429,7570,0.0720959247230926,2021-11-24 21:37:37 UTC
796509,mainnet,251,108432000,108537198,105199,97625,7574,0.07199688209963973,2021-11-24 21:39:37 UTC
796510,mainnet,251,108432000,108537473,105474,97890,7584,0.07190397633540019,2021-11-24 21:41:57 UTC
796512,mainnet,251,108432000,108537729,105730,98140,7590,0.07178662631230492,2021-11-24 21:44:03 UTC
796513,mainnet,251,108432000,108537991,105992,98399,7593,0.0716374820741188,2021-11-24 21:46:21 UTC
796515,mainnet,251,108432000,108538223,106224,98625,7599,0.07153750564844102,2021-11-24 21:48:30 UTC
796516,mainnet,251,108432000,108538437,106438,98827,7611,0.07150641688118906,2021-11-24 21:50:41 UTC
796518,mainnet,251,108432000,108538700,106701,99072,7629,0.07149886130401777,2021-11-24 21:52:45 UTC
796519,mainnet,251,108432000,108538976,106977,99343,7634,0.0713611337016368,2021-11-24 21:55:02 UTC
796521,mainnet,251,108432000,108539177,107178,99538,7640,0.07128328574894101,2021-11-24 21:57:11 UTC
796522,mainnet,251,108432000,108539482,107483,99829,7654,0.07121126131574296,2021-11-24 21:59:35 UTC
796524,mainnet,251,108432000,108539744,107745,100078,7667,0.07115875446656457,2021-11-24 22:01:59 UTC
796525,mainnet,251,108432000,108539949,107950,100250,7700,0.07132931912922649,2021-11-24 22:04:00 UTC
796527,mainnet,251,108432000,108540175,108176,100475,7701,0.07118954296701671,2021-11-24 22:06:03 UTC
796528,mainnet,251,108432000,108540392,108393,100679,7714,0.07116695727583884,2021-11-24 22:08:08 UTC
796530,mainnet,251,108432000,108540618,108619,100894,7725,0.07112015393255323,2021-11-24 22:10:08 UTC
796531,mainnet,251,108432000,108540857,108858,101115,7743,0.07112936118613239,2021-11-24 22:12:24 UTC
796533,mainnet,251,108432000,108541104,109105,101349,7756,0.07108748453324779,2021-11-24 22:14:29 UTC
796534,mainnet,251,108432000,108541326,109327,101567,7760,0.07097972138629982,2021-11-24 22:16:30 UTC
796536,mainnet,251,108432000,108541556,109557,101796,7761,0.0708398367972836,2021-11-24 22:18:32 UTC
796537,mainnet,251,108432000,108541790,109791,102021,7770,0.07077082820996257,2021-11-24 22:20:38 UTC
796538,mainnet,251,108432000,108542021,110022,102245,7777,0.07068586282743451,2021-11-24 22:22:39 UTC
796539,mainnet,251,108432000,108542264,110265,102482,7783,0.07058450097492405,2021-11-24 22:24:44 UTC
796541,mainnet,251,108432000,108542505,110506,102718,7788,0.07047581126816643,2021-11-24 22:26:58 UTC
796542,mainnet,251,108432000,108542788,110789,102990,7799,0.07039507532336242,2021-11-24 22:29:11 UTC
796544,mainnet,251,108432000,108543032,111033,103221,7812,0.0703574612952906,2021-11-24 22:31:16 UTC
796545,mainnet,251,108432000,108543309,111310,103492,7818,0.07023627706405534,2021-11-24 22:33:32 UTC
796547,mainnet,251,108432000,108543584,111585,103762,7823,0.07010798942510194,2021-11-24 22:35:48 UTC
796548,mainnet,251,108432000,108543828,111829,103997,7832,0.07003550063042681,2021-11-24 22:37:58 UTC
796550,mainnet,251,108432000,108544099,112100,104190,7910,0.07056199821587868,2021-11-24 22:40:09 UTC
796551,mainnet,251,108432000,108544343,112344,104427,7917,0.07047105319376201,2021-11-24 22:42:24 UTC
796552,mainnet,251,108432000,108544620,112621,104699,7922,0.07034212091883396,2021-11-24 22:44:50 UTC
796554,mainnet,251,108432000,108544898,112899,104962,7937,0.07030177415211826,2021-11-24 22:47:18 UTC
796555,mainnet,251,108432000,108545150,113151,105208,7943,0.07019823068289277,2021-11-24 22:49:27 UTC
796557,mainnet,251,108432000,108545446,113447,105487,7960,0.07016492282739958,2021-11-24 22:52:03 UTC
796558,mainnet,251,108432000,108545710,113711,105729,7982,0.0701954955984909,2021-11-24 22:54:19 UTC
796560,mainnet,251,108432000,108545955,113956,105962,7994,0.07014988241075502,2021-11-24 22:56:25 UTC
796561,mainnet,251,108432000,108546192,114193,106195,7998,0.07003931939786151,2021-11-24 22:58:29 UTC
796563,mainnet,251,108432000,108546494,114495,106483,8012,0.06997685488449278,2021-11-24 23:01:05 UTC
796564,mainnet,251,108432000,108546746,114747,106720,8027,0.06995389857686911,2021-11-24 23:03:20 UTC
796566,mainnet,251,108432000,108546994,114995,106962,8033,0.06985521109613461,2021-11-24 23:05:37 UTC
796567,mainnet,251,108432000,108547228,115229,107180,8049,0.06985220734363745,2021-11-24 23:07:47 UTC
796569,mainnet,251,108432000,108547449,115450,107387,8063,0.06983975747076657,2021-11-24 23:09:46 UTC
796570,mainnet,251,108432000,108547694,115695,107629,8066,0.06971779247158477,2021-11-24 23:12:02 UTC
796572,mainnet,251,108432000,108547953,115954,107867,8087,0.06974317401728272,2021-11-24 23:14:06 UTC
796573,mainnet,251,108432000,108548199,116200,108092,8108,0.069776247848537,2021-11-24 23:16:15 UTC
796575,mainnet,251,108432000,108548430,116431,108296,8135,0.06986970823921464,2021-11-24 23:18:21 UTC
796576,mainnet,251,108432000,108548700,116701,108556,8145,0.06979374641177025,2021-11-24 23:20:47 UTC
796578,mainnet,251,108432000,108548962,116963,108810,8153,0.06970580439968195,2021-11-24 23:22:56 UTC
796579,mainnet,251,108432000,108549201,117202,109043,8159,0.06961485298885685,2021-11-24 23:25:00 UTC
796580,mainnet,251,108432000,108549450,117451,109280,8171,0.06956943746753966,2021-11-24 23:27:23 UTC
796581,mainnet,251,108432000,108549719,117720,109544,8176,0.06945293917770982,2021-11-24 23:29:39 UTC
796583,mainnet,251,108432000,108549998,117999,109819,8180,0.06932262137814728,2021-11-24 23:31:56 UTC
796585,mainnet,251,108432000,108550305,118306,110104,8202,0.06932869000726928,2021-11-24 23:34:36 UTC
796586,mainnet,251,108432000,108550577,118578,110360,8218,0.06930459275750983,2021-11-24 23:36:52 UTC
796588,mainnet,251,108432000,108550839,118840,110617,8223,0.06919387411645911,2021-11-24 23:39:09 UTC
796589,mainnet,251,108432000,108551083,119084,110845,8239,0.06918645661885728,2021-11-24 23:41:14 UTC
796591,mainnet,251,108432000,108551355,119356,111106,8250,0.06912094909346828,2021-11-24 23:43:40 UTC
796592,mainnet,251,108432000,108551646,119647,111382,8265,0.06907820505319816,2021-11-24 23:46:02 UTC
796594,mainnet,251,108432000,108551910,119911,111625,8286,0.06910125009381958,2021-11-24 23:48:20 UTC
796595,mainnet,251,108432000,108552177,120178,111892,8286,0.06894772753748606,2021-11-24 23:50:41 UTC
796597,mainnet,251,108432000,108552456,120457,112165,8292,0.06883784254962352,2021-11-24 23:53:03 UTC
796598,mainnet,251,108432000,108552691,120692,112398,8294,0.06872037914691943,2021-11-24 23:55:12 UTC
796600,mainnet,251,108432000,108552967,120968,112653,8315,0.06873718669400172,2021-11-24 23:57:30 UTC
796601,mainnet,251,108432000,108553200,121201,112870,8331,0.06873705662494534,2021-11-24 23:59:41 UTC
796603,mainnet,251,108432000,108553427,121428,113075,8353,0.06878973548110814,2021-11-25 00:02:04 UTC
796604,mainnet,251,108432000,108553609,121610,113226,8384,0.0689416988734479,2021-11-25 00:04:12 UTC
796606,mainnet,251,108432000,108553798,121799,113386,8413,0.0690728166897922,2021-11-25 00:06:22 UTC
796607,mainnet,251,108432000,108553976,121977,113524,8453,0.069299949990572,2021-11-25 00:08:33 UTC
796608,mainnet,251,108432000,108554195,122196,113697,8499,0.06955219483452814,2021-11-25 00:10:58 UTC
796609,mainnet,251,108432000,108554396,122397,113870,8527,0.06966674019788066,2021-11-25 00:13:06 UTC
796611,mainnet,251,108432000,108554552,122553,114003,8550,0.06976573400895938,2021-11-25 00:15:14 UTC
796612,mainnet,251,108432000,108554764,122765,114186,8579,0.06988148087810044,2021-11-25 00:17:22 UTC
796614,mainnet,251,108432000,108555008,123009,114421,8588,0.0698160297214025,2021-11-25 00:19:40 UTC
796616,mainnet,251,108432000,108555232,123233,114639,8594,0.06973781373495735,2021-11-25 00:21:54 UTC
796617,mainnet,251,108432000,108555480,123481,114868,8613,0.06975162170698326,2021-11-25 00:24:15 UTC
796619,mainnet,251,108432000,108555728,123729,115112,8617,0.06964414163211535,2021-11-25 00:26:27 UTC
796620,mainnet,251,108432000,108555985,123986,115345,8641,0.06969335247527947,2021-11-25 00:28:53 UTC
796622,mainnet,251,108432000,108556162,124163,115520,8643,0.06961010929181802,2021-11-25 00:31:22 UTC
796623,mainnet,251,108432000,108556486,124487,115809,8678,0.06971009021022276,2021-11-25 00:33:25 UTC
796625,mainnet,251,108432000,108556749,124750,116062,8688,0.06964328657314629,2021-11-25 00:35:40 UTC
796626,mainnet,251,108432000,108556991,124992,116290,8702,0.06962045570916539,2021-11-25 00:37:48 UTC
796628,mainnet,251,108432000,108557212,125213,116487,8726,0.06968924951881993,2021-11-25 00:39:51 UTC
796629,mainnet,251,108432000,108557440,125441,116706,8735,0.06963433008346553,2021-11-25 00:41:59 UTC
796631,mainnet,251,108432000,108557652,125653,116910,8743,0.0695805114084025,2021-11-25 00:44:02 UTC
796632,mainnet,251,108432000,108557874,125875,117118,8757,0.0695690168818272,2021-11-25 00:46:05 UTC
796634,mainnet,251,108432000,108558124,126125,117348,8777,0.06958969276511398,2021-11-25 00:48:22 UTC
796635,mainnet,251,108432000,108558337,126338,117533,8805,0.06969399547246276,2021-11-25 00:50:28 UTC
796637,mainnet,251,108432000,108558596,126597,117784,8813,0.06961460382157555,2021-11-25 00:52:40 UTC
796638,mainnet,251,108432000,108558812,126813,117987,8826,0.06959854273615482,2021-11-25 00:54:41 UTC
796639,mainnet,251,108432000,108559052,127053,118211,8842,0.06959300449418747,2021-11-25 00:56:48 UTC
796641,mainnet,251,108432000,108559298,127299,118453,8846,0.06948994100503539,2021-11-25 00:58:54 UTC
796642,mainnet,251,108432000,108559573,127574,118721,8853,0.0693950177935943,2021-11-25 01:01:19 UTC
796644,mainnet,251,108432000,108559833,127834,118976,8858,0.06929298934555753,2021-11-25 01:04:01 UTC
796645,mainnet,251,108432000,108560096,128097,119232,8865,0.0692053678072086,2021-11-25 01:06:03 UTC
796647,mainnet,251,108432000,108560364,128365,119495,8870,0.06909983250886145,2021-11-25 01:08:25 UTC
796648,mainnet,251,108432000,108560604,128605,119730,8875,0.06900975856304187,2021-11-25 01:10:32 UTC
796650,mainnet,251,108432000,108560882,128883,119985,8898,0.06903936128116199,2021-11-25 01:12:47 UTC
796651,mainnet,251,108432000,108561116,129117,120198,8919,0.06907688375659286,2021-11-25 01:15:00 UTC
796653,mainnet,251,108432000,108561377,129378,120452,8926,0.0689916369089026,2021-11-25 01:17:19 UTC
796654,mainnet,251,108432000,108561625,129626,120690,8936,0.06893678737290358,2021-11-25 01:19:37 UTC
796656,mainnet,251,108432000,108561872,129873,120913,8960,0.06899047531049564,2021-11-25 01:21:50 UTC
796657,mainnet,251,108432000,108562135,130136,121154,8982,0.0690201020470892,2021-11-25 01:24:01 UTC
796659,mainnet,251,108432000,108562394,130395,121407,8988,0.06892902335212239,2021-11-25 01:26:33 UTC
796660,mainnet,251,108432000,108562687,130688,121692,8996,0.06883570029382959,2021-11-25 01:28:42 UTC
796662,mainnet,251,108432000,108562910,130911,121913,8998,0.06873371985547433,2021-11-25 01:30:46 UTC
796663,mainnet,251,108432000,108563211,131212,122188,9024,0.06877419748193762,2021-11-25 01:33:14 UTC
796665,mainnet,251,108432000,108563477,131478,122448,9030,0.0686806918267695,2021-11-25 01:35:29 UTC
796666,mainnet,251,108432000,108563734,131735,122699,9036,0.0685922495919839,2021-11-25 01:37:43 UTC
796668,mainnet,251,108432000,108563986,131987,122941,9046,0.06853705289157265,2021-11-25 01:39:51 UTC
796669,mainnet,251,108432000,108564236,132237,123185,9052,0.06845285358863253,2021-11-25 01:41:55 UTC
796671,mainnet,251,108432000,108564467,132468,123401,9067,0.0684467192076577,2021-11-25 01:43:56 UTC
796672,mainnet,251,108432000,108564710,132711,123637,9074,0.068374136281092,2021-11-25 01:46:01 UTC
796673,mainnet,251,108432000,108564944,132945,123849,9096,0.06841927112715784,2021-11-25 01:48:04 UTC
796674,mainnet,251,108432000,108565195,133196,124090,9106,0.06836541637887024,2021-11-25 01:50:20 UTC
796676,mainnet,251,108432000,108565453,133454,124342,9112,0.06827820822155949,2021-11-25 01:52:42 UTC
796678,mainnet,251,108432000,108565728,133729,124597,9132,0.06828735726730926,2021-11-25 01:55:00 UTC
796679,mainnet,251,108432000,108565954,133955,124820,9135,0.06819454294352581,2021-11-25 01:57:06 UTC
796680,mainnet,251,108432000,108566202,134203,125058,9145,0.06814303704090073,2021-11-25 01:59:07 UTC
796682,mainnet,251,108432000,108566454,134455,125310,9145,0.06801532111115242,2021-11-25 02:01:16 UTC
796683,mainnet,251,108432000,108566695,134696,125544,9152,0.06794559600879016,2021-11-25 02:03:17 UTC
796685,mainnet,251,108432000,108566947,134948,125791,9157,0.06785576666567864,2021-11-25 02:05:25 UTC
796686,mainnet,251,108432000,108567174,135175,126011,9164,0.06779360088773811,2021-11-25 02:07:26 UTC
796687,mainnet,251,108432000,108567395,135396,126228,9168,0.06771248781352478,2021-11-25 02:09:25 UTC
796689,mainnet,251,108432000,108567643,135644,126464,9180,0.0676771549054879,2021-11-25 02:11:38 UTC
796690,mainnet,251,108432000,108567881,135882,126699,9183,0.06758069501479225,2021-11-25 02:13:38 UTC
796692,mainnet,251,108432000,108568136,136137,126940,9197,0.06755694631143627,2021-11-25 02:15:41 UTC
796693,mainnet,251,108432000,108568385,136386,127186,9200,0.06745560394761926,2021-11-25 02:17:50 UTC
796695,mainnet,251,108432000,108568672,136673,127468,9205,0.06735053741411984,2021-11-25 02:20:12 UTC
796696,mainnet,251,108432000,108568967,136968,127754,9214,0.06727118743064073,2021-11-25 02:22:42 UTC
796698,mainnet,251,108432000,108569212,137213,127987,9226,0.06723852696173103,2021-11-25 02:24:54 UTC
796699,mainnet,251,108432000,108569427,137428,128196,9232,0.06717699449893763,2021-11-25 02:26:56 UTC
796701,mainnet,251,108432000,108569673,137674,128429,9245,0.06715138660894578,2021-11-25 02:28:57 UTC
796702,mainnet,251,108432000,108569906,137907,128647,9260,0.06714670031252946,2021-11-25 02:30:57 UTC
796704,mainnet,251,108432000,108570146,138147,128884,9263,0.06705176370098519,2021-11-25 02:32:56 UTC
796705,mainnet,251,108432000,108570383,138384,129116,9268,0.06697306046941844,2021-11-25 02:34:56 UTC
796707,mainnet,251,108432000,108570601,138602,129329,9273,0.06690379648201325,2021-11-25 02:36:56 UTC
796708,mainnet,251,108432000,108570889,138890,129599,9291,0.06689466484268126,2021-11-25 02:39:16 UTC
796710,mainnet,251,108432000,108571125,139126,129821,9305,0.06688181935799203,2021-11-25 02:41:22 UTC
796711,mainnet,251,108432000,108571380,139381,130070,9311,0.06680250536299782,2021-11-25 02:43:32 UTC
796713,mainnet,251,108432000,108571651,139652,130332,9320,0.066737318477358,2021-11-25 02:45:58 UTC
796714,mainnet,251,108432000,108571888,139889,130564,9325,0.06665999471009157,2021-11-25 02:47:59 UTC
796716,mainnet,251,108432000,108572122,140123,130797,9326,0.06655581167973852,2021-11-25 02:49:56 UTC
796717,mainnet,251,108432000,108572355,140356,131022,9334,0.06650232266522271,2021-11-25 02:51:57 UTC
796719,mainnet,251,108432000,108572561,140562,131215,9347,0.06649734636672786,2021-11-25 02:54:00 UTC
796720,mainnet,251,108432000,108572763,140764,131395,9369,0.06655821090619761,2021-11-25 02:56:03 UTC
796721,mainnet,251,108432000,108573022,141023,131633,9390,0.06658488331690575,2021-11-25 02:58:08 UTC
796723,mainnet,251,108432000,108573278,141279,131881,9398,0.06652085589507287,2021-11-25 03:00:17 UTC
796724,mainnet,251,108432000,108573510,141511,132100,9411,0.06650366402611811,2021-11-25 03:02:21 UTC
796726,mainnet,251,108432000,108573747,141748,132322,9426,0.06649829274487118,2021-11-25 03:04:21 UTC
796727,mainnet,251,108432000,108573979,141980,132543,9437,0.06646710804338639,2021-11-25 03:06:22 UTC
796728,mainnet,251,108432000,108574226,142227,132785,9442,0.06638683231735183,2021-11-25 03:08:30 UTC
796730,mainnet,251,108432000,108574456,142457,133003,9454,0.06636388524256442,2021-11-25 03:10:30 UTC
796731,mainnet,251,108432000,108574667,142668,133203,9465,0.06634283791740264,2021-11-25 03:12:28 UTC
796732,mainnet,251,108432000,108574938,142939,133456,9483,0.06634298546932607,2021-11-25 03:14:33 UTC
796734,mainnet,251,108432000,108575189,143190,133698,9492,0.06628954535931281,2021-11-25 03:16:51 UTC
796735,mainnet,251,108432000,108575455,143456,133951,9505,0.0662572496096364,2021-11-25 03:18:55 UTC
796737,mainnet,251,108432000,108575723,143724,134206,9518,0.06622415184659486,2021-11-25 03:21:13 UTC
796738,mainnet,251,108432000,108575966,143967,134441,9526,0.06616794126431752,2021-11-25 03:23:22 UTC
796740,mainnet,251,108432000,108576239,144240,134691,9549,0.06620216306156405,2021-11-25 03:25:36 UTC
796741,mainnet,251,108432000,108576484,144485,134924,9561,0.06617295913070562,2021-11-25 03:27:52 UTC
796743,mainnet,251,108432000,108576783,144784,135210,9574,0.0661260912808045,2021-11-25 03:30:24 UTC
796745,mainnet,251,108432000,108577024,145025,135441,9584,0.06608515773142562,2021-11-25 03:32:27 UTC
796746,mainnet,251,108432000,108577321,145322,135731,9591,0.06599826591981943,2021-11-25 03:34:58 UTC
796747,mainnet,251,108432000,108577581,145582,135981,9601,0.06594908711241775,2021-11-25 03:37:03 UTC
796749,mainnet,251,108432000,108577832,145833,136225,9608,0.06588357916246666,2021-11-25 03:39:13 UTC
796750,mainnet,251,108432000,108578104,146105,136492,9613,0.06579514732555354,2021-11-25 03:41:30 UTC
796752,mainnet,251,108432000,108578373,146374,136752,9622,0.06573571809201087,2021-11-25 03:43:51 UTC
796753,mainnet,251,108432000,108578616,146617,136984,9633,0.0657017944713096,2021-11-25 03:46:04 UTC
796755,mainnet,251,108432000,108578888,146889,137243,9646,0.06566863413870337,2021-11-25 03:48:15 UTC
796756,mainnet,251,108432000,108579123,147124,137473,9651,0.06559772708735488,2021-11-25 03:50:15 UTC
796758,mainnet,251,108432000,108579363,147364,137707,9657,0.06553160880540702,2021-11-25 03:52:18 UTC
796759,mainnet,251,108432000,108579581,147582,137919,9663,0.06547546448753913,2021-11-25 03:54:17 UTC
796760,mainnet,251,108432000,108579861,147862,138184,9678,0.06545292231946004,2021-11-25 03:56:40 UTC
796761,mainnet,251,108432000,108580094,148095,138417,9678,0.06534994429251494,2021-11-25 03:58:39 UTC
796763,mainnet,251,108432000,108580339,148340,138657,9683,0.06527571794526088,2021-11-25 04:00:43 UTC
796764,mainnet,251,108432000,108580577,148578,138889,9689,0.06521153872040275,2021-11-25 04:02:43 UTC
796765,mainnet,251,108432000,108580792,148793,139101,9692,0.06513747286498693,2021-11-25 04:04:44 UTC
796766,mainnet,251,108432000,108581052,149053,139350,9703,0.06509764982925537,2021-11-25 04:06:45 UTC
796768,mainnet,251,108432000,108581282,149283,139564,9719,0.06510453300107849,2021-11-25 04:08:46 UTC
796769,mainnet,251,108432000,108581532,149533,139806,9727,0.06504918646720122,2021-11-25 04:10:44 UTC
796771,mainnet,251,108432000,108581761,149762,140022,9740,0.06503652461906224,2021-11-25 04:12:42 UTC
796772,mainnet,251,108432000,108582013,150014,140261,9753,0.06501393203301026,2021-11-25 04:14:42 UTC
796774,mainnet,251,108432000,108582252,150253,140477,9776,0.06506359274024479,2021-11-25 04:16:47 UTC
796775,mainnet,251,108432000,108582491,150492,140707,9785,0.06502006751189432,2021-11-25 04:18:54 UTC
796776,mainnet,251,108432000,108582749,150750,140952,9798,0.06499502487562189,2021-11-25 04:21:07 UTC
796778,mainnet,251,108432000,108582972,150973,141158,9815,0.06501162459512629,2021-11-25 04:23:08 UTC
796779,mainnet,251,108432000,108583201,151202,141371,9831,0.065018981230407,2021-11-25 04:25:07 UTC
796781,mainnet,251,108432000,108583468,151469,141635,9834,0.06492417590398035,2021-11-25 04:27:30 UTC
796782,mainnet,251,108432000,108583708,151709,141874,9835,0.06482805898133927,2021-11-25 04:29:32 UTC
796784,mainnet,251,108432000,108583929,151930,142071,9859,0.06489172645297177,2021-11-25 04:31:34 UTC
796785,mainnet,251,108432000,108584199,152200,142318,9882,0.06492772667542707,2021-11-25 04:33:53 UTC
796787,mainnet,251,108432000,108584460,152461,142572,9889,0.06486248942352471,2021-11-25 04:36:08 UTC
796788,mainnet,251,108432000,108584696,152697,142806,9891,0.0647753393976306,2021-11-25 04:38:14 UTC
796790,mainnet,251,108432000,108584952,152953,143057,9896,0.06469961360679424,2021-11-25 04:40:25 UTC
796791,mainnet,251,108432000,108585171,153172,143265,9907,0.06467892304076463,2021-11-25 04:42:24 UTC
796793,mainnet,251,108432000,108585466,153467,143552,9915,0.06460672326949768,2021-11-25 04:44:47 UTC
796794,mainnet,251,108432000,108585708,153709,143793,9916,0.06451151201295956,2021-11-25 04:46:52 UTC
796795,mainnet,251,108432000,108585959,153960,144034,9926,0.06447129124447909,2021-11-25 04:49:05 UTC
796797,mainnet,251,108432000,108586212,154213,144282,9931,0.06439794310466693,2021-11-25 04:51:09 UTC
796798,mainnet,251,108432000,108586431,154432,144492,9940,0.06436489846663904,2021-11-25 04:53:10 UTC
796799,mainnet,251,108432000,108586677,154678,144737,9941,0.06426899753035338,2021-11-25 04:55:12 UTC
796801,mainnet,251,108432000,108586922,154923,144982,9941,0.06416736055976195,2021-11-25 04:57:16 UTC
796802,mainnet,251,108432000,108587172,155173,145222,9951,0.06412842440373002,2021-11-25 04:59:21 UTC
796804,mainnet,251,108432000,108587476,155477,145516,9961,0.06406735401377696,2021-11-25 05:01:48 UTC
796805,mainnet,251,108432000,108587754,155755,145780,9975,0.06404288786876826,2021-11-25 05:04:04 UTC
796807,mainnet,251,108432000,108587977,155978,146000,9978,0.06397055995076228,2021-11-25 05:06:07 UTC
796809,mainnet,251,108432000,108588273,156274,146284,9990,0.06392618093860783,2021-11-25 05:09:01 UTC
796810,mainnet,251,108432000,108588593,156594,146603,9991,0.06380193366284788,2021-11-25 05:11:15 UTC
796811,mainnet,251,108432000,108588837,156838,146834,10004,0.0637855621724327,2021-11-25 05:13:15 UTC
796813,mainnet,251,108432000,108589064,157065,147051,10014,0.06375704326234362,2021-11-25 05:15:14 UTC
796814,mainnet,251,108432000,108589306,157307,147274,10033,0.06377974279593407,2021-11-25 05:17:19 UTC
796816,mainnet,251,108432000,108589584,157585,147541,10044,0.06373703080876987,2021-11-25 05:19:45 UTC
796817,mainnet,251,108432000,108589816,157817,147772,10045,0.06364967018762237,2021-11-25 05:21:46 UTC
796819,mainnet,251,108432000,108590043,158044,147984,10060,0.06365315987952722,2021-11-25 05:23:48 UTC
796820,mainnet,251,108432000,108590280,158281,148209,10072,0.06363366417952881,2021-11-25 05:25:52 UTC
796822,mainnet,251,108432000,108590492,158493,148413,10080,0.0635990233007136,2021-11-25 05:27:56 UTC
796823,mainnet,251,108432000,108590740,158741,148638,10103,0.06364455307702484,2021-11-25 05:29:59 UTC
796825,mainnet,251,108432000,108590911,158912,148807,10105,0.06358865283930729,2021-11-25 05:32:05 UTC
796826,mainnet,251,108432000,108591228,159229,149105,10124,0.06358138278831117,2021-11-25 05:34:18 UTC
796828,mainnet,251,108432000,108591452,159453,149323,10130,0.06352969213498648,2021-11-25 05:36:19 UTC
796829,mainnet,251,108432000,108591718,159719,149574,10145,0.06351780314176773,2021-11-25 05:38:31 UTC
796831,mainnet,251,108432000,108591964,159965,149811,10154,0.06347638545931923,2021-11-25 05:40:44 UTC
796832,mainnet,251,108432000,108592185,160186,150030,10156,0.06340129599340766,2021-11-25 05:42:48 UTC
796834,mainnet,251,108432000,108592444,160445,150268,10177,0.06342983576926672,2021-11-25 05:44:59 UTC
796835,mainnet,251,108432000,108592694,160695,150513,10182,0.06336227013908335,2021-11-25 05:47:20 UTC
796837,mainnet,251,108432000,108592941,160942,150746,10196,0.06335201501161909,2021-11-25 05:49:30 UTC
796838,mainnet,251,108432000,108593188,161189,150991,10198,0.06326734454584369,2021-11-25 05:51:37 UTC
796840,mainnet,251,108432000,108593400,161401,151198,10203,0.06321522171485926,2021-11-25 05:53:36 UTC
796841,mainnet,251,108432000,108593644,161645,151429,10216,0.06320022271026014,2021-11-25 05:55:48 UTC
796843,mainnet,251,108432000,108593893,161894,151677,10217,0.0631091949053084,2021-11-25 05:57:46 UTC
796844,mainnet,251,108432000,108594125,162126,151902,10224,0.06306206284001332,2021-11-25 06:00:11 UTC
796846,mainnet,251,108432000,108594460,162461,152233,10228,0.06295664805707216,2021-11-25 06:02:43 UTC
796847,mainnet,251,108432000,108594698,162699,152464,10235,0.06290757779703625,2021-11-25 06:04:46 UTC
796849,mainnet,251,108432000,108594928,162929,152692,10237,0.06283104910727985,2021-11-25 06:06:58 UTC
796850,mainnet,251,108432000,108595168,163169,152927,10242,0.06276927602669624,2021-11-25 06:09:07 UTC
796852,mainnet,251,108432000,108595412,163413,153165,10248,0.06271226891373391,2021-11-25 06:11:16 UTC
796853,mainnet,251,108432000,108595646,163647,153389,10258,0.06268370333706087,2021-11-25 06:13:22 UTC
796855,mainnet,251,108432000,108595863,163864,153592,10272,0.06268612996143143,2021-11-25 06:15:24 UTC
796856,mainnet,251,108432000,108596086,164087,153799,10288,0.06269844655579053,2021-11-25 06:17:29 UTC
796857,mainnet,251,108432000,108596309,164310,154009,10301,0.06269247154768426,2021-11-25 06:19:29 UTC
796859,mainnet,251,108432000,108596537,164538,154231,10307,0.0626420644471186,2021-11-25 06:21:37 UTC
796860,mainnet,251,108432000,108596766,164767,154428,10339,0.06274921555894081,2021-11-25 06:23:43 UTC
796861,mainnet,251,108432000,108596990,164991,154631,10360,0.06279130376808433,2021-11-25 06:25:44 UTC
796863,mainnet,251,108432000,108597222,165223,154851,10372,0.06277576366486506,2021-11-25 06:27:45 UTC
796864,mainnet,251,108432000,108597456,165457,155083,10374,0.06269906984896378,2021-11-25 06:29:49 UTC
796866,mainnet,251,108432000,108597645,165646,155264,10382,0.0626758267630972,2021-11-25 06:31:53 UTC
796867,mainnet,251,108432000,108597899,165900,155493,10407,0.06273056057866185,2021-11-25 06:34:05 UTC
796869,mainnet,251,108432000,108598154,166155,155739,10416,0.06268845355240589,2021-11-25 06:36:46 UTC
796870,mainnet,251,108432000,108598431,166432,156002,10430,0.06266823687752356,2021-11-25 06:38:56 UTC
796872,mainnet,251,108432000,108598655,166656,156217,10439,0.06263800883256529,2021-11-25 06:41:05 UTC
796873,mainnet,251,108432000,108598882,166883,156438,10445,0.06258875978979285,2021-11-25 06:43:05 UTC
796875,mainnet,251,108432000,108599112,167113,156648,10465,0.06262229748732893,2021-11-25 06:45:14 UTC
796876,mainnet,251,108432000,108599352,167353,156870,10483,0.06264004828117811,2021-11-25 06:47:23 UTC
796878,mainnet,251,108432000,108599580,167581,157096,10485,0.06256675876143476,2021-11-25 06:49:28 UTC
796879,mainnet,251,108432000,108599821,167822,157328,10494,0.06253053830844585,2021-11-25 06:51:34 UTC
796881,mainnet,251,108432000,108600089,168090,157593,10497,0.06244868820274853,2021-11-25 06:53:56 UTC
796882,mainnet,251,108432000,108600319,168320,157812,10508,0.0624287072243346,2021-11-25 06:56:04 UTC
796883,mainnet,251,108432000,108600590,168591,158074,10517,0.062381740425052346,2021-11-25 06:58:25 UTC
796885,mainnet,251,108432000,108600816,168817,158296,10521,0.0623219225551929,2021-11-25 07:00:30 UTC
796886,mainnet,251,108432000,108601100,169101,158562,10539,0.06232370003725584,2021-11-25 07:03:05 UTC
796888,mainnet,251,108432000,108601321,169322,158765,10557,0.06234866113086309,2021-11-25 07:05:01 UTC
796889,mainnet,251,108432000,108601562,169563,158988,10575,0.062366200173386885,2021-11-25 07:07:10 UTC
796891,mainnet,251,108432000,108601787,169788,159207,10581,0.06231889179447311,2021-11-25 07:09:09 UTC
796892,mainnet,251,108432000,108602008,170009,159403,10606,0.062384932562393754,2021-11-25 07:11:16 UTC
796894,mainnet,251,108432000,108602224,170225,159610,10615,0.06235864297253635,2021-11-25 07:13:18 UTC
796895,mainnet,251,108432000,108602460,170461,159838,10623,0.06231924017810526,2021-11-25 07:15:29 UTC
796896,mainnet,251,108432000,108602719,170720,160092,10628,0.06225398313027179,2021-11-25 07:17:43 UTC
796897,mainnet,251,108432000,108602949,170950,160314,10636,0.06221702252120503,2021-11-25 07:19:48 UTC
796898,mainnet,251,108432000,108603185,171186,160532,10654,0.062236397836271655,2021-11-25 07:21:54 UTC
796900,mainnet,251,108432000,108603425,171426,160767,10659,0.06217843267649015,2021-11-25 07:24:09 UTC
796901,mainnet,251,108432000,108603690,171691,161020,10671,0.06215235510306306,2021-11-25 07:26:18 UTC
796903,mainnet,251,108432000,108603962,171963,161279,10684,0.06212964416764071,2021-11-25 07:28:40 UTC
796904,mainnet,251,108432000,108604191,172192,161490,10702,0.062151551756179146,2021-11-25 07:30:49 UTC
796906,mainnet,251,108432000,108604433,172434,161725,10709,0.06210492130322326,2021-11-25 07:33:02 UTC
796907,mainnet,251,108432000,108604680,172681,161963,10718,0.06206820669326678,2021-11-25 07:35:10 UTC
796908,mainnet,251,108432000,108604906,172907,162156,10751,0.06217793380256439,2021-11-25 07:37:13 UTC
796909,mainnet,251,108432000,108605167,173168,162411,10757,0.06211886722720133,2021-11-25 07:39:33 UTC
796911,mainnet,251,108432000,108605415,173416,162653,10763,0.06206463071458228,2021-11-25 07:41:51 UTC
796912,mainnet,251,108432000,108605652,173653,162871,10782,0.06208933908426575,2021-11-25 07:43:56 UTC
796914,mainnet,251,108432000,108605872,173873,163078,10795,0.06208554519678156,2021-11-25 07:46:02 UTC
796915,mainnet,251,108432000,108606109,174110,163289,10821,0.0621503647119637,2021-11-25 07:48:07 UTC
796917,mainnet,251,108432000,108606333,174334,163502,10832,0.06213360560762674,2021-11-25 07:50:06 UTC
796918,mainnet,251,108432000,108606572,174573,163725,10848,0.06214019350071317,2021-11-25 07:52:18 UTC
796920,mainnet,251,108432000,108606809,174810,163949,10861,0.06213031291116069,2021-11-25 07:54:17 UTC
796921,mainnet,251,108432000,108607057,175058,164189,10869,0.06208799369351872,2021-11-25 07:56:30 UTC
796922,mainnet,251,108432000,108607277,175278,164399,10879,0.062067116238204455,2021-11-25 07:58:32 UTC
796924,mainnet,251,108432000,108607521,175522,164627,10895,0.06207199097549025,2021-11-25 08:00:43 UTC
796925,mainnet,251,108432000,108607766,175767,164866,10901,0.06201960550046368,2021-11-25 08:02:53 UTC
796927,mainnet,251,108432000,108608016,176017,165099,10918,0.062028099558565364,2021-11-25 08:04:59 UTC
796928,mainnet,251,108432000,108608325,176326,165399,10927,0.061970441114753354,2021-11-25 08:07:48 UTC
796930,mainnet,251,108432000,108608549,176550,165620,10930,0.061908807703200223,2021-11-25 08:09:55 UTC
796931,mainnet,251,108432000,108608796,176797,165854,10943,0.0618958466489816,2021-11-25 08:12:32 UTC
796933,mainnet,251,108432000,108609076,177077,166128,10949,0.061831858457055404,2021-11-25 08:14:42 UTC
796934,mainnet,251,108432000,108609304,177305,166342,10963,0.06183130763373847,2021-11-25 08:16:41 UTC
796936,mainnet,251,108432000,108609577,177578,166605,10973,0.061792564394238025,2021-11-25 08:19:03 UTC
796937,mainnet,251,108432000,108609845,177846,166857,10989,0.061789413312641275,2021-11-25 08:21:33 UTC
796939,mainnet,251,108432000,108610118,178119,167126,10993,0.061717166613331535,2021-11-25 08:23:46 UTC
796940,mainnet,251,108432000,108610379,178380,167354,11026,0.061811862316403184,2021-11-25 08:26:01 UTC
796942,mainnet,251,108432000,108610611,178612,167570,11042,0.06182115423375809,2021-11-25 08:28:08 UTC
796943,mainnet,251,108432000,108610850,178851,167787,11064,0.06186154955801198,2021-11-25 08:30:18 UTC
796945,mainnet,251,108432000,108611115,179116,168042,11074,0.061825855869939036,2021-11-25 08:32:46 UTC
796946,mainnet,251,108432000,108611388,179389,168301,11088,0.061809809966051434,2021-11-25 08:35:05 UTC
796948,mainnet,251,108432000,108611659,179660,168557,11103,0.061800066792830906,2021-11-25 08:37:20 UTC
796950,mainnet,251,108432000,108611935,179936,168824,11112,0.061755290770051575,2021-11-25 08:39:49 UTC
796951,mainnet,251,108432000,108612189,180190,169071,11119,0.061707086963760475,2021-11-25 08:41:58 UTC
796952,mainnet,251,108432000,108612422,180423,169294,11129,0.06168282314339081,2021-11-25 08:44:05 UTC
796953,mainnet,251,108432000,108612628,180629,169488,11141,0.06167891091685167,2021-11-25 08:46:17 UTC
796955,mainnet,251,108432000,108612845,180846,169686,11160,0.061709963173086496,2021-11-25 08:48:16 UTC
796956,mainnet,251,108432000,108613079,181080,169910,11170,0.061685442898166555,2021-11-25 08:50:19 UTC
796958,mainnet,251,108432000,108613302,181303,170128,11175,0.06163714886129849,2021-11-25 08:52:21 UTC
796959,mainnet,251,108432000,108613554,181555,170367,11188,0.06162319958139407,2021-11-25 08:54:28 UTC
796961,mainnet,251,108432000,108613795,181796,170594,11202,0.061618517459130016,2021-11-25 08:56:39 UTC
796962,mainnet,251,108432000,108614021,182022,170810,11212,0.061596949819252615,2021-11-25 08:58:48 UTC
796963,mainnet,251,108432000,108614232,182233,171004,11229,0.06161891644213727,2021-11-25 09:00:49 UTC
796965,mainnet,251,108432000,108614466,182467,171220,11247,0.06163854285980479,2021-11-25 09:02:57 UTC
796966,mainnet,251,108432000,108614710,182711,171450,11261,0.06163285188083914,2021-11-25 09:05:00 UTC
796967,mainnet,251,108432000,108614926,182927,171630,11297,0.06175687569358269,2021-11-25 09:07:16 UTC
796969,mainnet,251,108432000,108615165,183166,171860,11306,0.06172542939191771,2021-11-25 09:09:19 UTC
796970,mainnet,251,108432000,108615420,183421,172101,11320,0.061715943103570474,2021-11-25 09:11:35 UTC
796972,mainnet,251,108432000,108615636,183637,172303,11334,0.061719588100437275,2021-11-25 09:13:39 UTC
796973,mainnet,251,108432000,108615923,183924,172564,11360,0.06176464191731367,2021-11-25 09:16:20 UTC
796975,mainnet,251,108432000,108616167,184168,172786,11382,0.061802267494895965,2021-11-25 09:18:23 UTC
796976,mainnet,251,108432000,108616406,184407,173008,11399,0.06181435628799341,2021-11-25 09:20:34 UTC
796978,mainnet,251,108432000,108616637,184638,173215,11423,0.06186700462526674,2021-11-25 09:22:50 UTC
796979,mainnet,251,108432000,108616962,184963,173535,11428,0.06178533003898077,2021-11-25 09:25:26 UTC
796980,mainnet,251,108432000,108617193,185194,173746,11448,0.061816257546140806,2021-11-25 09:27:29 UTC
796981,mainnet,251,108432000,108617419,185420,173961,11459,0.061800237299104735,2021-11-25 09:29:40 UTC
796983,mainnet,251,108432000,108617643,185644,174173,11471,0.061790308332076445,2021-11-25 09:31:42 UTC
796984,mainnet,251,108432000,108617900,185901,174410,11491,0.06181247007815988,2021-11-25 09:34:01 UTC
796986,mainnet,251,108432000,108618119,186120,174625,11495,0.0617612293144208,2021-11-25 09:36:03 UTC
796987,mainnet,251,108432000,108618380,186381,174869,11512,0.0617659525380806,2021-11-25 09:38:16 UTC
796989,mainnet,251,108432000,108618738,186739,175217,11522,0.06170109082730442,2021-11-25 09:41:15 UTC
796991,mainnet,251,108432000,108618950,186951,175414,11537,0.06171135752148959,2021-11-25 09:43:21 UTC
796992,mainnet,251,108432000,108619201,187202,175640,11562,0.061762160660676704,2021-11-25 09:45:32 UTC
796993,mainnet,251,108432000,108619428,187429,175857,11572,0.061740712483126944,2021-11-25 09:47:46 UTC
796995,mainnet,251,108432000,108619672,187673,176094,11579,0.06169774021835853,2021-11-25 09:49:53 UTC
796996,mainnet,251,108432000,108619884,187885,176267,11618,0.061835697368070895,2021-11-25 09:51:56 UTC
796998,mainnet,251,108432000,108620132,188133,176488,11645,0.061897700031360796,2021-11-25 09:54:08 UTC
796999,mainnet,251,108432000,108620368,188369,176705,11664,0.06192101672780553,2021-11-25 09:56:15 UTC
797001,mainnet,251,108432000,108620602,188603,176933,11670,0.06187600409325408,2021-11-25 09:58:23 UTC
797002,mainnet,251,108432000,108620864,188865,177171,11694,0.06191724247478358,2021-11-25 10:00:39 UTC
797004,mainnet,251,108432000,108621044,189045,177345,11700,0.061890026184241845,2021-11-25 10:02:41 UTC
797005,mainnet,251,108432000,108621248,189249,177539,11710,0.06187615258204799,2021-11-25 10:04:49 UTC
797007,mainnet,251,108432000,108621475,189476,177751,11725,0.06188118811881188,2021-11-25 10:06:57 UTC
797008,mainnet,251,108432000,108621704,189705,177958,11747,0.061922458554070796,2021-11-25 10:09:05 UTC
797010,mainnet,251,108432000,108621929,189930,178156,11774,0.06199125993787185,2021-11-25 10:11:12 UTC
797011,mainnet,251,108432000,108622151,190152,178358,11794,0.06202406495855947,2021-11-25 10:13:23 UTC
797013,mainnet,251,108432000,108622356,190357,178531,11826,0.062125374953377076,2021-11-25 10:15:33 UTC
797014,mainnet,251,108432000,108622552,190553,178707,11846,0.062166431386543375,2021-11-25 10:17:38 UTC
797016,mainnet,251,108432000,108622792,190793,178930,11863,0.062177333549973006,2021-11-25 10:19:59 UTC
797017,mainnet,251,108432000,108622983,190984,179108,11876,0.062183219536715115,2021-11-25 10:22:06 UTC
797019,mainnet,251,108432000,108623218,191219,179325,11894,0.06220093191576151,2021-11-25 10:24:24 UTC
797020,mainnet,251,108432000,108623415,191416,179511,11905,0.06219438291469888,2021-11-25 10:26:27 UTC
797022,mainnet,251,108432000,108623630,191631,179704,11927,0.06223940802897235,2021-11-25 10:28:36 UTC
797023,mainnet,251,108432000,108623855,191856,179898,11958,0.062327995996997745,2021-11-25 10:30:41 UTC
797024,mainnet,251,108432000,108624080,192081,180110,11971,0.062322665958632034,2021-11-25 10:32:53 UTC
797026,mainnet,251,108432000,108624293,192294,180316,11978,0.062290035050495594,2021-11-25 10:34:56 UTC
797027,mainnet,251,108432000,108624511,192512,180520,11992,0.062292220744680854,2021-11-25 10:37:05 UTC
797028,mainnet,251,108432000,108624738,192739,180730,12009,0.062307057730921094,2021-11-25 10:39:11 UTC
797030,mainnet,251,108432000,108624954,192955,180934,12021,0.0622994998833925,2021-11-25 10:41:21 UTC
797031,mainnet,251,108432000,108625157,193158,181124,12034,0.062301328446142536,2021-11-25 10:43:25 UTC
797032,mainnet,251,108432000,108625407,193408,181355,12053,0.06231903540701522,2021-11-25 10:45:37 UTC
797034,mainnet,251,108432000,108625582,193583,181526,12057,0.062283361658823345,2021-11-25 10:47:37 UTC
797035,mainnet,251,108432000,108625833,193834,181743,12091,0.06237811735815182,2021-11-25 10:49:44 UTC
797036,mainnet,251,108432000,108626039,194040,181933,12107,0.06239435168006596,2021-11-25 10:51:54 UTC
797038,mainnet,251,108432000,108626308,194309,182191,12118,0.06236458424468244,2021-11-25 10:54:15 UTC
797039,mainnet,251,108432000,108626529,194530,182384,12146,0.06243767028221868,2021-11-25 10:56:31 UTC
797041,mainnet,251,108432000,108626798,194799,182641,12158,0.06241305140170124,2021-11-25 10:58:41 UTC
797042,mainnet,251,108432000,108627052,195053,182887,12166,0.06237279098501433,2021-11-25 11:01:03 UTC
797043,mainnet,251,108432000,108627291,195292,183108,12184,0.06238862831042746,2021-11-25 11:03:20 UTC
797045,mainnet,251,108432000,108627514,195515,183304,12211,0.062455566069099556,2021-11-25 11:05:35 UTC
797046,mainnet,251,108432000,108627739,195740,183510,12230,0.06248084193317666,2021-11-25 11:07:43 UTC
797048,mainnet,251,108432000,108627960,195961,183723,12238,0.06245120202489271,2021-11-25 11:09:44 UTC
797049,mainnet,251,108432000,108628198,196199,183942,12257,0.062472285791466825,2021-11-25 11:11:52 UTC
797051,mainnet,251,108432000,108628458,196459,184188,12271,0.062460869698003144,2021-11-25 11:14:18 UTC
797052,mainnet,251,108432000,108628665,196666,184393,12273,0.06240529628913996,2021-11-25 11:16:24 UTC
797054,mainnet,251,108432000,108628901,196902,184620,12282,0.062376207453454,2021-11-25 11:18:37 UTC
797055,mainnet,251,108432000,108629141,197142,184849,12293,0.06235606821478934,2021-11-25 11:20:44 UTC
797057,mainnet,251,108432000,108629391,197392,185098,12294,0.062282159358028694,2021-11-25 11:23:01 UTC
797058,mainnet,251,108432000,108629622,197623,185308,12315,0.06231562115745637,2021-11-25 11:25:16 UTC
797060,mainnet,251,108432000,108629872,197873,185525,12348,0.06240366295553208,2021-11-25 11:27:18 UTC
797061,mainnet,251,108432000,108630118,198119,185741,12378,0.06247760184535557,2021-11-25 11:29:26 UTC
797063,mainnet,251,108432000,108630340,198341,185954,12387,0.06245304803343736,2021-11-25 11:31:33 UTC
797064,mainnet,251,108432000,108630570,198571,186151,12420,0.06254689758323219,2021-11-25 11:33:43 UTC
797066,mainnet,251,108432000,108630795,198796,186353,12443,0.06259180265196483,2021-11-25 11:35:50 UTC
797067,mainnet,251,108432000,108631044,199045,186584,12461,0.06260393378381773,2021-11-25 11:38:04 UTC
797069,mainnet,251,108432000,108631272,199273,186800,12473,0.0625925238241006,2021-11-25 11:40:09 UTC
797070,mainnet,251,108432000,108631522,199523,187041,12482,0.06255920370082647,2021-11-25 11:42:21 UTC
797072,mainnet,251,108432000,108631750,199751,187261,12490,0.06252784716972631,2021-11-25 11:44:26 UTC
797073,mainnet,251,108432000,108631975,199976,187470,12506,0.06253750450054006,2021-11-25 11:46:37 UTC
797075,mainnet,251,108432000,108632223,200224,187696,12528,0.06256992168770976,2021-11-25 11:48:39 UTC
797076,mainnet,251,108432000,108632452,200453,187918,12535,0.06253336193521673,2021-11-25 11:50:50 UTC
797077,mainnet,251,108432000,108632672,200673,188125,12548,0.06252958793659337,2021-11-25 11:52:51 UTC
797079,mainnet,251,108432000,108632900,200901,188348,12553,0.06248351177943365,2021-11-25 11:54:59 UTC
797080,mainnet,251,108432000,108633097,201098,188529,12569,0.06250186476245413,2021-11-25 11:57:03 UTC
797082,mainnet,251,108432000,108633334,201335,188742,12593,0.06254749546775275,2021-11-25 11:59:15 UTC
797083,mainnet,251,108432000,108633578,201579,188976,12603,0.06252139359754737,2021-11-25 12:01:22 UTC
797084,mainnet,251,108432000,108633784,201785,189172,12613,0.06250712391902272,2021-11-25 12:03:26 UTC
797086,mainnet,251,108432000,108634006,202007,189387,12620,0.06247308261594895,2021-11-25 12:05:29 UTC
797087,mainnet,251,108432000,108634255,202256,189613,12643,0.0625098884581916,2021-11-25 12:07:47 UTC
797089,mainnet,251,108432000,108634486,202487,189818,12669,0.06256697960856747,2021-11-25 12:09:52 UTC
797090,mainnet,251,108432000,108634701,202702,190004,12698,0.06264368383143729,2021-11-25 12:12:04 UTC
797092,mainnet,251,108432000,108634896,202897,190186,12711,0.06264755023484822,2021-11-25 12:14:02 UTC
797093,mainnet,251,108432000,108635114,203115,190380,12735,0.06269847130935677,2021-11-25 12:16:12 UTC
797095,mainnet,251,108432000,108635301,203302,190558,12744,0.0626850695025135,2021-11-25 12:18:14 UTC
797096,mainnet,251,108432000,108635516,203517,190753,12764,0.06271711945439447,2021-11-25 12:20:22 UTC
797098,mainnet,251,108432000,108635723,203724,190942,12782,0.06274174864031729,2021-11-25 12:22:24 UTC
797099,mainnet,251,108432000,108635942,203943,191148,12795,0.06273811800355981,2021-11-25 12:24:34 UTC
797101,mainnet,251,108432000,108636158,204159,191350,12809,0.06274031514652795,2021-11-25 12:26:38 UTC
797102,mainnet,251,108432000,108636404,204405,191594,12811,0.0626745921088036,2021-11-25 12:28:51 UTC
797104,mainnet,251,108432000,108636610,204611,191791,12820,0.06265547795573063,2021-11-25 12:31:06 UTC
797105,mainnet,251,108432000,108636860,204861,192029,12832,0.06263759329496585,2021-11-25 12:33:18 UTC
797107,mainnet,251,108432000,108637117,205118,192272,12846,0.06262736571144414,2021-11-25 12:35:43 UTC
797108,mainnet,251,108432000,108637372,205373,192485,12888,0.06275411081300852,2021-11-25 12:38:00 UTC
797110,mainnet,251,108432000,108637589,205590,192696,12894,0.0627170582226762,2021-11-25 12:40:17 UTC
797111,mainnet,251,108432000,108637812,205813,192907,12906,0.06270740915296896,2021-11-25 12:42:31 UTC
797113,mainnet,251,108432000,108638032,206033,193112,12921,0.06271325467279514,2021-11-25 12:44:29 UTC
797114,mainnet,251,108432000,108638248,206249,193304,12945,0.06276394067365175,2021-11-25 12:46:36 UTC
797116,mainnet,251,108432000,108638480,206481,193519,12962,0.06277575176408483,2021-11-25 12:48:41 UTC
797117,mainnet,251,108432000,108638669,206670,193691,12979,0.06280059999032274,2021-11-25 12:50:52 UTC
797119,mainnet,251,108432000,108638880,206881,193888,12993,0.06280422078392893,2021-11-25 12:52:53 UTC
797120,mainnet,251,108432000,108639110,207111,194105,13006,0.06279724398993776,2021-11-25 12:55:09 UTC
797121,mainnet,251,108432000,108639324,207325,194303,13022,0.0628095984565296,2021-11-25 12:57:11 UTC
797123,mainnet,251,108432000,108639533,207534,194500,13034,0.06280416702805323,2021-11-25 12:59:17 UTC
797124,mainnet,251,108432000,108639665,207666,194625,13041,0.0627979544075583,2021-11-25 13:01:37 UTC
797126,mainnet,251,108432000,108640027,208028,194953,13075,0.06285211606129944,2021-11-25 13:04:00 UTC
797127,mainnet,251,108432000,108640241,208242,195138,13104,0.06292678710346616,2021-11-25 13:06:09 UTC
797128,mainnet,251,108432000,108640474,208475,195363,13112,0.0628948315145701,2021-11-25 13:08:18 UTC
797130,mainnet,251,108432000,108640707,208708,195585,13123,0.06287732142514901,2021-11-25 13:10:28 UTC
797131,mainnet,251,108432000,108640948,208949,195808,13141,0.06289094468028084,2021-11-25 13:12:51 UTC
797133,mainnet,251,108432000,108641186,209187,196031,13156,0.0628910974391334,2021-11-25 13:15:01 UTC
797134,mainnet,251,108432000,108641428,209429,196251,13178,0.06292347287147435,2021-11-25 13:17:17 UTC
797136,mainnet,251,108432000,108641652,209653,196470,13183,0.0628800923430621,2021-11-25 13:19:21 UTC
797137,mainnet,251,108432000,108641883,209884,196687,13197,0.06287758952564274,2021-11-25 13:21:34 UTC
797138,mainnet,251,108432000,108642126,210127,196911,13216,0.06289529665392835,2021-11-25 13:24:16 UTC
797140,mainnet,251,108432000,108642425,210426,197194,13232,0.06288196325549124,2021-11-25 13:26:30 UTC
797141,mainnet,251,108432000,108642653,210654,197389,13265,0.06297055835635687,2021-11-25 13:28:39 UTC
797143,mainnet,251,108432000,108642873,210874,197602,13272,0.06293805779754735,2021-11-25 13:30:48 UTC
797144,mainnet,251,108432000,108643117,211118,197841,13277,0.06288900046419538,2021-11-25 13:32:55 UTC
797146,mainnet,251,108432000,108643360,211361,198078,13283,0.06284508494944668,2021-11-25 13:35:03 UTC
797147,mainnet,251,108432000,108643596,211597,198293,13304,0.0628742373474104,2021-11-25 13:37:10 UTC
797149,mainnet,251,108432000,108643831,211832,198510,13322,0.0628894595717361,2021-11-25 13:39:24 UTC
797150,mainnet,251,108432000,108644060,212061,198725,13336,0.06288756537034156,2021-11-25 13:41:39 UTC
797151,mainnet,251,108432000,108644359,212360,198990,13370,0.06295912601243173,2021-11-25 13:44:04 UTC
797152,mainnet,251,108432000,108644604,212605,199219,13386,0.06296183062486771,2021-11-25 13:46:20 UTC
797154,mainnet,251,108432000,108644824,212825,199435,13390,0.06291554093738988,2021-11-25 13:48:23 UTC
797155,mainnet,251,108432000,108645051,213052,199646,13406,0.06292360550475941,2021-11-25 13:50:27 UTC
797157,mainnet,251,108432000,108645289,213290,199874,13416,0.06290027661868818,2021-11-25 13:52:42 UTC
797158,mainnet,251,108432000,108645528,213529,200092,13437,0.0629282205227393,2021-11-25 13:54:48 UTC
797160,mainnet,251,108432000,108645752,213753,200295,13458,0.06296051985235294,2021-11-25 13:57:03 UTC
797161,mainnet,251,108432000,108645990,213991,200501,13490,0.06304003439396984,2021-11-25 13:59:10 UTC
797163,mainnet,251,108432000,108646217,214218,200696,13522,0.06312261341250502,2021-11-25 14:01:20 UTC
797164,mainnet,251,108432000,108646426,214427,200901,13526,0.06307974275627602,2021-11-25 14:03:25 UTC
797166,mainnet,251,108432000,108646658,214659,201115,13544,0.06309542110976013,2021-11-25 14:05:27 UTC
797167,mainnet,251,108432000,108646885,214886,201317,13569,0.06314510949992089,2021-11-25 14:07:33 UTC
797168,mainnet,251,108432000,108647122,215123,201538,13585,0.06314991888361542,2021-11-25 14:09:39 UTC
797170,mainnet,251,108432000,108647335,215336,201739,13597,0.06314318088940075,2021-11-25 14:11:41 UTC
797171,mainnet,251,108432000,108647559,215560,201955,13605,0.06311467804787531,2021-11-25 14:13:53 UTC
797172,mainnet,251,108432000,108647811,215812,202177,13635,0.06317998999128871,2021-11-25 14:15:59 UTC
797174,mainnet,251,108432000,108647938,215939,202298,13641,0.06317061762812647,2021-11-25 14:18:12 UTC
797175,mainnet,251,108432000,108648282,216283,202621,13662,0.06316723921898623,2021-11-25 14:20:23 UTC
797177,mainnet,251,108432000,108648546,216547,202863,13684,0.06319182440763436,2021-11-25 14:22:31 UTC
797178,mainnet,251,108432000,108648781,216782,203080,13702,0.06320635477115259,2021-11-25 14:24:36 UTC
797180,mainnet,251,108432000,108649003,217004,203273,13731,0.06327533133029806,2021-11-25 14:26:46 UTC
797181,mainnet,251,108432000,108649235,217236,203488,13748,0.06328601152663463,2021-11-25 14:28:53 UTC
797183,mainnet,251,108432000,108649462,217463,203704,13759,0.06327053337809191,2021-11-25 14:31:12 UTC
797184,mainnet,251,108432000,108649684,217685,203896,13789,0.06334382249580817,2021-11-25 14:33:18 UTC
797186,mainnet,251,108432000,108649947,217948,204101,13847,0.0635335034044818,2021-11-25 14:35:29 UTC
797187,mainnet,251,108432000,108650168,218169,204297,13872,0.06358373554446324,2021-11-25 14:37:41 UTC
797188,mainnet,251,108432000,108650418,218419,204546,13873,0.06351553665203119,2021-11-25 14:39:55 UTC
797190,mainnet,251,108432000,108650656,218657,204776,13881,0.06348298933946775,2021-11-25 14:42:04 UTC
797191,mainnet,251,108432000,108650893,218894,205000,13894,0.06347364477783768,2021-11-25 14:44:20 UTC
797193,mainnet,251,108432000,108651119,219120,205206,13914,0.06349945235487404,2021-11-25 14:46:29 UTC
797194,mainnet,251,108432000,108651360,219361,205436,13925,0.06347983461052785,2021-11-25 14:48:40 UTC
797195,mainnet,251,108432000,108651615,219616,205677,13939,0.06346987469036865,2021-11-25 14:51:04 UTC
797197,mainnet,251,108432000,108651908,219909,205951,13958,0.06347170875225662,2021-11-25 14:53:39 UTC
797198,mainnet,251,108432000,108652167,220168,206196,13972,0.06346063006431453,2021-11-25 14:55:52 UTC
797200,mainnet,251,108432000,108652396,220397,206422,13975,0.06340830410577276,2021-11-25 14:58:01 UTC
797201,mainnet,251,108432000,108652632,220633,206648,13985,0.06338580357426132,2021-11-25 15:00:23 UTC
797203,mainnet,251,108432000,108652890,220891,206879,14012,0.06343400138529863,2021-11-25 15:02:37 UTC
797204,mainnet,251,108432000,108653150,221151,207117,14034,0.06345890364502083,2021-11-25 15:05:02 UTC
797206,mainnet,251,108432000,108653377,221378,207312,14066,0.06353838231441246,2021-11-25 15:07:16 UTC
797207,mainnet,251,108432000,108653602,221603,207533,14070,0.06349192023573688,2021-11-25 15:09:38 UTC
797209,mainnet,251,108432000,108653844,221845,207744,14101,0.0635623971691947,2021-11-25 15:11:54 UTC
797210,mainnet,251,108432000,108654093,222094,207981,14113,0.06354516556052843,2021-11-25 15:13:58 UTC
797212,mainnet,251,108432000,108654315,222316,208190,14126,0.06354018604149049,2021-11-25 15:16:05 UTC
797213,mainnet,251,108432000,108654547,222548,208407,14141,0.06354134838327012,2021-11-25 15:18:14 UTC
797215,mainnet,251,108432000,108654775,222776,208621,14155,0.06353916041225266,2021-11-25 15:20:23 UTC
797216,mainnet,251,108432000,108655024,223025,208854,14171,0.06353996188768075,2021-11-25 15:22:37 UTC
797217,mainnet,251,108432000,108655243,223244,209054,14190,0.06356273852824712,2021-11-25 15:24:42 UTC
797219,mainnet,251,108432000,108655464,223465,209260,14205,0.06356700154386594,2021-11-25 15:26:45 UTC
797220,mainnet,251,108432000,108655697,223698,209478,14220,0.06356784593514471,2021-11-25 15:29:00 UTC
797222,mainnet,251,108432000,108655924,223925,209690,14235,0.06357039187227867,2021-11-25 15:31:09 UTC
797223,mainnet,251,108432000,108656144,224145,209900,14245,0.06355261103303665,2021-11-25 15:33:28 UTC
797225,mainnet,251,108432000,108656378,224379,210129,14250,0.06350861711657509,2021-11-25 15:35:38 UTC
797226,mainnet,251,108432000,108656623,224624,210359,14265,0.06350612579243536,2021-11-25 15:37:43 UTC
797228,mainnet,251,108432000,108656860,224861,210590,14271,0.06346587447356367,2021-11-25 15:39:53 UTC
797229,mainnet,251,108432000,108657112,225113,210826,14287,0.06346590379054075,2021-11-25 15:42:10 UTC
797231,mainnet,251,108432000,108657378,225379,211071,14308,0.06348417554430537,2021-11-25 15:44:22 UTC
797232,mainnet,251,108432000,108657630,225631,211311,14320,0.06346645629368305,2021-11-25 15:46:57 UTC
797234,mainnet,251,108432000,108657929,225930,211591,14339,0.06346656043907405,2021-11-25 15:49:37 UTC
797235,mainnet,251,108432000,108658165,226166,211817,14349,0.06344454957862809,2021-11-25 15:51:47 UTC
797237,mainnet,251,108432000,108658404,226405,212041,14364,0.06344382853735563,2021-11-25 15:53:50 UTC
797238,mainnet,251,108432000,108658636,226637,212263,14374,0.06342300683471808,2021-11-25 15:56:00 UTC
797240,mainnet,251,108432000,108658871,226872,212484,14388,0.0634190204167989,2021-11-25 15:58:13 UTC
797241,mainnet,251,108432000,108659103,227104,212699,14405,0.06342908975623503,2021-11-25 16:00:26 UTC
797242,mainnet,251,108432000,108659328,227329,212901,14428,0.06346748545060243,2021-11-25 16:02:34 UTC
797243,mainnet,251,108432000,108659532,227533,213086,14447,0.06349408657205768,2021-11-25 16:04:39 UTC
797245,mainnet,251,108432000,108659738,227739,213284,14455,0.06347178129349826,2021-11-25 16:06:47 UTC
797246,mainnet,251,108432000,108659956,227957,213476,14481,0.06352513851296517,2021-11-25 16:08:46 UTC
797247,mainnet,251,108432000,108660189,228190,213695,14495,0.06352162671457995,2021-11-25 16:10:56 UTC
797249,mainnet,251,108432000,108660411,228412,213898,14514,0.06354307129222633,2021-11-25 16:13:08 UTC
797250,mainnet,251,108432000,108660655,228656,214129,14527,0.06353211811629697,2021-11-25 16:15:27 UTC
797252,mainnet,251,108432000,108660883,228884,214338,14546,0.06355184285489593,2021-11-25 16:17:35 UTC
797253,mainnet,251,108432000,108661096,229097,214535,14562,0.06356259575638266,2021-11-25 16:19:44 UTC
797255,mainnet,251,108432000,108661333,229334,214755,14579,0.06357103613070893,2021-11-25 16:21:56 UTC
797256,mainnet,251,108432000,108661552,229553,214965,14588,0.0635495942113586,2021-11-25 16:24:03 UTC
797258,mainnet,251,108432000,108661784,229785,215162,14623,0.06363774832996062,2021-11-25 16:26:18 UTC
797259,mainnet,251,108432000,108662000,230001,215362,14639,0.06364754935848105,2021-11-25 16:28:30 UTC
797261,mainnet,251,108432000,108662230,230231,215579,14652,0.06364043069786432,2021-11-25 16:30:56 UTC
797262,mainnet,251,108432000,108662482,230483,215785,14698,0.06377042992324813,2021-11-25 16:33:03 UTC
797264,mainnet,251,108432000,108662734,230735,216016,14719,0.06379179578304114,2021-11-25 16:35:30 UTC
797266,mainnet,251,108432000,108662942,230943,216207,14736,0.0638079526116834,2021-11-25 16:37:39 UTC
797267,mainnet,251,108432000,108663198,231199,216434,14765,0.06386273297029832,2021-11-25 16:40:05 UTC
797269,mainnet,251,108432000,108663435,231436,216652,14784,0.06387943103060889,2021-11-25 16:42:14 UTC
797270,mainnet,251,108432000,108663663,231664,216874,14790,0.06384246149595967,2021-11-25 16:44:22 UTC
797272,mainnet,251,108432000,108663908,231909,217096,14813,0.06387419203221953,2021-11-25 16:46:35 UTC
797273,mainnet,251,108432000,108664121,232122,217302,14820,0.06384573629384548,2021-11-25 16:48:51 UTC
797275,mainnet,251,108432000,108664394,232395,217539,14856,0.06392564383915317,2021-11-25 16:51:03 UTC
797276,mainnet,251,108432000,108664646,232647,217757,14890,0.06400254462769776,2021-11-25 16:53:26 UTC
797278,mainnet,251,108432000,108664871,232872,217966,14906,0.06400941289635508,2021-11-25 16:55:35 UTC
797279,mainnet,251,108432000,108665112,233113,218189,14924,0.06402045359975635,2021-11-25 16:57:48 UTC
797281,mainnet,251,108432000,108665339,233340,218411,14929,0.0639796005828405,2021-11-25 16:59:59 UTC
797282,mainnet,251,108432000,108665581,233582,218635,14947,0.06399037597075118,2021-11-25 17:02:11 UTC
797284,mainnet,251,108432000,108665793,233794,218822,14972,0.06403928244522956,2021-11-25 17:04:15 UTC
797285,mainnet,251,108432000,108666022,234023,219033,14990,0.06405353319972823,2021-11-25 17:06:23 UTC
797286,mainnet,251,108432000,108666267,234268,219269,14999,0.06402496286304574,2021-11-25 17:08:35 UTC
797287,mainnet,251,108432000,108666497,234498,219480,15018,0.06404319013381778,2021-11-25 17:10:44 UTC
797289,mainnet,251,108432000,108666728,234729,219696,15033,0.06404406783993456,2021-11-25 17:12:51 UTC
797290,mainnet,251,108432000,108666960,234961,219920,15041,0.06401487906503632,2021-11-25 17:15:01 UTC
797291,mainnet,251,108432000,108667184,235185,220125,15060,0.06403469609031189,2021-11-25 17:17:09 UTC
797293,mainnet,251,108432000,108667386,235387,220312,15075,0.06404346884067515,2021-11-25 17:19:13 UTC
797294,mainnet,251,108432000,108667619,235620,220527,15093,0.06405653170359053,2021-11-25 17:21:26 UTC
797295,mainnet,251,108432000,108667847,235848,220726,15122,0.06411756724670127,2021-11-25 17:23:40 UTC
797296,mainnet,251,108432000,108668071,236072,220912,15160,0.06421769629604528,2021-11-25 17:25:41 UTC
797298,mainnet,251,108432000,108668317,236318,221140,15178,0.06422701613926997,2021-11-25 17:27:48 UTC
797299,mainnet,251,108432000,108668595,236596,221412,15184,0.06417690916160881,2021-11-25 17:30:28 UTC
797301,mainnet,251,108432000,108668825,236826,221629,15197,0.06416947463538632,2021-11-25 17:32:38 UTC
797302,mainnet,251,108432000,108669062,237063,221853,15210,0.06416015995747966,2021-11-25 17:34:46 UTC
797304,mainnet,251,108432000,108669313,237314,222075,15239,0.06421450061943249,2021-11-25 17:37:03 UTC
797305,mainnet,251,108432000,108669561,237562,222296,15266,0.06426111920256607,2021-11-25 17:39:26 UTC
797307,mainnet,251,108432000,108669810,237811,222527,15284,0.06426952495889593,2021-11-25 17:42:10 UTC
797308,mainnet,251,108432000,108670099,238100,222804,15296,0.06424191516169676,2021-11-25 17:44:19 UTC
797310,mainnet,251,108432000,108670348,238349,223039,15310,0.06423353989318184,2021-11-25 17:46:30 UTC
797312,mainnet,251,108432000,108670542,238543,223225,15318,0.06421483757645371,2021-11-25 17:48:40 UTC
797313,mainnet,251,108432000,108670812,238813,223470,15343,0.06424692123125625,2021-11-25 17:50:49 UTC
797314,mainnet,251,108432000,108671059,239060,223716,15344,0.06418472350037648,2021-11-25 17:52:59 UTC
797315,mainnet,251,108432000,108671285,239286,223938,15348,0.0641408189363356,2021-11-25 17:55:11 UTC
797317,mainnet,251,108432000,108671514,239515,224152,15363,0.06414212053524831,2021-11-25 17:57:19 UTC
797318,mainnet,251,108432000,108671772,239773,224392,15381,0.06414817348075054,2021-11-25 17:59:38 UTC
797320,mainnet,251,108432000,108672045,240046,224655,15391,0.0641168775984603,2021-11-25 18:02:08 UTC
797321,mainnet,251,108432000,108672329,240330,224925,15405,0.06409936337535888,2021-11-25 18:04:51 UTC
797323,mainnet,251,108432000,108672574,240575,225149,15426,0.06412137587031072,2021-11-25 18:07:00 UTC
797324,mainnet,251,108432000,108672822,240823,225387,15436,0.06409686782408656,2021-11-25 18:09:11 UTC
797326,mainnet,251,108432000,108673063,241064,225618,15446,0.06407427073308333,2021-11-25 18:11:23 UTC
797327,mainnet,251,108432000,108673321,241322,225854,15468,0.06409693272888506,2021-11-25 18:13:36 UTC
797329,mainnet,251,108432000,108673565,241566,226086,15480,0.06408186582548869,2021-11-25 18:15:58 UTC
797330,mainnet,251,108432000,108673836,241837,226345,15492,0.06405967655900462,2021-11-25 18:18:18 UTC
797332,mainnet,251,108432000,108674097,242098,226580,15518,0.06409800989681864,2021-11-25 18:20:33 UTC
797333,mainnet,251,108432000,108674338,242339,226804,15535,0.06410441571517585,2021-11-25 18:22:48 UTC
797335,mainnet,251,108432000,108674559,242560,227007,15553,0.06412021767810026,2021-11-25 18:24:58 UTC
797336,mainnet,251,108432000,108674772,242773,227209,15564,0.06410927080029492,2021-11-25 18:27:06 UTC
797338,mainnet,251,108432000,108675020,243021,227435,15586,0.0641343752186025,2021-11-25 18:29:12 UTC
797339,mainnet,251,108432000,108675250,243251,227650,15601,0.06413539923782431,2021-11-25 18:31:19 UTC
797340,mainnet,251,108432000,108675480,243481,227877,15604,0.06408713616257532,2021-11-25 18:33:28 UTC
797342,mainnet,251,108432000,108675716,243717,228101,15616,0.06407431570222841,2021-11-25 18:35:44 UTC
797343,mainnet,251,108432000,108675970,243971,228344,15627,0.06405269478749523,2021-11-25 18:37:56 UTC
797345,mainnet,251,108432000,108676264,244265,228619,15646,0.0640533846437271,2021-11-25 18:40:36 UTC
797346,mainnet,251,108432000,108676500,244501,228841,15660,0.06404881779624623,2021-11-25 18:42:40 UTC
797348,mainnet,251,108432000,108676737,244738,229073,15665,0.0640072240518432,2021-11-25 18:44:43 UTC
797349,mainnet,251,108432000,108676965,244966,229290,15676,0.0639925540687279,2021-11-25 18:46:48 UTC
797350,mainnet,251,108432000,108677198,245199,229514,15685,0.06396845011602821,2021-11-25 18:49:04 UTC
797352,mainnet,251,108432000,108677411,245412,229722,15690,0.06393330399491468,2021-11-25 18:51:13 UTC
797353,mainnet,251,108432000,108677667,245668,229964,15704,0.06392366934236449,2021-11-25 18:53:20 UTC
797355,mainnet,251,108432000,108677946,245947,230224,15723,0.06392840733979271,2021-11-25 18:55:51 UTC
797356,mainnet,251,108432000,108678197,246198,230464,15734,0.06390791151837139,2021-11-25 18:57:57 UTC
797358,mainnet,251,108432000,108678462,246463,230725,15738,0.06385542657518573,2021-11-25 19:00:22 UTC
797359,mainnet,251,108432000,108678754,246755,231006,15749,0.06382444124739113,2021-11-25 19:02:42 UTC
797361,mainnet,251,108432000,108679016,247017,231253,15764,0.06381747005266844,2021-11-25 19:05:03 UTC
797362,mainnet,251,108432000,108679272,247273,231484,15789,0.06385250310385687,2021-11-25 19:07:12 UTC
797363,mainnet,251,108432000,108679506,247507,231704,15803,0.06384869922870869,2021-11-25 19:09:23 UTC
797365,mainnet,251,108432000,108679720,247721,231898,15823,0.06387427791749589,2021-11-25 19:11:33 UTC
797366,mainnet,251,108432000,108679985,247986,232146,15840,0.06387457356463672,2021-11-25 19:13:45 UTC
797368,mainnet,251,108432000,108680226,248227,232380,15847,0.0638407586604197,2021-11-25 19:15:49 UTC
797369,mainnet,251,108432000,108680464,248465,232604,15861,0.0638359527498843,2021-11-25 19:17:53 UTC
797371,mainnet,251,108432000,108680720,248721,232846,15875,0.06382653656104631,2021-11-25 19:20:03 UTC
797372,mainnet,251,108432000,108680967,248968,233078,15890,0.0638234632563221,2021-11-25 19:22:11 UTC
797374,mainnet,251,108432000,108681198,249199,233299,15900,0.06380442939177124,2021-11-25 19:24:25 UTC
797375,mainnet,251,108432000,108681436,249437,233528,15909,0.06377963173065744,2021-11-25 19:26:31 UTC
797377,mainnet,251,108432000,108681669,249670,233746,15924,0.0637801898506028,2021-11-25 19:29:02 UTC
797378,mainnet,251,108432000,108681938,249939,234003,15936,0.063759557331989,2021-11-25 19:31:12 UTC
797380,mainnet,251,108432000,108682160,250161,234223,15938,0.06371097013523291,2021-11-25 19:33:23 UTC
797381,mainnet,251,108432000,108682439,250440,234478,15962,0.06373582494809137,2021-11-25 19:35:42 UTC
797383,mainnet,251,108432000,108682683,250684,234712,15972,0.06371367937323483,2021-11-25 19:37:56 UTC
797384,mainnet,251,108432000,108682917,250918,234920,15998,0.06375788106074494,2021-11-25 19:40:06 UTC
797386,mainnet,251,108432000,108683187,251188,235160,16028,0.06380878067423602,2021-11-25 19:42:19 UTC
797387,mainnet,251,108432000,108683420,251421,235386,16035,0.06377748875392271,2021-11-25 19:44:30 UTC
797389,mainnet,251,108432000,108683683,251684,235634,16050,0.06377044230066274,2021-11-25 19:46:55 UTC
797390,mainnet,251,108432000,108683931,251932,235871,16061,0.06375132972389375,2021-11-25 19:49:11 UTC
797392,mainnet,251,108432000,108684175,252176,236099,16077,0.06375309307785039,2021-11-25 19:51:25 UTC
797393,mainnet,251,108432000,108684411,252412,236318,16094,0.06376083545948687,2021-11-25 19:53:39 UTC
797395,mainnet,251,108432000,108684680,252681,236568,16113,0.0637681503555867,2021-11-25 19:55:54 UTC
797396,mainnet,251,108432000,108684918,252919,236797,16122,0.06374372822919591,2021-11-25 19:58:11 UTC
797397,mainnet,251,108432000,108685199,253200,237070,16130,0.06370458135860979,2021-11-25 20:00:33 UTC
797398,mainnet,251,108432000,108685456,253457,237291,16166,0.06378202219705907,2021-11-25 20:02:45 UTC
797400,mainnet,251,108432000,108685674,253675,237500,16175,0.0637626884793535,2021-11-25 20:04:54 UTC
797401,mainnet,251,108432000,108685916,253917,237717,16200,0.06380037571332364,2021-11-25 20:07:10 UTC
797402,mainnet,251,108432000,108686172,254173,237957,16216,0.06379906599048679,2021-11-25 20:09:20 UTC
797404,mainnet,251,108432000,108686428,254429,238195,16234,0.06380561964241498,2021-11-25 20:11:34 UTC
797405,mainnet,251,108432000,108686682,254683,238439,16244,0.06378124963189534,2021-11-25 20:13:52 UTC
797407,mainnet,251,108432000,108686940,254941,238693,16248,0.0637323929850436,2021-11-25 20:16:05 UTC
797408,mainnet,251,108432000,108687201,255202,238948,16254,0.0636907234269324,2021-11-25 20:18:20 UTC
797410,mainnet,251,108432000,108687449,255450,239189,16261,0.06365629281659815,2021-11-25 20:20:33 UTC
797411,mainnet,251,108432000,108687718,255719,239447,16272,0.06363234644277507,2021-11-25 20:22:50 UTC
797413,mainnet,251,108432000,108687969,255970,239688,16282,0.06360901668164239,2021-11-25 20:25:04 UTC
797414,mainnet,251,108432000,108688221,256222,239930,16292,0.06358548446269251,2021-11-25 20:27:19 UTC
797416,mainnet,251,108432000,108688477,256478,240181,16297,0.06354151233244176,2021-11-25 20:29:32 UTC
797417,mainnet,251,108432000,108688716,256717,240410,16307,0.063521309457496,2021-11-25 20:31:42 UTC
797418,mainnet,251,108432000,108688984,256985,240660,16325,0.06352510846936592,2021-11-25 20:33:54 UTC
797420,mainnet,251,108432000,108689228,257229,240894,16335,0.06350372625170568,2021-11-25 20:36:01 UTC
797421,mainnet,251,108432000,108689487,257488,241147,16341,0.06346315168085503,2021-11-25 20:38:12 UTC
797422,mainnet,251,108432000,108689746,257747,241393,16354,0.06344981706867588,2021-11-25 20:40:24 UTC
797424,mainnet,251,108432000,108690000,258001,241631,16370,0.06344936647532375,2021-11-25 20:42:28 UTC
797425,mainnet,251,108432000,108690236,258237,241847,16390,0.06346882902140281,2021-11-25 20:44:33 UTC
797426,mainnet,251,108432000,108690477,258478,242077,16401,0.06345220869861265,2021-11-25 20:46:42 UTC
797427,mainnet,251,108432000,108690708,258709,242290,16419,0.06346512877402796,2021-11-25 20:48:53 UTC
797429,mainnet,251,108432000,108690951,258952,242527,16425,0.06342874355092835,2021-11-25 20:51:04 UTC
797430,mainnet,251,108432000,108691202,259203,242748,16455,0.0634830615386396,2021-11-25 20:53:16 UTC
797432,mainnet,251,108432000,108691434,259435,242967,16468,0.06347640063985198,2021-11-25 20:55:29 UTC
797433,mainnet,251,108432000,108691724,259725,243247,16478,0.06344402733660602,2021-11-25 20:57:55 UTC
797435,mainnet,251,108432000,108691985,259986,243500,16486,0.06341110675190202,2021-11-25 21:00:09 UTC
797436,mainnet,251,108432000,108692268,260269,243750,16519,0.06346894943308654,2021-11-25 21:02:49 UTC
797438,mainnet,251,108432000,108692516,260517,243997,16520,0.063412368482671,2021-11-25 21:04:57 UTC
797439,mainnet,251,108432000,108692728,260729,244191,16538,0.06342984478136303,2021-11-25 21:07:21 UTC
797441,mainnet,251,108432000,108692984,260985,244428,16557,0.06344042761078222,2021-11-25 21:09:28 UTC
797443,mainnet,251,108432000,108693280,261281,244687,16594,0.06351016721460803,2021-11-25 21:11:48 UTC
797444,mainnet,251,108432000,108693533,261534,244928,16606,0.06349461255515536,2021-11-25 21:14:06 UTC
797446,mainnet,251,108432000,108693788,261789,245159,16630,0.06352444143947988,2021-11-25 21:16:21 UTC
797447,mainnet,251,108432000,108694026,262027,245386,16641,0.06350872238357116,2021-11-25 21:18:30 UTC
797448,mainnet,251,108432000,108694268,262269,245622,16647,0.06347299909634764,2021-11-25 21:20:39 UTC
797450,mainnet,251,108432000,108694509,262510,245851,16659,0.06346043960230087,2021-11-25 21:22:52 UTC
797451,mainnet,251,108432000,108694757,262758,246071,16687,0.06350710539736183,2021-11-25 21:25:04 UTC
797453,mainnet,251,108432000,108694989,262990,246302,16688,0.0634548842161299,2021-11-25 21:27:12 UTC
797454,mainnet,251,108432000,108695272,263273,246571,16702,0.0634398514089937,2021-11-25 21:29:45 UTC
797456,mainnet,251,108432000,108695491,263492,246772,16720,0.06345543697721373,2021-11-25 21:31:52 UTC
797458,mainnet,251,108432000,108695729,263730,247002,16728,0.06342850642702764,2021-11-25 21:34:16 UTC
797459,mainnet,251,108432000,108695995,263996,247246,16750,0.06344793102925803,2021-11-25 21:36:42 UTC
797460,mainnet,251,108432000,108696225,264226,247448,16778,0.06349867159174344,2021-11-25 21:38:47 UTC
797462,mainnet,251,108432000,108696470,264471,247681,16790,0.06348522144204846,2021-11-25 21:41:00 UTC
797464,mainnet,251,108432000,108696722,264723,247916,16807,0.06348900548875618,2021-11-25 21:43:18 UTC
797465,mainnet,251,108432000,108696982,264983,248166,16817,0.06346444866274441,2021-11-25 21:45:34 UTC
797466,mainnet,251,108432000,108697236,265237,248416,16821,0.06341875379377689,2021-11-25 21:47:47 UTC
797468,mainnet,251,108432000,108697491,265492,248655,16837,0.06341810676027904,2021-11-25 21:50:06 UTC
797470,mainnet,251,108432000,108697761,265762,248908,16854,0.06341764435848617,2021-11-25 21:52:30 UTC
797471,mainnet,251,108432000,108697963,265964,249096,16868,0.06342211727903024,2021-11-25 21:54:38 UTC
797473,mainnet,251,108432000,108698225,266226,249333,16893,0.06345360708570913,2021-11-25 21:56:52 UTC
797474,mainnet,251,108432000,108698460,266461,249549,16912,0.0634689504280176,2021-11-25 21:59:03 UTC
797476,mainnet,251,108432000,108698713,266714,249797,16917,0.0634274916202374,2021-11-25 22:01:15 UTC
797477,mainnet,251,108432000,108698952,266953,250031,16922,0.06338943559353144,2021-11-25 22:03:24 UTC
797479,mainnet,251,108432000,108699201,267202,250271,16931,0.06336404667629733,2021-11-25 22:05:32 UTC
797480,mainnet,251,108432000,108699442,267443,250497,16946,0.0633630343662014,2021-11-25 22:07:42 UTC
797482,mainnet,251,108432000,108699668,267669,250715,16954,0.06333942294400921,2021-11-25 22:09:50 UTC
797483,mainnet,251,108432000,108699945,267946,250953,16993,0.06341949497286767,2021-11-25 22:12:23 UTC
797485,mainnet,251,108432000,108700181,268182,251176,17006,0.06341216039853532,2021-11-25 22:14:31 UTC
797486,mainnet,251,108432000,108700436,268437,251421,17016,0.06338917511371384,2021-11-25 22:16:47 UTC
797488,mainnet,251,108432000,108700711,268712,251689,17023,0.06335035279406949,2021-11-25 22:19:15 UTC
797489,mainnet,251,108432000,108700980,268981,251954,17027,0.06330186890523866,2021-11-25 22:21:28 UTC
797491,mainnet,251,108432000,108701230,269231,252187,17044,0.06330623145180161,2021-11-25 22:23:39 UTC
797492,mainnet,251,108432000,108701467,269468,252418,17050,0.06327281903602654,2021-11-25 22:25:43 UTC
797494,mainnet,251,108432000,108701759,269760,252695,17065,0.06325993475682087,2021-11-25 22:28:15 UTC
797495,mainnet,251,108432000,108702007,270008,252929,17079,0.06325368137240378,2021-11-25 22:30:40 UTC
797497,mainnet,251,108432000,108702210,270211,253122,17089,0.06324316922701148,2021-11-25 22:33:01 UTC
797498,mainnet,251,108432000,108702574,270575,253439,17136,0.0633317934029382,2021-11-25 22:35:37 UTC
797500,mainnet,251,108432000,108702812,270813,253677,17136,0.0632761351929191,2021-11-25 22:37:40 UTC
797501,mainnet,251,108432000,108703045,271046,253906,17140,0.06323649860171336,2021-11-25 22:39:43 UTC
797503,mainnet,251,108432000,108703308,271309,254164,17145,0.06319362792977748,2021-11-25 22:41:54 UTC
797504,mainnet,251,108432000,108703552,271553,254396,17157,0.06318103648274923,2021-11-25 22:44:00 UTC
797505,mainnet,251,108432000,108703804,271805,254635,17170,0.0631702875223046,2021-11-25 22:46:16 UTC
797507,mainnet,251,108432000,108704041,272042,254859,17183,0.06316304100102191,2021-11-25 22:48:17 UTC
797508,mainnet,251,108432000,108704282,272283,255091,17192,0.06314018870072682,2021-11-25 22:50:28 UTC
797510,mainnet,251,108432000,108704549,272550,255345,17205,0.06312603192074849,2021-11-25 22:52:49 UTC
797511,mainnet,251,108432000,108704856,272857,255640,17217,0.06309898591569943,2021-11-25 22:55:30 UTC
797513,mainnet,251,108432000,108705128,273129,255899,17230,0.06308374431129612,2021-11-25 22:57:42 UTC
797514,mainnet,251,108432000,108705389,273390,256147,17243,0.06307107063169831,2021-11-25 22:59:55 UTC
797516,mainnet,251,108432000,108705723,273724,256461,17263,0.06306717715655186,2021-11-25 23:02:37 UTC
797517,mainnet,251,108432000,108705990,273991,256717,17274,0.06304586647006653,2021-11-25 23:05:02 UTC
797518,mainnet,251,108432000,108706226,274227,256953,17274,0.06299160914133181,2021-11-25 23:07:11 UTC
797520,mainnet,251,108432000,108706472,274473,257182,17291,0.06299708896685649,2021-11-25 23:09:32 UTC
797521,mainnet,251,108432000,108706698,274699,257388,17311,0.06301806704793246,2021-11-25 23:11:42 UTC
797523,mainnet,251,108432000,108706971,274972,257624,17348,0.06309006007884439,2021-11-25 23:14:06 UTC
797525,mainnet,251,108432000,108707241,275242,257866,17376,0.06312990023324928,2021-11-25 23:16:51 UTC
797526,mainnet,251,108432000,108707504,275505,258112,17393,0.0631313406290267,2021-11-25 23:18:57 UTC
797528,mainnet,251,108432000,108707758,275759,258351,17408,0.06312758604433581,2021-11-25 23:21:10 UTC
797529,mainnet,251,108432000,108708024,276025,258611,17414,0.06308848836156146,2021-11-25 23:23:26 UTC
797530,mainnet,251,108432000,108708240,276241,258812,17429,0.06309345824841352,2021-11-25 23:25:33 UTC
797532,mainnet,251,108432000,108708467,276468,259028,17440,0.06308144161349595,2021-11-25 23:27:42 UTC
797533,mainnet,251,108432000,108708720,276721,259264,17457,0.06308520133997782,2021-11-25 23:29:49 UTC
797535,mainnet,251,108432000,108708966,276967,259506,17461,0.0630436116938119,2021-11-25 23:32:02 UTC
797536,mainnet,251,108432000,108709207,277208,259730,17478,0.06305012842342213,2021-11-25 23:34:07 UTC
797538,mainnet,251,108432000,108709474,277475,259989,17486,0.06301828993603027,2021-11-25 23:36:24 UTC
797539,mainnet,251,108432000,108709731,277732,260233,17499,0.06300678351792376,2021-11-25 23:38:35 UTC
797540,mainnet,251,108432000,108709984,277985,260474,17511,0.06299260751479396,2021-11-25 23:40:45 UTC
797542,mainnet,251,108432000,108710196,278197,260663,17534,0.0630272792301858,2021-11-25 23:42:57 UTC
797543,mainnet,251,108432000,108710470,278471,260909,17562,0.06306581295718405,2021-11-25 23:45:06 UTC
797544,mainnet,251,108432000,108710703,278704,261128,17576,0.06306332166025604,2021-11-25 23:47:17 UTC
797546,mainnet,251,108432000,108710947,278948,261357,17591,0.06306193268996373,2021-11-25 23:49:25 UTC
797547,mainnet,251,108432000,108711196,279197,261592,17605,0.06305583512716827,2021-11-25 23:51:35 UTC
797549,mainnet,251,108432000,108711450,279451,261833,17618,0.06304504188569732,2021-11-25 23:53:47 UTC
797550,mainnet,251,108432000,108711692,279693,262067,17626,0.0630190959373313,2021-11-25 23:55:51 UTC
797551,mainnet,251,108432000,108711957,279958,262310,17648,0.06303802713264132,2021-11-25 23:58:06 UTC
797553,mainnet,251,108432000,108712222,280223,262565,17658,0.06301409948505297,2021-11-26 00:00:23 UTC
797554,mainnet,251,108432000,108712473,280474,262805,17669,0.06299692663134551,2021-11-26 00:02:34 UTC
797556,mainnet,251,108432000,108712751,280752,263079,17673,0.06294879466575483,2021-11-26 00:04:56 UTC
797557,mainnet,251,108432000,108712996,280997,263306,17691,0.06295796752278494,2021-11-26 00:07:08 UTC
797559,mainnet,251,108432000,108713260,281261,263558,17703,0.06294153828650258,2021-11-26 00:09:31 UTC
797560,mainnet,251,108432000,108713514,281515,263806,17709,0.06290606184395148,2021-11-26 00:12:09 UTC
797562,mainnet,251,108432000,108713786,281787,264052,17735,0.06293760890317864,2021-11-26 00:14:16 UTC
797563,mainnet,251,108432000,108714038,282039,264294,17745,0.06291683065108017,2021-11-26 00:16:25 UTC
797565,mainnet,251,108432000,108714271,282272,264526,17746,0.06286843895249972,2021-11-26 00:18:37 UTC
797566,mainnet,251,108432000,108714528,282529,264753,17776,0.06291743502436918,2021-11-26 00:20:48 UTC
797568,mainnet,251,108432000,108714781,282782,265004,17778,0.06286821650600109,2021-11-26 00:23:00 UTC
797569,mainnet,251,108432000,108715040,283041,265250,17791,0.06285661794580998,2021-11-26 00:25:09 UTC
797571,mainnet,251,108432000,108715285,283286,265471,17815,0.06288697641253009,2021-11-26 00:27:22 UTC
797572,mainnet,251,108432000,108715557,283558,265725,17833,0.06289013182488239,2021-11-26 00:29:44 UTC
797574,mainnet,251,108432000,108715821,283822,265983,17839,0.06285277392168331,2021-11-26 00:31:57 UTC
797575,mainnet,251,108432000,108716134,284135,266283,17852,0.0628292888943636,2021-11-26 00:34:56 UTC
797577,mainnet,251,108432000,108716455,284456,266582,17874,0.06283572854852772,2021-11-26 00:37:26 UTC
797578,mainnet,251,108432000,108716698,284699,266819,17880,0.06280317106839153,2021-11-26 00:39:49 UTC
797579,mainnet,251,108432000,108716964,284965,267066,17899,0.06281122243082483,2021-11-26 00:41:58 UTC
797581,mainnet,251,108432000,108717195,285196,267292,17904,0.06277787907263777,2021-11-26 00:44:00 UTC
797582,mainnet,251,108432000,108717456,285457,267550,17907,0.06273098925582488,2021-11-26 00:46:12 UTC
797584,mainnet,251,108432000,108717701,285702,267794,17908,0.0626806952698966,2021-11-26 00:48:22 UTC
797585,mainnet,251,108432000,108717984,285985,268061,17924,0.06267461580152806,2021-11-26 00:50:45 UTC
797587,mainnet,251,108432000,108718239,286240,268308,17932,0.06264673001676914,2021-11-26 00:53:10 UTC
797588,mainnet,251,108432000,108718509,286510,268561,17949,0.06264702802694495,2021-11-26 00:55:38 UTC
797590,mainnet,251,108432000,108718792,286793,268816,17977,0.06268284093405348,2021-11-26 00:57:53 UTC
797591,mainnet,251,108432000,108719034,287035,269045,17990,0.06267528350201194,2021-11-26 01:00:09 UTC
797593,mainnet,251,108432000,108719369,287370,269358,18012,0.06267877649023906,2021-11-26 01:03:03 UTC
797594,mainnet,251,108432000,108719636,287637,269608,18029,0.06267969697917862,2021-11-26 01:05:19 UTC
797596,mainnet,251,108432000,108719880,287881,269840,18041,0.06266825528603832,2021-11-26 01:07:55 UTC
797597,mainnet,251,108432000,108720196,288197,270151,18046,0.06261689052974181,2021-11-26 01:10:23 UTC
797599,mainnet,251,108432000,108720457,288458,270407,18051,0.06257756761816279,2021-11-26 01:12:44 UTC
797601,mainnet,251,108432000,108720792,288793,270735,18058,0.06252921642837603,2021-11-26 01:15:35 UTC
797602,mainnet,251,108432000,108721073,289074,270984,18090,0.06257913198696527,2021-11-26 01:17:59 UTC
797604,mainnet,251,108432000,108721344,289345,271243,18102,0.06256199346800533,2021-11-26 01:20:24 UTC
797605,mainnet,251,108432000,108721624,289625,271515,18110,0.06252913249892102,2021-11-26 01:22:49 UTC
797607,mainnet,251,108432000,108721876,289877,271764,18113,0.062485123000445016,2021-11-26 01:25:03 UTC
797608,mainnet,251,108432000,108722126,290127,272005,18122,0.062462300992324055,2021-11-26 01:27:19 UTC
797610,mainnet,251,108432000,108722348,290349,272200,18149,0.06250753403662489,2021-11-26 01:29:28 UTC
797611,mainnet,251,108432000,108722615,290616,272450,18166,0.06250860241693507,2021-11-26 01:31:36 UTC
797612,mainnet,251,108432000,108722863,290864,272691,18173,0.062479371802629406,2021-11-26 01:33:47 UTC
797614,mainnet,251,108432000,108723107,291108,272923,18185,0.062468224851257956,2021-11-26 01:35:53 UTC
797615,mainnet,251,108432000,108723372,291373,273174,18199,0.062459459181187,2021-11-26 01:38:05 UTC
797617,mainnet,251,108432000,108723611,291612,273402,18210,0.0624459898769598,2021-11-26 01:40:12 UTC
797618,mainnet,251,108432000,108723859,291860,273625,18235,0.06247858562324402,2021-11-26 01:42:23 UTC
797620,mainnet,251,108432000,108724128,292129,273889,18240,0.062438169438843796,2021-11-26 01:44:32 UTC
797621,mainnet,251,108432000,108724364,292365,274116,18249,0.06241855215227541,2021-11-26 01:46:41 UTC
797623,mainnet,251,108432000,108724638,292639,274378,18261,0.062401115367398056,2021-11-26 01:49:02 UTC
797624,mainnet,251,108432000,108724904,292905,274636,18269,0.062371758761373144,2021-11-26 01:51:13 UTC
797625,mainnet,251,108432000,108725149,293150,274876,18274,0.06233668770254136,2021-11-26 01:53:24 UTC
797627,mainnet,251,108432000,108725395,293396,275115,18281,0.06230827959481384,2021-11-26 01:55:48 UTC
797628,mainnet,251,108432000,108725710,293711,275410,18301,0.0623095491827,2021-11-26 01:58:05 UTC
797630,mainnet,251,108432000,108725977,293978,275663,18315,0.062300580315533816,2021-11-26 02:00:12 UTC
797631,mainnet,251,108432000,108726277,294278,275956,18322,0.06226085538164593,2021-11-26 02:02:57 UTC
797633,mainnet,251,108432000,108726527,294528,276200,18328,0.0622283789656671,2021-11-26 02:05:06 UTC
797634,mainnet,251,108432000,108726761,294762,276416,18346,0.062240044510486425,2021-11-26 02:07:26 UTC
797636,mainnet,251,108432000,108727004,295005,276648,18357,0.06222606396501754,2021-11-26 02:09:28 UTC
797637,mainnet,251,108432000,108727252,295253,276889,18364,0.06219750519046377,2021-11-26 02:11:44 UTC
797639,mainnet,251,108432000,108727492,295493,277117,18376,0.062187598352583646,2021-11-26 02:13:51 UTC
797640,mainnet,251,108432000,108727771,295772,277391,18381,0.06214584206753851,2021-11-26 02:16:07 UTC
797642,mainnet,251,108432000,108728013,296014,277623,18391,0.062128818231570127,2021-11-26 02:18:16 UTC
797643,mainnet,251,108432000,108728268,296269,277869,18400,0.06210572148959223,2021-11-26 02:20:30 UTC
797645,mainnet,251,108432000,108728523,296524,278088,18436,0.06217371949656689,2021-11-26 02:22:43 UTC
797646,mainnet,251,108432000,108728798,296799,278359,18440,0.06212958938540898,2021-11-26 02:25:04 UTC
797648,mainnet,251,108432000,108729047,297048,278598,18450,0.06211117395168458,2021-11-26 02:27:17 UTC
797649,mainnet,251,108432000,108729278,297279,278814,18465,0.06211336825002775,2021-11-26 02:29:28 UTC
797651,mainnet,251,108432000,108729550,297551,279062,18489,0.062137247060167836,2021-11-26 02:31:42 UTC
797652,mainnet,251,108432000,108729793,297794,279297,18497,0.06211340725467941,2021-11-26 02:33:52 UTC
797653,mainnet,251,108432000,108730029,298030,279526,18504,0.06208770929101097,2021-11-26 02:36:00 UTC
797654,mainnet,251,108432000,108730285,298286,279775,18511,0.06205789074914679,2021-11-26 02:38:09 UTC
797656,mainnet,251,108432000,108730523,298524,280007,18517,0.062028513620345435,2021-11-26 02:40:14 UTC
797657,mainnet,251,108432000,108730787,298788,280262,18526,0.06200382880169217,2021-11-26 02:43:03 UTC
797659,mainnet,251,108432000,108731120,299121,280575,18546,0.06200166487809281,2021-11-26 02:45:22 UTC
797660,mainnet,251,108432000,108731360,299361,280810,18551,0.06196865991227982,2021-11-26 02:47:38 UTC
797662,mainnet,251,108432000,108731608,299609,281046,18563,0.061957417834577734,2021-11-26 02:49:45 UTC
797663,mainnet,251,108432000,108731862,299863,281287,18576,0.061948289718971664,2021-11-26 02:51:54 UTC
797665,mainnet,251,108432000,108732108,300109,281528,18581,0.061914171184469645,2021-11-26 02:54:06 UTC
797666,mainnet,251,108432000,108732365,300366,281783,18583,0.06186785455078138,2021-11-26 02:56:14 UTC
797668,mainnet,251,108432000,108732599,300600,282006,18594,0.0618562874251497,2021-11-26 02:58:26 UTC
797669,mainnet,251,108432000,108732830,300831,282231,18600,0.06182873440569622,2021-11-26 03:00:37 UTC
797671,mainnet,251,108432000,108733101,301102,282466,18636,0.06189264767421007,2021-11-26 03:02:53 UTC
797672,mainnet,251,108432000,108733336,301337,282697,18640,0.06185765438694883,2021-11-26 03:04:58 UTC
797674,mainnet,251,108432000,108733620,301621,282960,18661,0.06186903431790227,2021-11-26 03:07:36 UTC
797675,mainnet,251,108432000,108733877,301878,283197,18681,0.06188261483115696,2021-11-26 03:09:55 UTC
797677,mainnet,251,108432000,108734128,302129,283436,18693,0.06187092268534301,2021-11-26 03:12:26 UTC
797678,mainnet,251,108432000,108734405,302406,283704,18702,0.06184401103152715,2021-11-26 03:14:33 UTC
797680,mainnet,251,108432000,108734659,302660,283949,18711,0.061821846296173925,2021-11-26 03:16:43 UTC
797681,mainnet,251,108432000,108734928,302929,284203,18726,0.06181646524433118,2021-11-26 03:18:59 UTC
797683,mainnet,251,108432000,108735180,303181,284445,18736,0.06179806782087268,2021-11-26 03:21:10 UTC
797684,mainnet,251,108432000,108735437,303438,284691,18747,0.061781978526091,2021-11-26 03:23:19 UTC
797686,mainnet,251,108432000,108735658,303659,284910,18749,0.0617436005519349,2021-11-26 03:25:24 UTC
797687,mainnet,251,108432000,108735903,303904,285138,18766,0.06174976308307887,2021-11-26 03:27:35 UTC
797689,mainnet,251,108432000,108736148,304149,285360,18789,0.061775642859256484,2021-11-26 03:29:45 UTC
797690,mainnet,251,108432000,108736394,304395,285593,18802,0.061768425893986435,2021-11-26 03:31:58 UTC
797692,mainnet,251,108432000,108736632,304633,285821,18812,0.06175299458692919,2021-11-26 03:34:00 UTC
797693,mainnet,251,108432000,108736863,304864,286033,18831,0.06176852629369161,2021-11-26 03:36:03 UTC
797694,mainnet,251,108432000,108737105,305106,286271,18835,0.06173264373693077,2021-11-26 03:38:15 UTC
797695,mainnet,251,108432000,108737350,305351,286497,18854,0.06174533569564206,2021-11-26 03:40:22 UTC
797696,mainnet,251,108432000,108737578,305579,286713,18866,0.06173853569780646,2021-11-26 03:42:34 UTC
797698,mainnet,251,108432000,108737877,305878,286980,18898,0.06178280229372495,2021-11-26 03:44:43 UTC
797699,mainnet,251,108432000,108738089,306090,287176,18914,0.06179228331536476,2021-11-26 03:46:48 UTC
797701,mainnet,251,108432000,108738331,306332,287407,18925,0.061779376624054944,2021-11-26 03:48:58 UTC
797702,mainnet,251,108432000,108738577,306578,287637,18941,0.06178199348942194,2021-11-26 03:51:25 UTC
797704,mainnet,251,108432000,108738863,306864,287910,18954,0.06176677616142656,2021-11-26 03:53:33 UTC
797705,mainnet,251,108432000,108739119,307120,288156,18964,0.06174785100286533,2021-11-26 03:55:43 UTC
797707,mainnet,251,108432000,108739385,307386,288418,18968,0.06170742974631246,2021-11-26 03:57:59 UTC
797708,mainnet,251,108432000,108739630,307631,288656,18975,0.061681039947209484,2021-11-26 04:00:12 UTC
797710,mainnet,251,108432000,108739925,307926,288940,18986,0.061657670998876354,2021-11-26 04:02:51 UTC
797711,mainnet,251,108432000,108740161,308162,289160,19002,0.06166237238854888,2021-11-26 04:05:00 UTC
797713,mainnet,251,108432000,108740412,308413,289402,19011,0.0616413704999465,2021-11-26 04:07:06 UTC
797714,mainnet,251,108432000,108740645,308646,289634,19012,0.061598076761079035,2021-11-26 04:09:15 UTC
797716,mainnet,251,108432000,108740920,308921,289891,19030,0.06160150977110653,2021-11-26 04:11:34 UTC
797717,mainnet,251,108432000,108741193,309194,290145,19049,0.061608569377154795,2021-11-26 04:13:56 UTC
797719,mainnet,251,108432000,108741439,309440,290386,19054,0.06157574974146846,2021-11-26 04:16:02 UTC
797720,mainnet,251,108432000,108741702,309703,290644,19059,0.06153960407228861,2021-11-26 04:18:10 UTC
797722,mainnet,251,108432000,108741954,309955,290887,19068,0.06151860753980416,2021-11-26 04:20:23 UTC
797723,mainnet,251,108432000,108742187,310188,291105,19083,0.061520755154938295,2021-11-26 04:22:28 UTC
797725,mainnet,251,108432000,108742464,310465,291373,19092,0.06149485449245486,2021-11-26 04:24:45 UTC
797726,mainnet,251,108432000,108742700,310701,291603,19098,0.06146745584983634,2021-11-26 04:26:51 UTC
797728,mainnet,251,108432000,108742932,310933,291822,19111,0.06146340208340704,2021-11-26 04:28:54 UTC
797729,mainnet,251,108432000,108743156,311157,292040,19117,0.061438437830420016,2021-11-26 04:31:02 UTC
797730,mainnet,251,108432000,108743412,311413,292276,19137,0.061452155176566166,2021-11-26 04:33:12 UTC
797732,mainnet,251,108432000,108743670,311671,292525,19146,0.06143016193357739,2021-11-26 04:35:32 UTC
797733,mainnet,251,108432000,108743929,311930,292768,19162,0.06143044913922995,2021-11-26 04:37:44 UTC
797735,mainnet,251,108432000,108744171,312172,293007,19165,0.06139243750240252,2021-11-26 04:39:59 UTC
797736,mainnet,251,108432000,108744476,312477,293271,19206,0.06146372373006653,2021-11-26 04:42:34 UTC
797738,mainnet,251,108432000,108744703,312704,293492,19212,0.06143829308227589,2021-11-26 04:44:36 UTC
797739,mainnet,251,108432000,108744939,312940,293721,19219,0.06141432862529558,2021-11-26 04:46:45 UTC
797741,mainnet,251,108432000,108745224,313225,293993,19232,0.061399952111102246,2021-11-26 04:49:07 UTC
797742,mainnet,251,108432000,108745500,313501,294255,19246,0.06139055377813787,2021-11-26 04:51:29 UTC
797744,mainnet,251,108432000,108745764,313765,294504,19261,0.061386706611636095,2021-11-26 04:53:39 UTC
797745,mainnet,251,108432000,108746030,314031,294764,19267,0.06135381538765281,2021-11-26 04:55:50 UTC
797746,mainnet,251,108432000,108746280,314281,295001,19280,0.06134637474107566,2021-11-26 04:58:06 UTC
797748,mainnet,251,108432000,108746587,314588,295294,19294,0.06133101071878139,2021-11-26 05:00:34 UTC
797749,mainnet,251,108432000,108746834,314835,295535,19300,0.06130195181603062,2021-11-26 05:02:41 UTC
797751,mainnet,251,108432000,108747091,315092,295775,19317,0.06130590430731342,2021-11-26 05:04:51 UTC
797753,mainnet,251,108432000,108747368,315369,296038,19331,0.06129644955591704,2021-11-26 05:07:15 UTC
797754,mainnet,251,108432000,108747627,315628,296295,19333,0.06125248710507306,2021-11-26 05:09:31 UTC
797756,mainnet,251,108432000,108747858,315859,296523,19336,0.061217188682291784,2021-11-26 05:11:39 UTC
797757,mainnet,251,108432000,108748099,316100,296756,19344,0.061195824106295475,2021-11-26 05:13:48 UTC
797759,mainnet,251,108432000,108748348,316349,297001,19348,0.0611603008070201,2021-11-26 05:15:59 UTC
797760,mainnet,251,108432000,108748592,316593,297234,19359,0.06114790914518009,2021-11-26 05:18:07 UTC
797761,mainnet,251,108432000,108748839,316840,297468,19372,0.06114127004166141,2021-11-26 05:20:17 UTC
797763,mainnet,251,108432000,108749085,317086,297694,19392,0.0611569101127139,2021-11-26 05:22:30 UTC
797764,mainnet,251,108432000,108749318,317319,297896,19423,0.06120969749684072,2021-11-26 05:24:41 UTC
797766,mainnet,251,108432000,108749544,317545,298102,19443,0.06122911713300477,2021-11-26 05:26:47 UTC
797767,mainnet,251,108432000,108749783,317784,298339,19445,0.06118936132719079,2021-11-26 05:28:59 UTC
797768,mainnet,251,108432000,108750033,318034,298566,19468,0.061213580937887146,2021-11-26 05:31:11 UTC
797770,mainnet,251,108432000,108750270,318271,298787,19484,0.06121826996490412,2021-11-26 05:33:16 UTC
797771,mainnet,251,108432000,108750514,318515,299018,19497,0.061212187809051376,2021-11-26 05:35:24 UTC
797773,mainnet,251,108432000,108750776,318777,299262,19515,0.06121834385793203,2021-11-26 05:37:35 UTC
797774,mainnet,251,108432000,108751025,319026,299463,19563,0.061321020857234204,2021-11-26 05:39:50 UTC
797776,mainnet,251,108432000,108751262,319263,299693,19570,0.06129742563341195,2021-11-26 05:41:54 UTC
797777,mainnet,251,108432000,108751517,319518,299941,19577,0.06127041356042539,2021-11-26 05:44:05 UTC
797779,mainnet,251,108432000,108751785,319786,300190,19596,0.06127847998348896,2021-11-26 05:46:27 UTC
797780,mainnet,251,108432000,108752060,320061,300460,19601,0.061241450848432015,2021-11-26 05:48:53 UTC
797782,mainnet,251,108432000,108752324,320325,300708,19617,0.06124092718332943,2021-11-26 05:51:38 UTC
797783,mainnet,251,108432000,108752624,320625,300993,19632,0.06123040935672515,2021-11-26 05:53:57 UTC
797785,mainnet,251,108432000,108752868,320869,301227,19642,0.06121501298037517,2021-11-26 05:56:03 UTC
797786,mainnet,251,108432000,108753119,321120,301465,19655,0.061207648231190834,2021-11-26 05:58:18 UTC
797788,mainnet,251,108432000,108753382,321383,301721,19662,0.061179340537614,2021-11-26 06:00:40 UTC
797789,mainnet,251,108432000,108753650,321651,301972,19679,0.06118121815259396,2021-11-26 06:03:03 UTC
797791,mainnet,251,108432000,108753893,321894,302207,19687,0.061159884931064265,2021-11-26 06:05:06 UTC
797792,mainnet,251,108432000,108754112,322113,302408,19705,0.06117418421485628,2021-11-26 06:07:10 UTC
797794,mainnet,251,108432000,108754364,322365,302652,19713,0.06115117956353822,2021-11-26 06:09:16 UTC
797795,mainnet,251,108432000,108754615,322616,302887,19729,0.06115319760954199,2021-11-26 06:11:26 UTC
797797,mainnet,251,108432000,108754848,322849,303107,19742,0.061149329872479084,2021-11-26 06:13:37 UTC
797798,mainnet,251,108432000,108755097,323098,303352,19746,0.06111458442949198,2021-11-26 06:15:47 UTC
797800,mainnet,251,108432000,108755345,323346,303572,19774,0.06115430529525647,2021-11-26 06:17:56 UTC
797801,mainnet,251,108432000,108755578,323579,303791,19788,0.06115353592167601,2021-11-26 06:20:01 UTC
797802,mainnet,251,108432000,108755823,323824,304017,19807,0.06116594199318148,2021-11-26 06:22:15 UTC
797804,mainnet,251,108432000,108756083,324084,304257,19827,0.06117858333024771,2021-11-26 06:24:23 UTC
797805,mainnet,251,108432000,108756300,324301,304464,19837,0.0611684823666902,2021-11-26 06:26:23 UTC
797807,mainnet,251,108432000,108756537,324538,304690,19848,0.061157707263864325,2021-11-26 06:28:34 UTC
797808,mainnet,251,108432000,108756776,324777,304924,19853,0.0611280971251043,2021-11-26 06:30:47 UTC
797810,mainnet,251,108432000,108757020,325021,305154,19867,0.06112528113568046,2021-11-26 06:32:56 UTC
797811,mainnet,251,108432000,108757271,325272,305390,19882,0.06112422833812932,2021-11-26 06:35:05 UTC
797813,mainnet,251,108432000,108757496,325497,305610,19887,0.06109733730264795,2021-11-26 06:37:06 UTC
797814,mainnet,251,108432000,108757761,325762,305866,19896,0.0610752635359557,2021-11-26 06:39:19 UTC
797816,mainnet,251,108432000,108758029,326030,306132,19898,0.061031193448455666,2021-11-26 06:41:35 UTC
797817,mainnet,251,108432000,108758274,326275,306366,19909,0.06101907899777795,2021-11-26 06:43:48 UTC
797818,mainnet,251,108432000,108758516,326517,306594,19923,0.06101673113497919,2021-11-26 06:45:53 UTC
797820,mainnet,251,108432000,108758735,326736,306813,19923,0.06097583370060232,2021-11-26 06:47:58 UTC
797821,mainnet,251,108432000,108758993,326994,307061,19933,0.06095830504535251,2021-11-26 06:50:14 UTC
797822,mainnet,251,108432000,108759303,327304,307362,19942,0.060928066873609854,2021-11-26 06:52:49 UTC
797823,mainnet,251,108432000,108759546,327547,307604,19943,0.0608859186620546,2021-11-26 06:55:12 UTC
797824,mainnet,251,108432000,108759837,327838,307879,19959,0.060880678871881845,2021-11-26 06:57:33 UTC
797826,mainnet,251,108432000,108760109,328110,308146,19964,0.060845448172868855,2021-11-26 06:59:59 UTC
797827,mainnet,251,108432000,108760352,328353,308378,19975,0.06083391959263354,2021-11-26 07:02:17 UTC
797829,mainnet,251,108432000,108760630,328631,308641,19990,0.06082810203541358,2021-11-26 07:04:50 UTC
797830,mainnet,251,108432000,108760873,328874,308869,20005,0.06082876724824705,2021-11-26 07:07:03 UTC
797832,mainnet,251,108432000,108761131,329132,309118,20014,0.060808429444721264,2021-11-26 07:09:24 UTC
797833,mainnet,251,108432000,108761378,329379,309350,20029,0.06080836968962806,2021-11-26 07:11:28 UTC
797835,mainnet,251,108432000,108761605,329606,309552,20054,0.06084233903509038,2021-11-26 07:13:31 UTC
797836,mainnet,251,108432000,108761857,329858,309802,20056,0.06080192082653748,2021-11-26 07:15:48 UTC
797838,mainnet,251,108432000,108762140,330141,310069,20072,0.060798264983749364,2021-11-26 07:17:59 UTC
797839,mainnet,251,108432000,108762384,330385,310307,20078,0.06077152413093815,2021-11-26 07:20:04 UTC
797841,mainnet,251,108432000,108762688,330689,310593,20096,0.06077008911696488,2021-11-26 07:22:40 UTC
797842,mainnet,251,108432000,108762920,330921,310817,20104,0.06075165976169539,2021-11-26 07:24:47 UTC
797843,mainnet,251,108432000,108763147,331148,311035,20113,0.060737193037554205,2021-11-26 07:26:52 UTC
797845,mainnet,251,108432000,108763419,331420,311289,20131,0.060741657111821855,2021-11-26 07:29:21 UTC
797846,mainnet,251,108432000,108763644,331645,311495,20150,0.06075773794267967,2021-11-26 07:31:36 UTC
797848,mainnet,251,108432000,108763861,331862,311697,20165,0.06076320880365935,2021-11-26 07:33:40 UTC
797849,mainnet,251,108432000,108764128,332129,311946,20183,0.06076855679570287,2021-11-26 07:36:03 UTC
797851,mainnet,251,108432000,108764296,332297,312100,20197,0.060779964910908015,2021-11-26 07:38:15 UTC
797852,mainnet,251,108432000,108764599,332600,312368,20232,0.060829825616355984,2021-11-26 07:40:18 UTC
797853,mainnet,251,108432000,108764813,332814,312567,20247,0.0608357821485875,2021-11-26 07:42:31 UTC
797855,mainnet,251,108432000,108765033,333034,312767,20267,0.06085564837223827,2021-11-26 07:44:38 UTC
797856,mainnet,251,108432000,108765277,333278,312997,20281,0.060853101614868066,2021-11-26 07:47:07 UTC
797858,mainnet,251,108432000,108765503,333504,313187,20317,0.060919809057762425,2021-11-26 07:49:30 UTC
797860,mainnet,251,108432000,108765740,333741,313388,20353,0.06098441605915965,2021-11-26 07:51:50 UTC
797861,mainnet,251,108432000,108765987,333988,313613,20375,0.061005185815059225,2021-11-26 07:54:21 UTC
797863,mainnet,251,108432000,108766190,334191,313791,20400,0.06104293652432292,2021-11-26 07:56:36 UTC
797864,mainnet,251,108432000,108766350,334351,313933,20418,0.061067560737069725,2021-11-26 07:58:44 UTC
797866,mainnet,251,108432000,108766687,334688,314237,20451,0.061104670618605986,2021-11-26 08:01:00 UTC
797867,mainnet,251,108432000,108766903,334904,314421,20483,0.06116081026204524,2021-11-26 08:03:23 UTC
797869,mainnet,251,108432000,108767147,335148,314618,20530,0.06125651950779954,2021-11-26 08:05:35 UTC
797870,mainnet,251,108432000,108767350,335351,314808,20543,0.06125820409063936,2021-11-26 08:07:58 UTC
797872,mainnet,251,108432000,108767590,335591,315011,20580,0.06132464815802569,2021-11-26 08:10:30 UTC
797873,mainnet,251,108432000,108767801,335802,315182,20620,0.06140523284554589,2021-11-26 08:12:37 UTC
797875,mainnet,251,108432000,108767997,335998,315351,20647,0.06144977053434842,2021-11-26 08:14:48 UTC
797876,mainnet,251,108432000,108768185,336186,315521,20665,0.06146894873671122,2021-11-26 08:17:01 UTC
797878,mainnet,251,108432000,108768398,336399,315690,20709,0.06156082509163226,2021-11-26 08:19:14 UTC
797879,mainnet,251,108432000,108768603,336604,315856,20748,0.061639196206818694,2021-11-26 08:21:27 UTC
797881,mainnet,251,108432000,108768795,336796,316013,20783,0.06170797752942434,2021-11-26 08:23:37 UTC
797882,mainnet,251,108432000,108768993,336994,316154,20840,0.06184086363555434,2021-11-26 08:25:52 UTC
797884,mainnet,251,108432000,108769179,337180,316313,20867,0.06188682602764102,2021-11-26 08:28:03 UTC
797885,mainnet,251,108432000,108769419,337420,316498,20922,0.06200580878430443,2021-11-26 08:30:31 UTC
797887,mainnet,251,108432000,108769621,337622,316660,20962,0.062087186261558784,2021-11-26 08:33:21 UTC
797889,mainnet,251,108432000,108769844,337845,316847,20998,0.062152762361437935,2021-11-26 08:36:01 UTC
797890,mainnet,251,108432000,108770087,338088,317042,21046,0.06225006507181562,2021-11-26 08:38:32 UTC
797892,mainnet,251,108432000,108770281,338282,317207,21075,0.06230009282196511,2021-11-26 08:40:39 UTC
797893,mainnet,251,108432000,108770491,338492,317393,21099,0.062332344634437445,2021-11-26 08:43:02 UTC
797895,mainnet,251,108432000,108770699,338700,317570,21130,0.062385591969294364,2021-11-26 08:45:14 UTC
797896,mainnet,251,108432000,108770892,338893,317739,21154,0.062420882107331814,2021-11-26 08:47:27 UTC
797898,mainnet,251,108432000,108771073,339074,317893,21181,0.0624671900529088,2021-11-26 08:49:44 UTC
797899,mainnet,251,108432000,108771258,339259,318040,21219,0.06254513513274519,2021-11-26 08:51:50 UTC
797901,mainnet,251,108432000,108771432,339433,318175,21258,0.06262797076300772,2021-11-26 08:54:02 UTC
797902,mainnet,251,108432000,108771593,339594,318293,21301,0.06272490091108794,2021-11-26 08:56:17 UTC
797904,mainnet,251,108432000,108771813,339814,318448,21366,0.06287557310764123,2021-11-26 08:58:36 UTC
797906,mainnet,251,108432000,108772007,340008,318611,21397,0.06293087221477142,2021-11-26 09:01:04 UTC
797907,mainnet,251,108432000,108772169,340170,318740,21430,0.06299791280830173,2021-11-26 09:03:25 UTC
797909,mainnet,251,108432000,108772393,340394,318925,21469,0.06307102945410319,2021-11-26 09:05:57 UTC
797910,mainnet,251,108432000,108772562,340563,319059,21504,0.06314250226830279,2021-11-26 09:08:05 UTC
797912,mainnet,251,108432000,108772761,340762,319215,21547,0.06323181575410404,2021-11-26 09:10:34 UTC
797913,mainnet,251,108432000,108772925,340926,319354,21572,0.06327472824014596,2021-11-26 09:12:39 UTC
797914,mainnet,251,108432000,108773122,341123,319519,21604,0.06333199461777717,2021-11-26 09:14:45 UTC
797916,mainnet,251,108432000,108773324,341325,319699,21626,0.06335896872482238,2021-11-26 09:17:00 UTC
797917,mainnet,251,108432000,108773506,341507,319846,21661,0.0634276896227603,2021-11-26 09:19:01 UTC
797919,mainnet,251,108432000,108773688,341689,320012,21677,0.06344073119122945,2021-11-26 09:21:12 UTC
797920,mainnet,251,108432000,108773888,341889,320170,21719,0.06352646619224368,2021-11-26 09:23:22 UTC
797922,mainnet,251,108432000,108774121,342122,320368,21754,0.06358550458608332,2021-11-26 09:25:33 UTC
797923,mainnet,251,108432000,108774314,342315,320537,21778,0.0636197654207382,2021-11-26 09:27:36 UTC
797924,mainnet,251,108432000,108774493,342494,320697,21797,0.0636419908085981,2021-11-26 09:29:45 UTC
797926,mainnet,251,108432000,108774712,342713,320882,21831,0.06370053076480904,2021-11-26 09:31:51 UTC
797927,mainnet,251,108432000,108774901,342902,321051,21851,0.06372374614321293,2021-11-26 09:34:17 UTC
797929,mainnet,251,108432000,108775091,343092,321208,21884,0.06378464085434811,2021-11-26 09:36:18 UTC
797930,mainnet,251,108432000,108775287,343288,321379,21909,0.06382104821607514,2021-11-26 09:38:27 UTC
797932,mainnet,251,108432000,108775490,343491,321546,21945,0.06388813680707792,2021-11-26 09:40:36 UTC
797933,mainnet,251,108432000,108775678,343679,321721,21958,0.06389101458046607,2021-11-26 09:42:47 UTC
797934,mainnet,251,108432000,108775911,343912,321914,21998,0.06396403731187048,2021-11-26 09:45:00 UTC
797935,mainnet,251,108432000,108776116,344117,322098,22019,0.06398695792419438,2021-11-26 09:47:15 UTC
797936,mainnet,251,108432000,108776346,344347,322290,22057,0.06405457285819247,2021-11-26 09:49:22 UTC
797938,mainnet,251,108432000,108776547,344548,322483,22065,0.06404042397575954,2021-11-26 09:51:31 UTC
797939,mainnet,251,108432000,108776757,344758,322658,22100,0.06410293597247925,2021-11-26 09:53:45 UTC
797940,mainnet,251,108432000,108776956,344957,322828,22129,0.06415002449580673,2021-11-26 09:55:50 UTC
797941,mainnet,251,108432000,108777168,345169,323019,22150,0.0641714638336583,2021-11-26 09:58:05 UTC
797943,mainnet,251,108432000,108777357,345358,323181,22177,0.06421452521731073,2021-11-26 10:00:11 UTC
797944,mainnet,251,108432000,108777574,345575,323365,22210,0.06426969543514433,2021-11-26 10:02:26 UTC
797945,mainnet,251,108432000,108777763,345764,323531,22233,0.06430108397635381,2021-11-26 10:04:41 UTC
797946,mainnet,251,108432000,108777983,345984,323693,22291,0.06442783481317055,2021-11-26 10:06:56 UTC
797948,mainnet,251,108432000,108778172,346173,323866,22307,0.0644388788264827,2021-11-26 10:08:59 UTC
797949,mainnet,251,108432000,108778360,346361,324024,22337,0.06449051711942165,2021-11-26 10:11:04 UTC
797951,mainnet,251,108432000,108778581,346582,324222,22360,0.06451575673289438,2021-11-26 10:13:16 UTC
797952,mainnet,251,108432000,108778774,346775,324396,22379,0.06453464061711485,2021-11-26 10:15:23 UTC
797954,mainnet,251,108432000,108778980,346981,324591,22390,0.06452802891224592,2021-11-26 10:17:35 UTC
797955,mainnet,251,108432000,108779209,347210,324791,22419,0.06456899282854757,2021-11-26 10:19:41 UTC
797957,mainnet,251,108432000,108779437,347438,324990,22448,0.06461008870647425,2021-11-26 10:21:59 UTC
797958,mainnet,251,108432000,108779545,347546,325089,22457,0.0646159069590788,2021-11-26 10:24:12 UTC
797959,mainnet,251,108432000,108779909,347910,325404,22506,0.06468914374407174,2021-11-26 10:26:26 UTC
797961,mainnet,251,108432000,108780133,348134,325609,22525,0.06470209746821626,2021-11-26 10:28:40 UTC
797962,mainnet,251,108432000,108780336,348337,325796,22541,0.0647103236233877,2021-11-26 10:30:49 UTC
797964,mainnet,251,108432000,108780549,348550,325965,22585,0.06479701621001291,2021-11-26 10:32:55 UTC
797965,mainnet,251,108432000,108780783,348784,326173,22611,0.06482808844442406,2021-11-26 10:35:16 UTC
797967,mainnet,251,108432000,108781000,349001,326374,22627,0.06483362511855267,2021-11-26 10:37:22 UTC
797968,mainnet,251,108432000,108781250,349251,326600,22651,0.06485593455709504,2021-11-26 10:39:38 UTC
797970,mainnet,251,108432000,108781506,349507,326852,22655,0.06481987485229194,2021-11-26 10:42:03 UTC
797971,mainnet,251,108432000,108781757,349758,327082,22676,0.06483339909308722,2021-11-26 10:44:34 UTC
797973,mainnet,251,108432000,108782023,350024,327320,22704,0.06486412360295295,2021-11-26 10:47:01 UTC
797974,mainnet,251,108432000,108782236,350237,327522,22715,0.06485608316654151,2021-11-26 10:49:12 UTC
797976,mainnet,251,108432000,108782443,350444,327703,22741,0.06489196562075539,2021-11-26 10:51:19 UTC
797977,mainnet,251,108432000,108782663,350664,327888,22776,0.06495106426664841,2021-11-26 10:53:30 UTC
797979,mainnet,251,108432000,108782916,350917,328127,22790,0.06494413208821459,2021-11-26 10:56:26 UTC
797980,mainnet,251,108432000,108783223,351224,328412,22812,0.064950003416623,2021-11-26 10:59:30 UTC
797982,mainnet,251,108432000,108783518,351519,328682,22837,0.06496661631376967,2021-11-26 11:02:00 UTC
797984,mainnet,251,108432000,108783743,351744,328871,22873,0.06502740629548763,2021-11-26 11:04:12 UTC
797985,mainnet,251,108432000,108783947,351948,329053,22895,0.06505222362394444,2021-11-26 11:06:19 UTC
797986,mainnet,251,108432000,108784156,352157,329243,22914,0.06506756929437722,2021-11-26 11:08:37 UTC
797988,mainnet,251,108432000,108784359,352360,329417,22943,0.06511238506073334,2021-11-26 11:10:55 UTC
797989,mainnet,251,108432000,108784573,352574,329576,22998,0.06522885975710063,2021-11-26 11:13:00 UTC
797990,mainnet,251,108432000,108784775,352776,329737,23039,0.06530773068462707,2021-11-26 11:15:04 UTC
797992,mainnet,251,108432000,108784989,352990,329928,23062,0.06533329556078075,2021-11-26 11:17:36 UTC
797993,mainnet,251,108432000,108785258,353259,330167,23092,0.06536846902697455,2021-11-26 11:20:24 UTC
797995,mainnet,251,108432000,108785433,353434,330329,23105,0.06537288432918169,2021-11-26 11:22:16 UTC
797996,mainnet,251,108432000,108785659,353660,330532,23128,0.06539614318837302,2021-11-26 11:24:31 UTC
797998,mainnet,251,108432000,108785854,353855,330723,23132,0.06537140919303104,2021-11-26 11:26:27 UTC
797999,mainnet,251,108432000,108786050,354051,330904,23147,0.0653775868448331,2021-11-26 11:28:26 UTC
798000,mainnet,251,108432000,108786237,354238,331075,23163,0.06538824180353321,2021-11-26 11:30:21 UTC
798002,mainnet,251,108432000,108786441,354442,331260,23182,0.06540421281902258,2021-11-26 11:32:24 UTC
798003,mainnet,251,108432000,108786613,354614,331419,23195,0.0654091491029683,2021-11-26 11:34:19 UTC
798005,mainnet,251,108432000,108786810,354811,331595,23216,0.06543201873673589,2021-11-26 11:36:18 UTC
798006,mainnet,251,108432000,108787011,355012,331768,23244,0.06547384313769676,2021-11-26 11:38:18 UTC
798008,mainnet,251,108432000,108787191,355192,331940,23252,0.06546318610779522,2021-11-26 11:40:16 UTC
798009,mainnet,251,108432000,108787409,355410,332120,23290,0.0655299513238232,2021-11-26 11:42:18 UTC
798011,mainnet,251,108432000,108787643,355644,332323,23321,0.06557400096725939,2021-11-26 11:44:45 UTC
798012,mainnet,251,108432000,108787860,355861,332514,23347,0.065607076920483,2021-11-26 11:46:44 UTC
798014,mainnet,251,108432000,108788058,356059,332700,23359,0.06560429591724967,2021-11-26 11:48:45 UTC
798015,mainnet,251,108432000,108788273,356274,332883,23391,0.06565452432678219,2021-11-26 11:50:52 UTC
798017,mainnet,251,108432000,108788468,356469,333066,23403,0.06565227270814573,2021-11-26 11:52:48 UTC
798018,mainnet,251,108432000,108788675,356676,333262,23414,0.06564501115858651,2021-11-26 11:54:51 UTC
798020,mainnet,251,108432000,108788872,356873,333442,23431,0.06565640998338344,2021-11-26 11:56:54 UTC
798021,mainnet,251,108432000,108789078,357079,333624,23455,0.06568574461113647,2021-11-26 11:58:57 UTC
798023,mainnet,251,108432000,108789276,357277,333797,23480,0.06571931582497614,2021-11-26 12:01:09 UTC
798024,mainnet,251,108432000,108789472,357473,333963,23510,0.06576720479588669,2021-11-26 12:03:39 UTC
798026,mainnet,251,108432000,108789706,357707,334178,23529,0.06577729817979519,2021-11-26 12:05:50 UTC
798027,mainnet,251,108432000,108789885,357886,334336,23550,0.0658030769574669,2021-11-26 12:07:50 UTC
798029,mainnet,251,108432000,108790075,358076,334502,23574,0.06583518582647259,2021-11-26 12:09:51 UTC
798030,mainnet,251,108432000,108790261,358262,334678,23584,0.06582891850098531,2021-11-26 12:11:58 UTC
798032,mainnet,251,108432000,108790500,358501,334887,23614,0.06586871445267935,2021-11-26 12:14:20 UTC
798033,mainnet,251,108432000,108790668,358669,335049,23620,0.06585459016530562,2021-11-26 12:16:19 UTC
798035,mainnet,251,108432000,108790872,358873,335229,23644,0.0658840313982941,2021-11-26 12:18:31 UTC
798036,mainnet,251,108432000,108791074,359075,335405,23670,0.06591937617489382,2021-11-26 12:20:36 UTC
798038,mainnet,251,108432000,108791270,359271,335575,23696,0.06595578268215359,2021-11-26 12:22:40 UTC
798039,mainnet,251,108432000,108791506,359507,335747,23760,0.0660905072780224,2021-11-26 12:25:04 UTC
798041,mainnet,251,108432000,108791601,359602,335834,23768,0.06609529424196751,2021-11-26 12:27:01 UTC
798042,mainnet,251,108432000,108791873,359874,336069,23805,0.0661481518531486,2021-11-26 12:28:27 UTC
798043,mainnet,251,108432000,108792076,360077,336250,23827,0.06617195766461062,2021-11-26 12:30:32 UTC
798044,mainnet,251,108432000,108792288,360289,336440,23849,0.06619408308330257,2021-11-26 12:32:42 UTC
798046,mainnet,251,108432000,108792526,360527,336663,23864,0.06619199116848391,2021-11-26 12:34:47 UTC
798047,mainnet,251,108432000,108792704,360705,336817,23888,0.0662258632400438,2021-11-26 12:36:48 UTC
798049,mainnet,251,108432000,108792893,360894,336974,23920,0.0662798494848903,2021-11-26 12:38:49 UTC
798050,mainnet,251,108432000,108793075,361076,337133,23943,0.06631013969358251,2021-11-26 12:40:50 UTC
798052,mainnet,251,108432000,108793305,361306,337332,23974,0.066353727865023,2021-11-26 12:42:54 UTC
798053,mainnet,251,108432000,108793551,361552,337539,24013,0.06641644908616189,2021-11-26 12:44:55 UTC
798055,mainnet,251,108432000,108793746,361747,337721,24026,0.06641658396614208,2021-11-26 12:46:51 UTC
798056,mainnet,251,108432000,108793974,361975,337926,24049,0.06643828993715035,2021-11-26 12:48:56 UTC
798058,mainnet,251,108432000,108794183,362184,338109,24075,0.0664717381220595,2021-11-26 12:50:58 UTC
798060,mainnet,251,108432000,108794420,362421,338327,24094,0.0664806951032087,2021-11-26 12:53:20 UTC
798061,mainnet,251,108432000,108794627,362628,338503,24125,0.06652823278952535,2021-11-26 12:55:22 UTC
798063,mainnet,251,108432000,108794849,362850,338694,24156,0.0665729640347251,2021-11-26 12:57:23 UTC
798064,mainnet,251,108432000,108795068,363069,338888,24181,0.0666016652482035,2021-11-26 12:59:40 UTC
798066,mainnet,251,108432000,108795302,363303,339104,24199,0.06660831317109961,2021-11-26 13:02:04 UTC
798067,mainnet,251,108432000,108795603,363604,339377,24227,0.06663018008602765,2021-11-26 13:04:39 UTC
798069,mainnet,251,108432000,108795836,363837,339600,24237,0.06661499517641141,2021-11-26 13:06:49 UTC
798070,mainnet,251,108432000,108796068,364069,339831,24238,0.06657529204628793,2021-11-26 13:08:57 UTC
798072,mainnet,251,108432000,108796298,364299,340047,24252,0.06657168973837425,2021-11-26 13:11:02 UTC
798073,mainnet,251,108432000,108796537,364538,340273,24265,0.06656370529272669,2021-11-26 13:13:23 UTC
798074,mainnet,251,108432000,108796766,364767,340490,24277,0.0665548144431925,2021-11-26 13:15:42 UTC
798076,mainnet,251,108432000,108797007,365008,340700,24308,0.06659580063998598,2021-11-26 13:18:06 UTC
798077,mainnet,251,108432000,108797290,365291,340966,24325,0.0665907454604685,2021-11-26 13:20:21 UTC
798079,mainnet,251,108432000,108797549,365550,341217,24333,0.06656544932293804,2021-11-26 13:22:48 UTC
798080,mainnet,251,108432000,108797788,365789,341446,24343,0.06654929481203645,2021-11-26 13:25:09 UTC
798082,mainnet,251,108432000,108798045,366046,341694,24352,0.06652715778891177,2021-11-26 13:27:21 UTC
798083,mainnet,251,108432000,108798271,366272,341911,24361,0.06651068058710466,2021-11-26 13:29:27 UTC
798085,mainnet,251,108432000,108798537,366538,342162,24376,0.06650333662539763,2021-11-26 13:31:50 UTC
798086,mainnet,251,108432000,108798772,366773,342371,24402,0.06653161492258154,2021-11-26 13:34:00 UTC
798088,mainnet,251,108432000,108799012,367013,342596,24417,0.066528978537545,2021-11-26 13:36:06 UTC
798089,mainnet,251,108432000,108799245,367246,342819,24427,0.06651399879100113,2021-11-26 13:38:17 UTC
798090,mainnet,251,108432000,108799441,367442,342992,24450,0.06654111397172888,2021-11-26 13:40:25 UTC
798092,mainnet,251,108432000,108799667,367668,343192,24476,0.06657092811993429,2021-11-26 13:42:35 UTC
798093,mainnet,251,108432000,108799900,367901,343411,24490,0.06656682096542277,2021-11-26 13:44:41 UTC
798094,mainnet,251,108432000,108800128,368129,343616,24513,0.06658807102944891,2021-11-26 13:46:52 UTC
798096,mainnet,251,108432000,108800349,368350,343824,24526,0.0665834125152708,2021-11-26 13:48:57 UTC
798097,mainnet,251,108432000,108800552,368553,344023,24530,0.06655759144546375,2021-11-26 13:51:09 UTC
798099,mainnet,251,108432000,108800804,368805,344258,24547,0.0665582082672415,2021-11-26 13:53:16 UTC
798100,mainnet,251,108432000,108801052,369053,344476,24577,0.06659477094075919,2021-11-26 13:55:24 UTC
798102,mainnet,251,108432000,108801238,369239,344644,24595,0.06660997348600771,2021-11-26 13:57:24 UTC
798103,mainnet,251,108432000,108801441,369442,344831,24611,0.0666166813735309,2021-11-26 13:59:39 UTC
798105,mainnet,251,108432000,108801705,369706,345055,24651,0.06667730575105625,2021-11-26 14:02:15 UTC
798106,mainnet,251,108432000,108801958,369959,345284,24675,0.06669657989128525,2021-11-26 14:04:20 UTC
798107,mainnet,251,108432000,108802196,370197,345511,24686,0.06668341450633042,2021-11-26 14:06:37 UTC
798109,mainnet,251,108432000,108802467,370468,345761,24707,0.06669132016800372,2021-11-26 14:09:03 UTC
798110,mainnet,251,108432000,108802685,370686,345961,24725,0.06670065769950848,2021-11-26 14:11:04 UTC
798112,mainnet,251,108432000,108802917,370918,346175,24743,0.06670746634026928,2021-11-26 14:13:16 UTC
798113,mainnet,251,108432000,108803150,371151,346396,24755,0.06669792079234597,2021-11-26 14:15:25 UTC
798115,mainnet,251,108432000,108803373,371374,346609,24765,0.06668479753563793,2021-11-26 14:17:33 UTC
798116,mainnet,251,108432000,108803621,371622,346842,24780,0.06668065937969227,2021-11-26 14:19:42 UTC
798118,mainnet,251,108432000,108803850,371851,347061,24790,0.06666648738338743,2021-11-26 14:21:49 UTC
798119,mainnet,251,108432000,108804078,372079,347270,24809,0.0666767003781455,2021-11-26 14:24:03 UTC
798121,mainnet,251,108432000,108804303,372304,347462,24842,0.066725041901242,2021-11-26 14:26:10 UTC
798122,mainnet,251,108432000,108804464,372465,347619,24846,0.0667069389070114,2021-11-26 14:28:24 UTC
798124,mainnet,251,108432000,108804789,372790,347910,24880,0.06673998766061322,2021-11-26 14:30:49 UTC
798125,mainnet,251,108432000,108805018,373019,348126,24893,0.06673386610333522,2021-11-26 14:32:55 UTC
798127,mainnet,251,108432000,108805261,373262,348351,24911,0.06673864470532763,2021-11-26 14:35:20 UTC
798128,mainnet,251,108432000,108805420,373421,348504,24917,0.06672629552167661,2021-11-26 14:37:42 UTC
798130,mainnet,251,108432000,108805744,373745,348781,24964,0.06679420460474388,2021-11-26 14:39:47 UTC
798131,mainnet,251,108432000,108805949,373950,348960,24990,0.06682711592458884,2021-11-26 14:41:54 UTC
798133,mainnet,251,108432000,108806181,374182,349183,24999,0.06680973430042066,2021-11-26 14:44:01 UTC
798134,mainnet,251,108432000,108806404,374405,349400,25005,0.06678596706774749,2021-11-26 14:46:10 UTC
798136,mainnet,251,108432000,108806609,374610,349593,25017,0.06678145271081926,2021-11-26 14:48:18 UTC
798137,mainnet,251,108432000,108806822,374823,349791,25032,0.06678352182230013,2021-11-26 14:50:23 UTC
798139,mainnet,251,108432000,108807048,375049,349989,25060,0.06681793578972348,2021-11-26 14:52:29 UTC
798140,mainnet,251,108432000,108807271,375272,350194,25078,0.0668261953996035,2021-11-26 14:54:34 UTC
798142,mainnet,251,108432000,108807513,375514,350414,25100,0.06684171562178774,2021-11-26 14:56:40 UTC
798143,mainnet,251,108432000,108807738,375739,350611,25128,0.06687620928357184,2021-11-26 14:58:49 UTC
798144,mainnet,251,108432000,108807961,375962,350827,25135,0.06685516089392013,2021-11-26 15:00:59 UTC
798146,mainnet,251,108432000,108808175,376176,351015,25161,0.06688624473650631,2021-11-26 15:03:01 UTC
798147,mainnet,251,108432000,108808292,376293,351131,25162,0.0668681054391126,2021-11-26 15:05:07 UTC
798149,mainnet,251,108432000,108808623,376624,351415,25209,0.06693413059178385,2021-11-26 15:07:25 UTC
798151,mainnet,251,108432000,108808863,376864,351642,25222,0.06692599983017747,2021-11-26 15:09:38 UTC
798152,mainnet,251,108432000,108809099,377100,351855,25245,0.06694510739856802,2021-11-26 15:12:13 UTC
798154,mainnet,251,108432000,108809297,377298,352034,25264,0.06696033374149876,2021-11-26 15:14:18 UTC
798155,mainnet,251,108432000,108809498,377499,352185,25314,0.06705713127716895,2021-11-26 15:16:24 UTC
798157,mainnet,251,108432000,108809724,377725,352390,25335,0.0670726057316831,2021-11-26 15:18:48 UTC
798158,mainnet,251,108432000,108809909,377910,352551,25359,0.06710327855838692,2021-11-26 15:21:03 UTC
798160,mainnet,251,108432000,108810149,378150,352763,25387,0.06713473489356075,2021-11-26 15:23:28 UTC
798161,mainnet,251,108432000,108810387,378388,352962,25426,0.0671955770267556,2021-11-26 15:25:33 UTC
798163,mainnet,251,108432000,108810663,378664,353200,25464,0.06724695244332707,2021-11-26 15:28:12 UTC
798165,mainnet,251,108432000,108810896,378897,353419,25478,0.06724254876655134,2021-11-26 15:30:32 UTC
798166,mainnet,251,108432000,108811131,379132,353627,25505,0.06727208465653123,2021-11-26 15:32:51 UTC
798168,mainnet,251,108432000,108811402,379403,353877,25526,0.06727938366328153,2021-11-26 15:35:19 UTC
798169,mainnet,251,108432000,108811627,379628,354076,25552,0.06730799624895951,2021-11-26 15:37:27 UTC
798171,mainnet,251,108432000,108811876,379877,354294,25583,0.06734548287998483,2021-11-26 15:39:51 UTC
798172,mainnet,251,108432000,108812095,380096,354495,25601,0.06735403687489476,2021-11-26 15:42:00 UTC
798174,mainnet,251,108432000,108812310,380311,354698,25613,0.06734751295650139,2021-11-26 15:44:05 UTC
798175,mainnet,251,108432000,108812515,380516,354895,25621,0.0673322540970682,2021-11-26 15:46:13 UTC
798177,mainnet,251,108432000,108812740,380741,355102,25639,0.06733974013830925,2021-11-26 15:48:20 UTC
798178,mainnet,251,108432000,108812982,380983,355331,25652,0.0673310882637808,2021-11-26 15:50:44 UTC
798180,mainnet,251,108432000,108813307,381308,355614,25694,0.06738384717865872,2021-11-26 15:53:44 UTC
798182,mainnet,251,108432000,108813521,381522,355816,25706,0.0673775037874618,2021-11-26 15:55:50 UTC
798183,mainnet,251,108432000,108813756,381757,356026,25731,0.06740151457602611,2021-11-26 15:58:06 UTC
798185,mainnet,251,108432000,108814026,382027,356266,25761,0.067432406610004,2021-11-26 16:00:28 UTC
798186,mainnet,251,108432000,108814255,382256,356478,25778,0.06743648235737307,2021-11-26 16:02:38 UTC
798188,mainnet,251,108432000,108814459,382460,356661,25799,0.06745542017465879,2021-11-26 16:04:50 UTC
798189,mainnet,251,108432000,108814699,382700,356859,25841,0.06752286386203292,2021-11-26 16:06:55 UTC
798191,mainnet,251,108432000,108814976,382977,357115,25862,0.06752885943542301,2021-11-26 16:09:24 UTC
798192,mainnet,251,108432000,108815234,383235,357361,25874,0.06751471029524965,2021-11-26 16:11:49 UTC
798194,mainnet,251,108432000,108815468,383469,357577,25892,0.06752045145761457,2021-11-26 16:13:51 UTC
798195,mainnet,251,108432000,108815694,383695,357793,25902,0.0675067436375246,2021-11-26 16:16:00 UTC
798197,mainnet,251,108432000,108815919,383920,357983,25937,0.06755834548864346,2021-11-26 16:18:10 UTC
798198,mainnet,251,108432000,108816139,384140,358195,25945,0.06754048003332118,2021-11-26 16:20:20 UTC
798200,mainnet,251,108432000,108816355,384356,358390,25966,0.06755716054907429,2021-11-26 16:22:39 UTC
798201,mainnet,251,108432000,108816595,384596,358593,26003,0.06761120760486329,2021-11-26 16:24:45 UTC
798203,mainnet,251,108432000,108816817,384818,358806,26012,0.06759559064284934,2021-11-26 16:26:52 UTC
798204,mainnet,251,108432000,108817031,385032,359014,26018,0.06757360427185273,2021-11-26 16:29:07 UTC
798206,mainnet,251,108432000,108817302,385303,359265,26038,0.06757798408006166,2021-11-26 16:31:40 UTC
798207,mainnet,251,108432000,108817505,385506,359450,26056,0.06758909070157144,2021-11-26 16:33:50 UTC
798209,mainnet,251,108432000,108817732,385733,359644,26089,0.0676348666046203,2021-11-26 16:36:02 UTC
798210,mainnet,251,108432000,108817935,385936,359830,26106,0.06764333982836533,2021-11-26 16:38:18 UTC
798212,mainnet,251,108432000,108818204,386205,360087,26118,0.06762729638404474,2021-11-26 16:40:44 UTC
798213,mainnet,251,108432000,108818429,386430,360295,26135,0.0676319126361825,2021-11-26 16:42:53 UTC
798215,mainnet,251,108432000,108818652,386653,360512,26141,0.0676084240908515,2021-11-26 16:45:01 UTC
798216,mainnet,251,108432000,108818883,386884,360715,26169,0.06764042968951933,2021-11-26 16:47:13 UTC
798218,mainnet,251,108432000,108819101,387102,360905,26197,0.06767466972529204,2021-11-26 16:49:23 UTC
798219,mainnet,251,108432000,108819339,387340,361114,26226,0.06770795683378944,2021-11-26 16:51:51 UTC
798221,mainnet,251,108432000,108819536,387537,361286,26251,0.06773804823797469,2021-11-26 16:54:34 UTC
798223,mainnet,251,108432000,108819788,387789,361515,26274,0.0677533400895848,2021-11-26 16:56:43 UTC
798224,mainnet,251,108432000,108820021,388022,361721,26301,0.06778223915138833,2021-11-26 16:58:49 UTC
798226,mainnet,251,108432000,108820240,388241,361927,26314,0.06777748872478692,2021-11-26 17:01:03 UTC
798227,mainnet,251,108432000,108820474,388475,362138,26337,0.06779586846000386,2021-11-26 17:03:16 UTC
798228,mainnet,251,108432000,108820688,388689,362337,26352,0.06779713344087432,2021-11-26 17:05:22 UTC
798229,mainnet,251,108432000,108820894,388895,362516,26379,0.06783064837552552,2021-11-26 17:07:34 UTC
798231,mainnet,251,108432000,108821116,389117,362726,26391,0.06782278851862036,2021-11-26 17:09:40 UTC
798232,mainnet,251,108432000,108821342,389343,362936,26407,0.06782451463105796,2021-11-26 17:11:51 UTC
798234,mainnet,251,108432000,108821575,389576,363146,26430,0.06784298827443169,2021-11-26 17:14:08 UTC
798235,mainnet,251,108432000,108821761,389762,363324,26438,0.06783113797650873,2021-11-26 17:16:47 UTC
798237,mainnet,251,108432000,108822068,390069,363594,26475,0.06787260715411889,2021-11-26 17:18:59 UTC
798238,mainnet,251,108432000,108822280,390281,363787,26494,0.06788442173715861,2021-11-26 17:21:09 UTC
798240,mainnet,251,108432000,108822502,390503,363991,26512,0.06789192400570546,2021-11-26 17:23:21 UTC
798242,mainnet,251,108432000,108822719,390720,364196,26524,0.06788493038493039,2021-11-26 17:25:38 UTC
798243,mainnet,251,108432000,108822960,390961,364422,26539,0.06788145109102954,2021-11-26 17:27:55 UTC
798245,mainnet,251,108432000,108823164,391165,364608,26557,0.06789206600795061,2021-11-26 17:30:02 UTC
798246,mainnet,251,108432000,108823376,391377,364782,26595,0.06795238350746212,2021-11-26 17:32:25 UTC
798248,mainnet,251,108432000,108823623,391624,364990,26634,0.06800911077972749,2021-11-26 17:34:54 UTC
798249,mainnet,251,108432000,108823847,391848,365192,26656,0.06802637757497805,2021-11-26 17:37:12 UTC
798251,mainnet,251,108432000,108824105,392106,365426,26680,0.06804282515442253,2021-11-26 17:39:46 UTC
798253,mainnet,251,108432000,108824352,392353,365647,26706,0.06806625666173063,2021-11-26 17:42:07 UTC
798254,mainnet,251,108432000,108824576,392577,365854,26723,0.06807072243152298,2021-11-26 17:44:19 UTC
798256,mainnet,251,108432000,108824783,392784,366039,26745,0.06809085909813027,2021-11-26 17:46:40 UTC
798257,mainnet,251,108432000,108825022,393023,366254,26769,0.06811051770507069,2021-11-26 17:48:58 UTC
798259,mainnet,251,108432000,108825298,393299,366501,26798,0.0681364559787846,2021-11-26 17:51:49 UTC
798260,mainnet,251,108432000,108825553,393554,366739,26815,0.06813550364117758,2021-11-26 17:54:10 UTC
798262,mainnet,251,108432000,108825757,393758,366922,26836,0.06815353592815893,2021-11-26 17:56:23 UTC
798263,mainnet,251,108432000,108825971,393972,367118,26854,0.06816220442061872,2021-11-26 17:58:45 UTC
798265,mainnet,251,108432000,108826196,394197,367306,26891,0.06821716045530535,2021-11-26 18:01:09 UTC
798267,mainnet,251,108432000,108826448,394449,367521,26928,0.0682673805739145,2021-11-26 18:03:24 UTC
798268,mainnet,251,108432000,108826708,394709,367762,26947,0.06827054868270042,2021-11-26 18:06:13 UTC
798270,mainnet,251,108432000,108826900,394901,367937,26964,0.06828040445580032,2021-11-26 18:08:21 UTC
798271,mainnet,251,108432000,108827117,395118,368105,27013,0.0683669182370836,2021-11-26 18:10:30 UTC
798272,mainnet,251,108432000,108827297,395298,368277,27021,0.06835602507475373,2021-11-26 18:12:36 UTC
798274,mainnet,251,108432000,108827515,395516,368463,27053,0.06839925565590267,2021-11-26 18:14:47 UTC
798275,mainnet,251,108432000,108827750,395751,368665,27086,0.06844202541497052,2021-11-26 18:17:04 UTC
798277,mainnet,251,108432000,108827963,395964,368862,27102,0.06844561626814559,2021-11-26 18:19:14 UTC
798278,mainnet,251,108432000,108828154,396155,369041,27114,0.06844290744784239,2021-11-26 18:21:20 UTC
798280,mainnet,251,108432000,108828375,396376,369235,27141,0.06847286414919168,2021-11-26 18:23:30 UTC
798281,mainnet,251,108432000,108828558,396559,369401,27158,0.06848413476935336,2021-11-26 18:25:38 UTC
798283,mainnet,251,108432000,108828798,396799,369603,27196,0.06853847917963503,2021-11-26 18:27:44 UTC
798284,mainnet,251,108432000,108829117,397118,369873,27245,0.06860681208104392,2021-11-26 18:30:59 UTC
798286,mainnet,251,108432000,108829365,397366,370085,27281,0.06865459047829961,2021-11-26 18:33:26 UTC
798287,mainnet,251,108432000,108829601,397602,370291,27311,0.06868929230738276,2021-11-26 18:35:36 UTC
798289,mainnet,251,108432000,108829804,397805,370467,27338,0.06872211259285328,2021-11-26 18:37:43 UTC
798291,mainnet,251,108432000,108830035,398036,370664,27372,0.06876764915736265,2021-11-26 18:39:52 UTC
798292,mainnet,251,108432000,108830260,398261,370874,27387,0.06876646219439012,2021-11-26 18:42:11 UTC
798294,mainnet,251,108432000,108830491,398492,371093,27399,0.06875671280728346,2021-11-26 18:44:31 UTC
798295,mainnet,251,108432000,108830733,398734,371280,27454,0.06885291949018645,2021-11-26 18:47:07 UTC
798297,mainnet,251,108432000,108830976,398977,371511,27466,0.06884106101354213,2021-11-26 18:49:13 UTC
798298,mainnet,251,108432000,108831186,399187,371701,27486,0.06885494768116196,2021-11-26 18:51:22 UTC
798300,mainnet,251,108432000,108831454,399455,371951,27504,0.06885381332064938,2021-11-26 18:54:09 UTC
798301,mainnet,251,108432000,108831669,399670,372150,27520,0.06885680686566417,2021-11-26 18:56:27 UTC
798303,mainnet,251,108432000,108831917,399918,372382,27536,0.06885411509359418,2021-11-26 18:58:37 UTC
798304,mainnet,251,108432000,108832152,400153,372617,27536,0.06881367876787128,2021-11-26 19:00:51 UTC
798306,mainnet,251,108432000,108832393,400394,372848,27546,0.06879723472379706,2021-11-26 19:03:14 UTC
798307,mainnet,251,108432000,108832628,400629,373041,27588,0.06886171495323604,2021-11-26 19:05:26 UTC
798309,mainnet,251,108432000,108832838,400839,373241,27598,0.06885058589608296,2021-11-26 19:07:32 UTC
798310,mainnet,251,108432000,108833071,401072,373418,27654,0.06895021342801293,2021-11-26 19:09:57 UTC
798312,mainnet,251,108432000,108833288,401289,373608,27681,0.06898021126918505,2021-11-26 19:12:08 UTC
798313,mainnet,251,108432000,108833511,401512,373808,27704,0.06899918308792763,2021-11-26 19:14:22 UTC
798315,mainnet,251,108432000,108833760,401761,374034,27727,0.06901366732958152,2021-11-26 19:16:42 UTC
798316,mainnet,251,108432000,108833992,401993,374260,27733,0.06898876348593135,2021-11-26 19:19:03 UTC
798318,mainnet,251,108432000,108834202,402203,374451,27752,0.06899998259585334,2021-11-26 19:21:13 UTC
798319,mainnet,251,108432000,108834447,402448,374670,27778,0.06902258179938775,2021-11-26 19:23:33 UTC
798321,mainnet,251,108432000,108834671,402672,374882,27790,0.0690139865697143,2021-11-26 19:25:41 UTC
798322,mainnet,251,108432000,108834875,402876,375062,27814,0.0690386123770093,2021-11-26 19:27:51 UTC
798324,mainnet,251,108432000,108835123,403124,375283,27841,0.06906311705579425,2021-11-26 19:29:59 UTC
798325,mainnet,251,108432000,108835353,403354,375496,27858,0.06906588257461188,2021-11-26 19:32:18 UTC
798327,mainnet,251,108432000,108835588,403589,375710,27879,0.06907770033375538,2021-11-26 19:34:36 UTC
798328,mainnet,251,108432000,108835822,403823,375914,27909,0.0691119624191787,2021-11-26 19:36:47 UTC
798330,mainnet,251,108432000,108836049,404050,376115,27935,0.0691374829847791,2021-11-26 19:39:03 UTC
798331,mainnet,251,108432000,108836271,404272,376307,27965,0.06917372462104722,2021-11-26 19:41:22 UTC
798332,mainnet,251,108432000,108836506,404507,376524,27983,0.06917803647402888,2021-11-26 19:43:40 UTC
798334,mainnet,251,108432000,108836723,404724,376721,28003,0.0691903618268252,2021-11-26 19:46:01 UTC
798335,mainnet,251,108432000,108836941,404942,376916,28026,0.06920991154288762,2021-11-26 19:48:13 UTC
798337,mainnet,251,108432000,108837214,405215,377164,28051,0.06922497933195958,2021-11-26 19:50:32 UTC
798339,mainnet,251,108432000,108837460,405461,377394,28067,0.06922244062930837,2021-11-26 19:52:52 UTC
798340,mainnet,251,108432000,108837704,405705,377623,28082,0.069217781392884,2021-11-26 19:55:16 UTC
798342,mainnet,251,108432000,108837954,405955,377845,28110,0.06924412804374869,2021-11-26 19:57:33 UTC
798343,mainnet,251,108432000,108838189,406190,378059,28131,0.06925576700558851,2021-11-26 19:59:47 UTC
798345,mainnet,251,108432000,108838425,406426,378277,28149,0.06925984065980031,2021-11-26 20:02:15 UTC
798346,mainnet,251,108432000,108838679,406680,378494,28186,0.06930756368643651,2021-11-26 20:04:29 UTC
798348,mainnet,251,108432000,108838874,406875,378667,28208,0.0693284178187404,2021-11-26 20:06:45 UTC
798349,mainnet,251,108432000,108839128,407129,378903,28226,0.06932937717529333,2021-11-26 20:08:58 UTC
798351,mainnet,251,108432000,108839389,407390,379150,28240,0.06931932546208792,2021-11-26 20:11:29 UTC
798352,mainnet,251,108432000,108839600,407601,379345,28256,0.06932269547915731,2021-11-26 20:13:43 UTC
798353,mainnet,251,108432000,108839859,407860,379575,28285,0.06934977688422497,2021-11-26 20:16:01 UTC
798355,mainnet,251,108432000,108840094,408095,379805,28290,0.06932209412024161,2021-11-26 20:18:13 UTC
798356,mainnet,251,108432000,108840320,408321,380017,28304,0.06931801205424164,2021-11-26 20:20:29 UTC
798358,mainnet,251,108432000,108840572,408573,380248,28325,0.06932665643593679,2021-11-26 20:22:45 UTC
798359,mainnet,251,108432000,108840809,408810,380470,28340,0.06932315745700937,2021-11-26 20:25:01 UTC
798361,mainnet,251,108432000,108841046,409047,380700,28347,0.06930010487792357,2021-11-26 20:27:12 UTC
798362,mainnet,251,108432000,108841298,409299,380938,28361,0.06929164254005019,2021-11-26 20:29:27 UTC
798364,mainnet,251,108432000,108841530,409531,381142,28389,0.06932075960061632,2021-11-26 20:31:42 UTC
798365,mainnet,251,108432000,108841776,409777,381374,28403,0.06931330943415565,2021-11-26 20:34:05 UTC
798367,mainnet,251,108432000,108841979,409980,381549,28431,0.06934728523342602,2021-11-26 20:36:16 UTC
798368,mainnet,251,108432000,108842202,410203,381756,28447,0.06934859081966734,2021-11-26 20:38:30 UTC
798370,mainnet,251,108432000,108842455,410456,381988,28468,0.06935700781569766,2021-11-26 20:41:09 UTC
798371,mainnet,251,108432000,108842717,410718,382239,28479,0.06933954684235899,2021-11-26 20:43:32 UTC
798373,mainnet,251,108432000,108842956,410957,382464,28493,0.06933328791090065,2021-11-26 20:45:48 UTC
798375,mainnet,251,108432000,108843205,411206,382691,28515,0.0693448052800786,2021-11-26 20:48:18 UTC
798376,mainnet,251,108432000,108843434,411435,382904,28531,0.06934509703841434,2021-11-26 20:50:31 UTC
798378,mainnet,251,108432000,108843646,411647,383100,28547,0.0693482522646831,2021-11-26 20:52:39 UTC
798379,mainnet,251,108432000,108843875,411876,383309,28567,0.06935825345492333,2021-11-26 20:54:52 UTC
798380,mainnet,251,108432000,108844083,412084,383498,28586,0.06936935187971384,2021-11-26 20:57:04 UTC
798382,mainnet,251,108432000,108844338,412339,383720,28619,0.06940648350022675,2021-11-26 20:59:37 UTC
798384,mainnet,251,108432000,108844537,412538,383898,28640,0.06942390761578328,2021-11-26 21:01:50 UTC
798385,mainnet,251,108432000,108844679,412680,384015,28665,0.06946059901134051,2021-11-26 21:04:06 UTC
798387,mainnet,251,108432000,108844880,412881,384170,28711,0.06953819623571925,2021-11-26 21:06:14 UTC
798388,mainnet,251,108432000,108845042,413043,384300,28743,0.06958839636551158,2021-11-26 21:08:27 UTC
798390,mainnet,251,108432000,108845251,413252,384485,28767,0.06961127834832015,2021-11-26 21:10:47 UTC
798391,mainnet,251,108432000,108845465,413466,384678,28788,0.06962603938413316,2021-11-26 21:12:57 UTC
798393,mainnet,251,108432000,108845687,413688,384884,28804,0.06962735201407824,2021-11-26 21:15:05 UTC
798394,mainnet,251,108432000,108845925,413926,385106,28820,0.06962597179205945,2021-11-26 21:17:24 UTC
798396,mainnet,251,108432000,108846135,414136,385296,28840,0.06963895918249077,2021-11-26 21:19:34 UTC
798397,mainnet,251,108432000,108846373,414374,385509,28865,0.06965929329542876,2021-11-26 21:21:48 UTC
798399,mainnet,251,108432000,108846595,414596,385715,28881,0.06966058524443072,2021-11-26 21:23:59 UTC
798400,mainnet,251,108432000,108846807,414808,385911,28897,0.06966355518697807,2021-11-26 21:26:08 UTC
798402,mainnet,251,108432000,108847072,415073,386153,28920,0.06967449099315061,2021-11-26 21:28:18 UTC
798403,mainnet,251,108432000,108847271,415272,386329,28943,0.06969648808491784,2021-11-26 21:30:26 UTC
798405,mainnet,251,108432000,108847526,415527,386566,28961,0.06969703533103745,2021-11-26 21:32:51 UTC
798406,mainnet,251,108432000,108847782,415783,386816,28967,0.06966855306734522,2021-11-26 21:35:17 UTC
798408,mainnet,251,108432000,108848008,416009,387030,28979,0.06965955063472185,2021-11-26 21:37:24 UTC
798409,mainnet,251,108432000,108848258,416259,387274,28985,0.06963212807410771,2021-11-26 21:39:47 UTC
798410,mainnet,251,108432000,108848498,416499,387504,28995,0.06961601348382589,2021-11-26 21:42:02 UTC
798411,mainnet,251,108432000,108848738,416739,387724,29015,0.06962391328865308,2021-11-26 21:44:11 UTC
798413,mainnet,251,108432000,108848997,416998,387959,29039,0.06963822368452606,2021-11-26 21:46:25 UTC
798415,mainnet,251,108432000,108849205,417206,388144,29062,0.06965863386432601,2021-11-26 21:48:34 UTC
798416,mainnet,251,108432000,108849472,417473,388381,29092,0.0696859437616325,2021-11-26 21:50:51 UTC
798417,mainnet,251,108432000,108849679,417680,388555,29125,0.06973041562918982,2021-11-26 21:53:03 UTC
798419,mainnet,251,108432000,108849915,417916,388776,29140,0.06972693077077691,2021-11-26 21:55:13 UTC
798420,mainnet,251,108432000,108850135,418136,388984,29152,0.06971894311898522,2021-11-26 21:57:21 UTC
798422,mainnet,251,108432000,108850351,418352,389187,29165,0.06971402072895552,2021-11-26 21:59:34 UTC
798423,mainnet,251,108432000,108850558,418559,389374,29185,0.06972732637453741,2021-11-26 22:01:51 UTC
798425,mainnet,251,108432000,108850751,418752,389542,29210,0.06975489072290998,2021-11-26 22:04:06 UTC
798426,mainnet,251,108432000,108850975,418976,389730,29246,0.06980352096540136,2021-11-26 22:06:18 UTC
798427,mainnet,251,108432000,108851178,419179,389927,29252,0.06978403021143711,2021-11-26 22:08:29 UTC
798429,mainnet,251,108432000,108851388,419389,390103,29286,0.06983015768177038,2021-11-26 22:10:34 UTC
798430,mainnet,251,108432000,108851635,419636,390323,29313,0.06985339675337673,2021-11-26 22:12:48 UTC
798431,mainnet,251,108432000,108851856,419857,390528,29329,0.06985473625543935,2021-11-26 22:14:59 UTC
798432,mainnet,251,108432000,108852094,420095,390743,29352,0.06986991037741463,2021-11-26 22:17:13 UTC
798434,mainnet,251,108432000,108852204,420205,390845,29360,0.06987065836912935,2021-11-26 22:19:19 UTC
798435,mainnet,251,108432000,108852569,420570,391132,29438,0.06999548232161115,2021-11-26 22:21:31 UTC
798437,mainnet,251,108432000,108852792,420793,391328,29465,0.07002255265653183,2021-11-26 22:23:37 UTC
798438,mainnet,251,108432000,108853013,421014,391523,29491,0.07004755186288342,2021-11-26 22:25:45 UTC
798440,mainnet,251,108432000,108853258,421259,391751,29508,0.07004716813171945,2021-11-26 22:27:55 UTC
798441,mainnet,251,108432000,108853489,421490,391969,29521,0.07003962134332961,2021-11-26 22:30:08 UTC
798443,mainnet,251,108432000,108853716,421717,392184,29533,0.07003037582075183,2021-11-26 22:32:25 UTC
798444,mainnet,251,108432000,108854012,422013,392471,29542,0.07000258285882188,2021-11-26 22:34:59 UTC
798446,mainnet,251,108432000,108854231,422232,392686,29546,0.06997574793004793,2021-11-26 22:37:12 UTC
798447,mainnet,251,108432000,108854461,422462,392908,29554,0.06995658781144813,2021-11-26 22:39:23 UTC
798449,mainnet,251,108432000,108854667,422668,393100,29568,0.06995561528197072,2021-11-26 22:41:53 UTC
798451,mainnet,251,108432000,108854910,422911,393322,29589,0.06996507539411366,2021-11-26 22:44:02 UTC
798452,mainnet,251,108432000,108855143,423144,393527,29617,0.06999272115402794,2021-11-26 22:46:09 UTC
798454,mainnet,251,108432000,108855354,423355,393725,29630,0.06998854389342278,2021-11-26 22:48:17 UTC
798455,mainnet,251,108432000,108855580,423581,393926,29655,0.07001022236597014,2021-11-26 22:50:27 UTC
798457,mainnet,251,108432000,108855836,423837,394163,29674,0.07001276434100845,2021-11-26 22:53:00 UTC
798458,mainnet,251,108432000,108856108,424109,394412,29697,0.07002209337693847,2021-11-26 22:55:28 UTC
798460,mainnet,251,108432000,108856335,424336,394637,29699,0.0699893480637985,2021-11-26 22:57:40 UTC
798461,mainnet,251,108432000,108856580,424581,394866,29715,0.06998664565771902,2021-11-26 22:59:49 UTC
798462,mainnet,251,108432000,108856789,424790,395060,29730,0.06998752324678076,2021-11-26 23:01:50 UTC
798463,mainnet,251,108432000,108857027,425028,395271,29757,0.07001185804229368,2021-11-26 23:04:03 UTC
798465,mainnet,251,108432000,108857249,425250,395479,29771,0.0700082304526749,2021-11-26 23:06:11 UTC
798466,mainnet,251,108432000,108857512,425513,395725,29788,0.07000491171832587,2021-11-26 23:08:35 UTC
798468,mainnet,251,108432000,108857764,425765,395968,29797,0.06998461592662619,2021-11-26 23:10:47 UTC
798469,mainnet,251,108432000,108858003,426004,396188,29816,0.06998995314597985,2021-11-26 23:13:00 UTC
798470,mainnet,251,108432000,108858254,426255,396434,29821,0.06996046967191001,2021-11-26 23:15:11 UTC
798472,mainnet,251,108432000,108858495,426496,396650,29846,0.06997955432172868,2021-11-26 23:17:22 UTC
798473,mainnet,251,108432000,108858731,426732,396877,29855,0.06996194332742799,2021-11-26 23:19:29 UTC
798475,mainnet,251,108432000,108858963,426964,397101,29863,0.06994266495535924,2021-11-26 23:21:40 UTC
798476,mainnet,251,108432000,108859200,427201,397321,29880,0.06994365649893142,2021-11-26 23:23:52 UTC
798478,mainnet,251,108432000,108859425,427426,397520,29906,0.06996766691778226,2021-11-26 23:26:02 UTC
798479,mainnet,251,108432000,108859653,427654,397726,29928,0.06998180772306584,2021-11-26 23:28:11 UTC
798481,mainnet,251,108432000,108859893,427894,397946,29948,0.06998929641453257,2021-11-26 23:30:24 UTC
798482,mainnet,251,108432000,108860133,428134,398157,29977,0.07001779816599475,2021-11-26 23:32:51 UTC
798484,mainnet,251,108432000,108860347,428348,398350,29998,0.07003184326762352,2021-11-26 23:35:04 UTC
798485,mainnet,251,108432000,108860583,428584,398555,30029,0.070065611408732,2021-11-26 23:37:14 UTC
798487,mainnet,251,108432000,108860808,428809,398772,30037,0.07004750366713385,2021-11-26 23:39:24 UTC
798488,mainnet,251,108432000,108861020,429021,398977,30044,0.07002920602954167,2021-11-26 23:41:29 UTC
798490,mainnet,251,108432000,108861247,429248,399196,30052,0.07001080960190845,2021-11-26 23:43:41 UTC
798491,mainnet,251,108432000,108861461,429462,399387,30075,0.07002947874317168,2021-11-26 23:45:55 UTC
798493,mainnet,251,108432000,108861587,429588,399504,30084,0.07002988910304757,2021-11-26 23:48:08 UTC
798494,mainnet,251,108432000,108861893,429894,399764,30130,0.07008704471334794,2021-11-26 23:50:15 UTC
798496,mainnet,251,108432000,108862104,430105,399944,30161,0.07012473698282977,2021-11-26 23:52:20 UTC
798497,mainnet,251,108432000,108862357,430358,400186,30172,0.07010907198193132,2021-11-26 23:54:38 UTC
798499,mainnet,251,108432000,108862577,430578,400382,30196,0.0701289894049394,2021-11-26 23:56:51 UTC
798500,mainnet,251,108432000,108862726,430727,400509,30218,0.070155806346015,2021-11-26 23:58:58 UTC
798502,mainnet,251,108432000,108863044,431045,400791,30254,0.07018756742335487,2021-11-27 00:01:16 UTC
798503,mainnet,251,108432000,108863283,431284,401005,30279,0.07020663878094249,2021-11-27 00:03:33 UTC
798505,mainnet,251,108432000,108863498,431499,401210,30289,0.07019483243298362,2021-11-27 00:05:43 UTC
798506,mainnet,251,108432000,108863738,431739,401429,30310,0.07020445222692413,2021-11-27 00:07:56 UTC
798508,mainnet,251,108432000,108863950,431951,401635,30316,0.07018388659824841,2021-11-27 00:10:09 UTC
798510,mainnet,251,108432000,108863950,431951,401635,30316,0.07018388659824841,2021-11-27 00:12:23 UTC
798513,mainnet,252,108864000,108865089,1090,827,263,0.24128440366972478,2021-11-27 00:23:12 UTC
798515,mainnet,252,108864000,108865288,1289,1010,279,0.21644685802948022,2021-11-27 00:25:02 UTC
798516,mainnet,252,108864000,108865480,1481,1186,295,0.19918973666441595,2021-11-27 00:26:57 UTC
798518,mainnet,252,108864000,108865672,1673,1366,307,0.1835026897788404,2021-11-27 00:28:53 UTC
798519,mainnet,252,108864000,108865853,1854,1534,320,0.1725997842502697,2021-11-27 00:30:45 UTC
798521,mainnet,252,108864000,108866058,2059,1715,344,0.16707139388052453,2021-11-27 00:32:39 UTC
798522,mainnet,252,108864000,108866272,2273,1914,359,0.15794104707435108,2021-11-27 00:34:33 UTC
798523,mainnet,252,108864000,108866488,2489,2121,368,0.1478505423865006,2021-11-27 00:36:36 UTC
798525,mainnet,252,108864000,108866772,2773,2385,388,0.139920663541291,2021-11-27 00:39:05 UTC
798526,mainnet,252,108864000,108866969,2970,2566,404,0.13602693602693602,2021-11-27 00:41:03 UTC
798528,mainnet,252,108864000,108867145,3146,2733,413,0.13127781309599493,2021-11-27 00:43:12 UTC
798529,mainnet,252,108864000,108867439,3440,3001,439,0.12761627906976744,2021-11-27 00:45:28 UTC
798531,mainnet,252,108864000,108867668,3669,3229,440,0.11992368492777324,2021-11-27 00:47:39 UTC
798532,mainnet,252,108864000,108867884,3885,3438,447,0.11505791505791506,2021-11-27 00:49:44 UTC
798534,mainnet,252,108864000,108868120,4121,3637,484,0.11744722154816792,2021-11-27 00:51:50 UTC
798535,mainnet,252,108864000,108868347,4348,3842,506,0.11637534498620056,2021-11-27 00:54:04 UTC
798537,mainnet,252,108864000,108868571,4572,4034,538,0.11767279090113736,2021-11-27 00:56:08 UTC
798538,mainnet,252,108864000,108868801,4802,4257,545,0.11349437734277384,2021-11-27 00:58:13 UTC
798540,mainnet,252,108864000,108869058,5059,4503,556,0.10990314291361929,2021-11-27 01:00:26 UTC
798541,mainnet,252,108864000,108869301,5302,4741,561,0.10580912863070539,2021-11-27 01:02:49 UTC
798543,mainnet,252,108864000,108869563,5564,4994,570,0.10244428468727534,2021-11-27 01:05:05 UTC
798544,mainnet,252,108864000,108869827,5828,5233,595,0.10209334248455731,2021-11-27 01:07:33 UTC
798546,mainnet,252,108864000,108870052,6053,5455,598,0.09879398645299851,2021-11-27 01:09:47 UTC
798547,mainnet,252,108864000,108870277,6278,5659,619,0.09859827970691303,2021-11-27 01:11:52 UTC
798549,mainnet,252,108864000,108870473,6474,5840,634,0.09793018226753167,2021-11-27 01:14:00 UTC
798550,mainnet,252,108864000,108870768,6769,6105,664,0.09809425321317772,2021-11-27 01:16:37 UTC
798551,mainnet,252,108864000,108871025,7026,6348,678,0.09649871904355252,2021-11-27 01:19:01 UTC
798552,mainnet,252,108864000,108871251,7252,6567,685,0.09445670159955874,2021-11-27 01:21:04 UTC
798554,mainnet,252,108864000,108871484,7485,6785,700,0.09352037408149633,2021-11-27 01:23:11 UTC
798555,mainnet,252,108864000,108871718,7719,7017,702,0.09094442285270113,2021-11-27 01:25:19 UTC
798557,mainnet,252,108864000,108871940,7941,7232,709,0.0892834655584939,2021-11-27 01:27:28 UTC
798558,mainnet,252,108864000,108872144,8145,7425,720,0.08839779005524862,2021-11-27 01:29:33 UTC
798559,mainnet,252,108864000,108872364,8365,7632,733,0.08762701733413031,2021-11-27 01:31:35 UTC
798561,mainnet,252,108864000,108872565,8566,7827,739,0.08627130515993463,2021-11-27 01:33:30 UTC
798562,mainnet,252,108864000,108872790,8791,8029,762,0.08667955863951769,2021-11-27 01:35:38 UTC
798564,mainnet,252,108864000,108873021,9022,8246,776,0.08601197073819553,2021-11-27 01:37:41 UTC
798565,mainnet,252,108864000,108873247,9248,8467,781,0.08445069204152249,2021-11-27 01:39:52 UTC
798567,mainnet,252,108864000,108873463,9464,8663,801,0.08463651732882502,2021-11-27 01:41:53 UTC
798568,mainnet,252,108864000,108873733,9734,8927,807,0.08290528046024245,2021-11-27 01:44:22 UTC
798570,mainnet,252,108864000,108873946,9947,9122,825,0.08293957977279581,2021-11-27 01:46:24 UTC
798571,mainnet,252,108864000,108874201,10202,9366,836,0.08194471672221133,2021-11-27 01:48:46 UTC
798572,mainnet,252,108864000,108874444,10445,9587,858,0.08214456677836285,2021-11-27 01:51:01 UTC
798574,mainnet,252,108864000,108874791,10792,9915,877,0.08126389918458117,2021-11-27 01:54:12 UTC
798575,mainnet,252,108864000,108875036,11037,10139,898,0.08136268913654073,2021-11-27 01:56:26 UTC
798577,mainnet,252,108864000,108875293,11294,10380,914,0.08092792633256596,2021-11-27 01:58:37 UTC
798578,mainnet,252,108864000,108875561,11562,10635,927,0.08017644006227297,2021-11-27 02:01:05 UTC
798580,mainnet,252,108864000,108875800,11801,10864,937,0.07940005084314888,2021-11-27 02:03:24 UTC
798582,mainnet,252,108864000,108876033,12034,11088,946,0.07861060329067641,2021-11-27 02:05:33 UTC
798583,mainnet,252,108864000,108876267,12268,11293,975,0.07947505705901532,2021-11-27 02:07:44 UTC
798584,mainnet,252,108864000,108876481,12482,11490,992,0.07947444319820542,2021-11-27 02:09:44 UTC
798586,mainnet,252,108864000,108876728,12729,11730,999,0.07848220598633043,2021-11-27 02:12:03 UTC
798588,mainnet,252,108864000,108876993,12994,11974,1020,0.07849776820070802,2021-11-27 02:14:22 UTC
798589,mainnet,252,108864000,108877241,13242,12214,1028,0.07763177767708805,2021-11-27 02:16:43 UTC
798591,mainnet,252,108864000,108877506,13507,12466,1041,0.07707114829347746,2021-11-27 02:19:15 UTC
798592,mainnet,252,108864000,108877744,13745,12690,1055,0.07675518370316478,2021-11-27 02:21:29 UTC
798593,mainnet,252,108864000,108877967,13968,12897,1071,0.07667525773195877,2021-11-27 02:23:44 UTC
798595,mainnet,252,108864000,108878269,14270,13186,1084,0.0759635599159075,2021-11-27 02:26:12 UTC
798596,mainnet,252,108864000,108878543,14544,13453,1091,0.07501375137513751,2021-11-27 02:28:50 UTC
798598,mainnet,252,108864000,108878780,14781,13674,1107,0.07489344428658413,2021-11-27 02:31:08 UTC
798599,mainnet,252,108864000,108879002,15003,13873,1130,0.07531826967939745,2021-11-27 02:33:20 UTC
798601,mainnet,252,108864000,108879255,15256,14104,1152,0.07551127425275302,2021-11-27 02:35:37 UTC
798602,mainnet,252,108864000,108879489,15490,14332,1158,0.07475790832795352,2021-11-27 02:37:47 UTC
798604,mainnet,252,108864000,108879771,15772,14598,1174,0.07443570885112859,2021-11-27 02:40:13 UTC
798606,mainnet,252,108864000,108880017,16018,14824,1194,0.07454114121613185,2021-11-27 02:42:34 UTC
798607,mainnet,252,108864000,108880326,16327,15123,1204,0.0737428798922031,2021-11-27 02:45:17 UTC
798609,mainnet,252,108864000,108880569,16570,15343,1227,0.07404948702474351,2021-11-27 02:47:31 UTC
798610,mainnet,252,108864000,108880827,16828,15583,1245,0.0739838364630378,2021-11-27 02:49:58 UTC
798612,mainnet,252,108864000,108881059,17060,15799,1261,0.073915592028136,2021-11-27 02:52:08 UTC
798613,mainnet,252,108864000,108881335,17336,16072,1264,0.07291185971389016,2021-11-27 02:54:43 UTC
798615,mainnet,252,108864000,108881625,17626,16350,1276,0.07239305571315102,2021-11-27 02:57:20 UTC
798616,mainnet,252,108864000,108881862,17863,16578,1285,0.07193640485920617,2021-11-27 02:59:25 UTC
798618,mainnet,252,108864000,108882090,18091,16793,1298,0.0717483831739539,2021-11-27 03:01:32 UTC
798620,mainnet,252,108864000,108882345,18346,17020,1326,0.07227733565899924,2021-11-27 03:03:49 UTC
798621,mainnet,252,108864000,108882626,18627,17286,1341,0.07199226928651957,2021-11-27 03:06:25 UTC
798623,mainnet,252,108864000,108882898,18899,17552,1347,0.07127361236044236,2021-11-27 03:08:55 UTC
798624,mainnet,252,108864000,108883145,19146,17772,1374,0.07176433719837041,2021-11-27 03:11:06 UTC
798626,mainnet,252,108864000,108883394,19395,18005,1390,0.07166795565867491,2021-11-27 03:13:22 UTC
798627,mainnet,252,108864000,108883640,19641,18228,1413,0.07194134718191537,2021-11-27 03:15:44 UTC
798629,mainnet,252,108864000,108883852,19853,18431,1422,0.07162645444013499,2021-11-27 03:17:56 UTC
798630,mainnet,252,108864000,108884172,20173,18724,1449,0.07182868190155157,2021-11-27 03:20:40 UTC
798632,mainnet,252,108864000,108884440,20441,18981,1460,0.0714250770510249,2021-11-27 03:22:54 UTC
798634,mainnet,252,108864000,108884693,20694,19209,1485,0.07175993041461293,2021-11-27 03:25:16 UTC
798635,mainnet,252,108864000,108884940,20941,19451,1490,0.07115228499116566,2021-11-27 03:27:37 UTC
798637,mainnet,252,108864000,108885130,21131,19631,1500,0.07098575552505797,2021-11-27 03:29:48 UTC
798638,mainnet,252,108864000,108885486,21487,19952,1535,0.0714385442360497,2021-11-27 03:32:27 UTC
798640,mainnet,252,108864000,108885731,21732,20176,1556,0.07159948463095896,2021-11-27 03:34:45 UTC
798641,mainnet,252,108864000,108885986,21987,20420,1567,0.07126938645563287,2021-11-27 03:37:06 UTC
798643,mainnet,252,108864000,108886229,22230,20646,1584,0.07125506072874493,2021-11-27 03:39:16 UTC
798644,mainnet,252,108864000,108886482,22483,20880,1603,0.07129831428190188,2021-11-27 03:41:33 UTC
798646,mainnet,252,108864000,108886799,22800,21191,1609,0.07057017543859649,2021-11-27 03:44:24 UTC
798647,mainnet,252,108864000,108887027,23028,21410,1618,0.07026228938683342,2021-11-27 03:46:37 UTC
798649,mainnet,252,108864000,108887250,23251,21604,1647,0.07083566298223733,2021-11-27 03:48:50 UTC
798650,mainnet,252,108864000,108887491,23492,21828,1664,0.07083262387195641,2021-11-27 03:51:05 UTC
798652,mainnet,252,108864000,108887762,23763,22082,1681,0.07074022640239028,2021-11-27 03:53:29 UTC
798654,mainnet,252,108864000,108888075,24076,22379,1697,0.0704851304203356,2021-11-27 03:56:17 UTC
798655,mainnet,252,108864000,108888333,24334,22632,1702,0.06994328922495274,2021-11-27 03:58:31 UTC
798657,mainnet,252,108864000,108888622,24623,22886,1737,0.07054380051171669,2021-11-27 04:01:07 UTC
798658,mainnet,252,108864000,108888870,24871,23117,1754,0.0705239033412408,2021-11-27 04:03:20 UTC
798660,mainnet,252,108864000,108889144,25145,23376,1769,0.07035195863988865,2021-11-27 04:05:40 UTC
798661,mainnet,252,108864000,108889418,25419,23639,1780,0.07002635823596522,2021-11-27 04:08:01 UTC
798663,mainnet,252,108864000,108889698,25699,23897,1802,0.07011945990116347,2021-11-27 04:10:21 UTC
798664,mainnet,252,108864000,108889983,25984,24172,1812,0.06973522167487685,2021-11-27 04:12:48 UTC
798666,mainnet,252,108864000,108890248,26249,24419,1830,0.06971694159777515,2021-11-27 04:15:01 UTC
798668,mainnet,252,108864000,108890540,26541,24705,1836,0.06917599186164802,2021-11-27 04:17:36 UTC
798669,mainnet,252,108864000,108890798,26799,24958,1841,0.06869659315646107,2021-11-27 04:19:49 UTC
798671,mainnet,252,108864000,108891100,27101,25251,1850,0.06826316372089591,2021-11-27 04:22:25 UTC
798672,mainnet,252,108864000,108891356,27357,25493,1864,0.06813612603721168,2021-11-27 04:24:33 UTC
798674,mainnet,252,108864000,108891597,27598,25722,1876,0.06797594028552793,2021-11-27 04:26:41 UTC
798675,mainnet,252,108864000,108891829,27830,25934,1896,0.06812791951131872,2021-11-27 04:28:47 UTC
798677,mainnet,252,108864000,108892081,28082,26164,1918,0.06829997863400043,2021-11-27 04:30:52 UTC
798678,mainnet,252,108864000,108892324,28325,26387,1938,0.06842012356575464,2021-11-27 04:33:03 UTC
798679,mainnet,252,108864000,108892588,28589,26643,1946,0.06806813809507153,2021-11-27 04:35:19 UTC
798681,mainnet,252,108864000,108892837,28838,26879,1959,0.0679312018863999,2021-11-27 04:37:26 UTC
798682,mainnet,252,108864000,108893046,29047,27079,1968,0.06775226357283023,2021-11-27 04:39:37 UTC
798684,mainnet,252,108864000,108893277,29278,27281,1997,0.06820821094337044,2021-11-27 04:41:42 UTC
798685,mainnet,252,108864000,108893541,29542,27524,2018,0.0683095254214339,2021-11-27 04:43:53 UTC
798687,mainnet,252,108864000,108893772,29773,27742,2031,0.06821616901219225,2021-11-27 04:46:02 UTC
798688,mainnet,252,108864000,108894025,30026,27979,2047,0.06817424898421368,2021-11-27 04:48:13 UTC
798690,mainnet,252,108864000,108894254,30255,28199,2056,0.06795570980003306,2021-11-27 04:50:18 UTC
798691,mainnet,252,108864000,108894500,30501,28434,2067,0.0677682698927904,2021-11-27 04:52:28 UTC
798693,mainnet,252,108864000,108894768,30769,28698,2071,0.06730800481003607,2021-11-27 04:54:37 UTC
798694,mainnet,252,108864000,108895034,31035,28964,2071,0.06673111003705494,2021-11-27 04:56:51 UTC
798696,mainnet,252,108864000,108895285,31286,29215,2071,0.06619574250463466,2021-11-27 04:58:54 UTC
798697,mainnet,252,108864000,108895525,31526,29437,2089,0.06626276723973863,2021-11-27 05:01:02 UTC
798698,mainnet,252,108864000,108895784,31785,29676,2109,0.06635205285512034,2021-11-27 05:03:13 UTC
798700,mainnet,252,108864000,108896019,32020,29905,2115,0.066052467207995,2021-11-27 05:05:21 UTC
798701,mainnet,252,108864000,108896250,32251,30133,2118,0.06567238225171312,2021-11-27 05:07:33 UTC
798703,mainnet,252,108864000,108896520,32521,30394,2127,0.06540389286922296,2021-11-27 05:09:59 UTC
798704,mainnet,252,108864000,108896792,32793,30653,2140,0.06525782941481413,2021-11-27 05:12:21 UTC
798706,mainnet,252,108864000,108897049,33050,30891,2159,0.06532526475037821,2021-11-27 05:14:33 UTC
798707,mainnet,252,108864000,108897346,33347,31185,2162,0.06483341829849762,2021-11-27 05:17:02 UTC
798708,mainnet,252,108864000,108897663,33664,31482,2182,0.06481701520912547,2021-11-27 05:19:34 UTC
798710,mainnet,252,108864000,108897953,33954,31758,2196,0.06467573776285562,2021-11-27 05:21:58 UTC
798711,mainnet,252,108864000,108898229,34230,32034,2196,0.06415425065731814,2021-11-27 05:24:14 UTC
798713,mainnet,252,108864000,108898534,34535,32328,2207,0.06390618213406689,2021-11-27 05:26:45 UTC
798714,mainnet,252,108864000,108898816,34817,32604,2213,0.06356090415601574,2021-11-27 05:29:03 UTC
798716,mainnet,252,108864000,108899090,35091,32877,2214,0.06309310079507566,2021-11-27 05:31:17 UTC
798717,mainnet,252,108864000,108899347,35348,33133,2215,0.0626626683263551,2021-11-27 05:33:27 UTC
798719,mainnet,252,108864000,108899619,35620,33396,2224,0.06243683323975295,2021-11-27 05:35:39 UTC
798720,mainnet,252,108864000,108899877,35878,33640,2238,0.06237805897764647,2021-11-27 05:37:50 UTC
798722,mainnet,252,108864000,108900138,36139,33889,2250,0.06225960873294779,2021-11-27 05:40:01 UTC
798723,mainnet,252,108864000,108900377,36378,34117,2261,0.06215294958491396,2021-11-27 05:42:09 UTC
798724,mainnet,252,108864000,108900636,36637,34366,2271,0.06198651636323935,2021-11-27 05:44:16 UTC
798725,mainnet,252,108864000,108900886,36887,34612,2275,0.06167484479626969,2021-11-27 05:46:25 UTC
798727,mainnet,252,108864000,108901142,37143,34852,2291,0.061680531997953855,2021-11-27 05:48:39 UTC
798728,mainnet,252,108864000,108901427,37428,35108,2320,0.06198567917067436,2021-11-27 05:51:19 UTC
798730,mainnet,252,108864000,108901804,37805,35473,2332,0.06168496230657321,2021-11-27 05:54:46 UTC
798732,mainnet,252,108864000,108902097,38098,35729,2369,0.06218174182371778,2021-11-27 05:57:05 UTC
798733,mainnet,252,108864000,108902377,38378,35951,2427,0.06323935588097347,2021-11-27 05:59:43 UTC
798735,mainnet,252,108864000,108902654,38655,36215,2440,0.0631224938559048,2021-11-27 06:02:02 UTC
798736,mainnet,252,108864000,108902896,38897,36450,2447,0.06290973596935497,2021-11-27 06:04:16 UTC
798738,mainnet,252,108864000,108903216,39217,36753,2464,0.06282989519851084,2021-11-27 06:07:04 UTC
798740,mainnet,252,108864000,108903462,39463,36991,2472,0.06264095481843752,2021-11-27 06:09:13 UTC
798741,mainnet,252,108864000,108903782,39783,37286,2497,0.0627655028529774,2021-11-27 06:11:59 UTC
798743,mainnet,252,108864000,108904064,40065,37557,2508,0.06259827779857731,2021-11-27 06:14:12 UTC
798744,mainnet,252,108864000,108904318,40319,37792,2527,0.06267516555470126,2021-11-27 06:16:18 UTC
798746,mainnet,252,108864000,108904560,40561,38019,2542,0.06267103868247824,2021-11-27 06:18:25 UTC
798747,mainnet,252,108864000,108904812,40813,38262,2551,0.06250459412442114,2021-11-27 06:20:35 UTC
798748,mainnet,252,108864000,108905079,41080,38517,2563,0.0623904576436222,2021-11-27 06:22:43 UTC
798750,mainnet,252,108864000,108905332,41333,38758,2575,0.062298889507173445,2021-11-27 06:24:59 UTC
798751,mainnet,252,108864000,108905600,41601,39010,2591,0.06228215667892599,2021-11-27 06:27:09 UTC
798753,mainnet,252,108864000,108905816,41817,39203,2614,0.06251046225219409,2021-11-27 06:29:17 UTC
798754,mainnet,252,108864000,108906068,42069,39431,2638,0.06270650597827379,2021-11-27 06:31:27 UTC
798756,mainnet,252,108864000,108906299,42300,39652,2648,0.06260047281323877,2021-11-27 06:33:35 UTC
798757,mainnet,252,108864000,108906578,42579,39914,2665,0.06258953944432702,2021-11-27 06:36:05 UTC
798759,mainnet,252,108864000,108906864,42865,40187,2678,0.0624752128776391,2021-11-27 06:38:35 UTC
798761,mainnet,252,108864000,108907124,43125,40429,2696,0.06251594202898551,2021-11-27 06:41:01 UTC
798762,mainnet,252,108864000,108907360,43361,40657,2704,0.06236018542007795,2021-11-27 06:43:17 UTC
798764,mainnet,252,108864000,108907680,43681,40971,2710,0.0620407041963325,2021-11-27 06:46:01 UTC
798765,mainnet,252,108864000,108907956,43957,41230,2727,0.062037900675660305,2021-11-27 06:48:21 UTC
798767,mainnet,252,108864000,108908222,44223,41491,2732,0.06177780792800126,2021-11-27 06:50:39 UTC
798768,mainnet,252,108864000,108908498,44499,41758,2741,0.06159688981774871,2021-11-27 06:52:58 UTC
798770,mainnet,252,108864000,108908797,44798,42043,2755,0.06149828117326667,2021-11-27 06:55:35 UTC
798771,mainnet,252,108864000,108909132,45133,42357,2776,0.06150710123413024,2021-11-27 06:58:34 UTC
798773,mainnet,252,108864000,108909389,45390,42596,2794,0.061555408680326065,2021-11-27 07:01:01 UTC
798775,mainnet,252,108864000,108909639,45640,42834,2806,0.06148115687992989,2021-11-27 07:03:30 UTC
798776,mainnet,252,108864000,108909920,45921,43095,2826,0.061540471679623704,2021-11-27 07:05:42 UTC
798778,mainnet,252,108864000,108910177,46178,43344,2834,0.06137121573043441,2021-11-27 07:07:58 UTC
798779,mainnet,252,108864000,108910380,46381,43531,2850,0.061447575515836225,2021-11-27 07:10:05 UTC
798780,mainnet,252,108864000,108910638,46639,43773,2866,0.0614507172109179,2021-11-27 07:12:14 UTC
798782,mainnet,252,108864000,108910895,46896,44022,2874,0.06128454452405322,2021-11-27 07:14:26 UTC
798783,mainnet,252,108864000,108911161,47162,44271,2891,0.061299351172554174,2021-11-27 07:16:39 UTC
798785,mainnet,252,108864000,108911417,47418,44509,2909,0.061348011303724324,2021-11-27 07:18:45 UTC
798786,mainnet,252,108864000,108911655,47656,44744,2912,0.06110458284371328,2021-11-27 07:20:55 UTC
798787,mainnet,252,108864000,108911924,47925,44987,2938,0.06130412102243088,2021-11-27 07:23:05 UTC
798789,mainnet,252,108864000,108912233,48234,45281,2953,0.06122237425882158,2021-11-27 07:25:35 UTC
798790,mainnet,252,108864000,108912437,48438,45471,2967,0.06125356125356125,2021-11-27 07:27:42 UTC
798791,mainnet,252,108864000,108912664,48665,45687,2978,0.061193876502619954,2021-11-27 07:29:50 UTC
798793,mainnet,252,108864000,108912906,48907,45909,2998,0.061300018402273705,2021-11-27 07:31:56 UTC
798794,mainnet,252,108864000,108913184,49185,46179,3006,0.06111619396157365,2021-11-27 07:34:27 UTC
798795,mainnet,252,108864000,108913451,49452,46431,3021,0.061089541373453043,2021-11-27 07:36:54 UTC
798797,mainnet,252,108864000,108913721,49722,46683,3039,0.06111982623386026,2021-11-27 07:39:08 UTC
798799,mainnet,252,108864000,108914016,50017,46962,3055,0.06107923306075934,2021-11-27 07:41:53 UTC
798800,mainnet,252,108864000,108914311,50312,47230,3082,0.06125775162982986,2021-11-27 07:44:19 UTC
798802,mainnet,252,108864000,108914608,50609,47505,3104,0.06133296449248157,2021-11-27 07:46:54 UTC
798803,mainnet,252,108864000,108914887,50888,47766,3122,0.06135041660116334,2021-11-27 07:49:23 UTC
798805,mainnet,252,108864000,108915182,51183,48047,3136,0.06127034366879628,2021-11-27 07:51:50 UTC
798806,mainnet,252,108864000,108915466,51467,48321,3146,0.06112654710785552,2021-11-27 07:54:12 UTC
798808,mainnet,252,108864000,108915768,51769,48618,3151,0.06086654175278642,2021-11-27 07:56:45 UTC
798810,mainnet,252,108864000,108916061,52062,48905,3157,0.06063923783181591,2021-11-27 07:59:20 UTC
798811,mainnet,252,108864000,108916312,52313,49154,3159,0.06038651960315791,2021-11-27 08:01:31 UTC
798813,mainnet,252,108864000,108916559,52560,49387,3173,0.06036910197869102,2021-11-27 08:03:44 UTC
798815,mainnet,252,108864000,108917062,53063,49846,3217,0.06062604828223055,2021-11-27 08:08:12 UTC
798816,mainnet,252,108864000,108917315,53316,50079,3237,0.06071348188161153,2021-11-27 08:10:24 UTC
798818,mainnet,252,108864000,108917558,53559,50297,3262,0.060904796579473106,2021-11-27 08:12:33 UTC
798819,mainnet,252,108864000,108917764,53765,50492,3273,0.06087603459499674,2021-11-27 08:14:43 UTC
798821,mainnet,252,108864000,108917999,54000,50708,3292,0.06096296296296296,2021-11-27 08:16:53 UTC
798822,mainnet,252,108864000,108918216,54217,50922,3295,0.0607742958850545,2021-11-27 08:19:01 UTC
798824,mainnet,252,108864000,108918466,54467,51166,3301,0.06060550425027999,2021-11-27 08:21:23 UTC
798825,mainnet,252,108864000,108918743,54744,51429,3315,0.060554581323980713,2021-11-27 08:23:55 UTC
798827,mainnet,252,108864000,108919032,55033,51693,3340,0.06069085821234532,2021-11-27 08:26:22 UTC
798828,mainnet,252,108864000,108919292,55293,51934,3359,0.060749100247770964,2021-11-27 08:28:57 UTC
798830,mainnet,252,108864000,108919556,55557,52177,3380,0.06083841820112677,2021-11-27 08:31:09 UTC
798831,mainnet,252,108864000,108919813,55814,52419,3395,0.06082703264413946,2021-11-27 08:33:34 UTC
798833,mainnet,252,108864000,108920068,56069,52664,3405,0.06072874493927125,2021-11-27 08:35:47 UTC
798834,mainnet,252,108864000,108920328,56329,52918,3411,0.0605549539313675,2021-11-27 08:38:05 UTC
798836,mainnet,252,108864000,108920591,56592,53156,3436,0.06071529544811988,2021-11-27 08:40:45 UTC
798837,mainnet,252,108864000,108920873,56874,53420,3454,0.0607307381228681,2021-11-27 08:43:06 UTC
798839,mainnet,252,108864000,108921119,57120,53649,3471,0.060766806722689075,2021-11-27 08:45:24 UTC
798840,mainnet,252,108864000,108921381,57382,53890,3492,0.0608553204837754,2021-11-27 08:47:47 UTC
798842,mainnet,252,108864000,108921616,57617,54117,3500,0.06074596039363382,2021-11-27 08:49:55 UTC
798843,mainnet,252,108864000,108921861,57862,54348,3514,0.06073070408903944,2021-11-27 08:52:08 UTC
798845,mainnet,252,108864000,108922122,58123,54604,3519,0.06054401871892366,2021-11-27 08:54:18 UTC
798846,mainnet,252,108864000,108922368,58369,54833,3536,0.06058010245164385,2021-11-27 08:56:30 UTC
798848,mainnet,252,108864000,108922624,58625,55076,3549,0.06053731343283582,2021-11-27 08:58:42 UTC
798849,mainnet,252,108864000,108922901,58902,55344,3558,0.06040541917082612,2021-11-27 09:01:00 UTC
798851,mainnet,252,108864000,108923209,59210,55613,3597,0.060749873332207396,2021-11-27 09:03:13 UTC
798852,mainnet,252,108864000,108923436,59437,55831,3606,0.06066928007806585,2021-11-27 09:05:21 UTC
798854,mainnet,252,108864000,108923668,59669,56032,3637,0.06095292362868491,2021-11-27 09:07:34 UTC
798855,mainnet,252,108864000,108923937,59938,56277,3661,0.061079782441856585,2021-11-27 09:09:48 UTC
798857,mainnet,252,108864000,108924193,60194,56519,3675,0.061052596604312726,2021-11-27 09:12:15 UTC
798859,mainnet,252,108864000,108924482,60483,56791,3692,0.06104194567068433,2021-11-27 09:14:39 UTC
798860,mainnet,252,108864000,108924740,60741,57019,3722,0.06127656772196704,2021-11-27 09:16:52 UTC
798862,mainnet,252,108864000,108925121,61122,57382,3740,0.061189097215405254,2021-11-27 09:20:18 UTC
798863,mainnet,252,108864000,108925369,61370,57613,3757,0.061218836565096954,2021-11-27 09:22:40 UTC
798865,mainnet,252,108864000,108925613,61614,57840,3774,0.06125231278605512,2021-11-27 09:24:55 UTC
798866,mainnet,252,108864000,108925941,61942,58155,3787,0.061137838623228184,2021-11-27 09:27:44 UTC
798868,mainnet,252,108864000,108926184,62185,58378,3807,0.06122055157996301,2021-11-27 09:30:03 UTC
798869,mainnet,252,108864000,108926436,62437,58618,3819,0.061165654980220065,2021-11-27 09:32:23 UTC
798871,mainnet,252,108864000,108926696,62697,58861,3836,0.06118315070896534,2021-11-27 09:34:34 UTC
798872,mainnet,252,108864000,108926907,62908,59071,3837,0.06099383226298722,2021-11-27 09:36:42 UTC
798873,mainnet,252,108864000,108927179,63180,59309,3871,0.061269389047166826,2021-11-27 09:38:58 UTC
798875,mainnet,252,108864000,108927424,63425,59545,3880,0.06117461568782026,2021-11-27 09:41:09 UTC
798876,mainnet,252,108864000,108927677,63678,59788,3890,0.061088602028958196,2021-11-27 09:43:17 UTC
798877,mainnet,252,108864000,108927928,63929,60030,3899,0.06098953526568537,2021-11-27 09:45:26 UTC
798879,mainnet,252,108864000,108928137,64138,60227,3911,0.060977891421622125,2021-11-27 09:47:30 UTC
798880,mainnet,252,108864000,108928385,64386,60457,3929,0.061022582549001336,2021-11-27 09:49:37 UTC
798882,mainnet,252,108864000,108928619,64620,60687,3933,0.06086350974930362,2021-11-27 09:51:45 UTC
798883,mainnet,252,108864000,108928862,64863,60913,3950,0.060897584138877324,2021-11-27 09:53:57 UTC
798885,mainnet,252,108864000,108929132,65133,61177,3956,0.06073726068198916,2021-11-27 09:56:14 UTC
798886,mainnet,252,108864000,108929381,65382,61402,3980,0.06087302315622037,2021-11-27 09:58:21 UTC
798887,mainnet,252,108864000,108929633,65634,61641,3993,0.06083737087485145,2021-11-27 10:00:36 UTC
798889,mainnet,252,108864000,108929908,65909,61892,4017,0.06094767027264865,2021-11-27 10:02:51 UTC
798890,mainnet,252,108864000,108930131,66132,62108,4024,0.06084800096776145,2021-11-27 10:05:00 UTC
798892,mainnet,252,108864000,108930355,66356,62317,4039,0.06086864789921032,2021-11-27 10:07:09 UTC
798893,mainnet,252,108864000,108930614,66615,62559,4056,0.060887187570367034,2021-11-27 10:09:21 UTC
798895,mainnet,252,108864000,108930849,66850,62776,4074,0.06094240837696335,2021-11-27 10:11:30 UTC
798896,mainnet,252,108864000,108931099,67100,63017,4083,0.060849478390461995,2021-11-27 10:13:43 UTC
798898,mainnet,252,108864000,108931354,67355,63256,4099,0.0608566550367456,2021-11-27 10:15:58 UTC
798899,mainnet,252,108864000,108931576,67577,63476,4101,0.060686328188584875,2021-11-27 10:18:04 UTC
798901,mainnet,252,108864000,108931820,67821,63692,4129,0.06088084811489067,2021-11-27 10:20:14 UTC
798902,mainnet,252,108864000,108932074,68075,63937,4138,0.06078589790672053,2021-11-27 10:22:25 UTC
798904,mainnet,252,108864000,108932329,68330,64181,4149,0.06072003512366457,2021-11-27 10:24:37 UTC
798905,mainnet,252,108864000,108932607,68608,64442,4166,0.060721781716417914,2021-11-27 10:26:59 UTC
798907,mainnet,252,108864000,108932908,68909,64720,4189,0.060790317665326735,2021-11-27 10:29:38 UTC
798908,mainnet,252,108864000,108933139,69140,64944,4196,0.060688458200752096,2021-11-27 10:31:49 UTC
798910,mainnet,252,108864000,108933421,69422,65215,4207,0.060600386044769666,2021-11-27 10:34:11 UTC
798911,mainnet,252,108864000,108933644,69645,65428,4217,0.06054993179697035,2021-11-27 10:36:33 UTC
798913,mainnet,252,108864000,108933893,69894,65653,4241,0.06067759750479297,2021-11-27 10:39:00 UTC
798914,mainnet,252,108864000,108934213,70214,65929,4285,0.06102771527045888,2021-11-27 10:41:19 UTC
798916,mainnet,252,108864000,108934519,70520,66222,4298,0.0609472490073738,2021-11-27 10:43:59 UTC
798918,mainnet,252,108864000,108934814,70815,66493,4322,0.06103226717503354,2021-11-27 10:46:30 UTC
798919,mainnet,252,108864000,108935105,71106,66769,4337,0.06099344640396028,2021-11-27 10:49:09 UTC
798921,mainnet,252,108864000,108935352,71353,67001,4352,0.06099253009684246,2021-11-27 10:51:19 UTC
798922,mainnet,252,108864000,108935608,71609,67247,4362,0.06091413090533313,2021-11-27 10:53:29 UTC
798924,mainnet,252,108864000,108935861,71862,67483,4379,0.060936238902340595,2021-11-27 10:55:40 UTC
798925,mainnet,252,108864000,108936103,72104,67710,4394,0.06093975368911572,2021-11-27 10:57:55 UTC
798927,mainnet,252,108864000,108936343,72344,67939,4405,0.06088963839433816,2021-11-27 11:00:10 UTC
798928,mainnet,252,108864000,108936602,72603,68187,4416,0.0608239328953349,2021-11-27 11:02:32 UTC
798930,mainnet,252,108864000,108936860,72861,68432,4429,0.06078697794430491,2021-11-27 11:04:47 UTC
798931,mainnet,252,108864000,108937108,73109,68658,4451,0.060881697191864204,2021-11-27 11:07:06 UTC
798933,mainnet,252,108864000,108937414,73415,68951,4464,0.06080501259960498,2021-11-27 11:09:45 UTC
798934,mainnet,252,108864000,108937670,73671,69201,4470,0.060675163904385716,2021-11-27 11:12:01 UTC
798936,mainnet,252,108864000,108937956,73957,69475,4482,0.060602782698054275,2021-11-27 11:14:32 UTC
798937,mainnet,252,108864000,108938238,74239,69747,4492,0.06050728053987796,2021-11-27 11:17:04 UTC
798939,mainnet,252,108864000,108938523,74524,70008,4516,0.060597928184209116,2021-11-27 11:19:26 UTC
798941,mainnet,252,108864000,108938774,74775,70253,4522,0.060474757606151786,2021-11-27 11:21:42 UTC
798942,mainnet,252,108864000,108939073,75074,70527,4547,0.060566907318112796,2021-11-27 11:24:21 UTC
798944,mainnet,252,108864000,108939343,75344,70783,4561,0.060535676364408576,2021-11-27 11:26:32 UTC
798945,mainnet,252,108864000,108939592,75593,71018,4575,0.06052147685632268,2021-11-27 11:28:43 UTC
798947,mainnet,252,108864000,108939810,75811,71231,4580,0.06041339647280738,2021-11-27 11:30:51 UTC
798948,mainnet,252,108864000,108940104,76105,71505,4600,0.06044280927665725,2021-11-27 11:33:14 UTC
798950,mainnet,252,108864000,108940321,76322,71715,4607,0.06036267393412122,2021-11-27 11:35:24 UTC
798951,mainnet,252,108864000,108940616,76617,71971,4646,0.06063928370988162,2021-11-27 11:38:00 UTC
798953,mainnet,252,108864000,108940887,76888,72214,4674,0.06078972011237124,2021-11-27 11:40:13 UTC
798954,mainnet,252,108864000,108941176,77177,72489,4688,0.06074348575352761,2021-11-27 11:42:54 UTC
798956,mainnet,252,108864000,108941517,77518,72811,4707,0.06072138084057896,2021-11-27 11:45:51 UTC
798958,mainnet,252,108864000,108941755,77756,73040,4716,0.06065126806934513,2021-11-27 11:48:07 UTC
798959,mainnet,252,108864000,108942023,78024,73290,4734,0.06067363888034451,2021-11-27 11:50:24 UTC
798961,mainnet,252,108864000,108942320,78321,73565,4756,0.060724454488579056,2021-11-27 11:53:02 UTC
798962,mainnet,252,108864000,108942608,78609,73834,4775,0.06074368074902365,2021-11-27 11:55:32 UTC
798964,mainnet,252,108864000,108942892,78893,74100,4793,0.06075317201779626,2021-11-27 11:57:55 UTC
798965,mainnet,252,108864000,108943137,79138,74331,4807,0.06074199499608279,2021-11-27 12:00:10 UTC
798967,mainnet,252,108864000,108943388,79389,74565,4824,0.06076408570456864,2021-11-27 12:02:20 UTC
798968,mainnet,252,108864000,108943643,79644,74809,4835,0.06070764903822008,2021-11-27 12:04:26 UTC
798969,mainnet,252,108864000,108943850,79851,75014,4837,0.06057532153636147,2021-11-27 12:06:35 UTC
798971,mainnet,252,108864000,108944101,80102,75237,4865,0.060735062794936456,2021-11-27 12:08:44 UTC
798972,mainnet,252,108864000,108944385,80386,75500,4886,0.06078172816162018,2021-11-27 12:11:05 UTC
798974,mainnet,252,108864000,108944621,80622,75726,4896,0.06072784103594552,2021-11-27 12:13:21 UTC
798975,mainnet,252,108864000,108944843,80844,75932,4912,0.06075899262777695,2021-11-27 12:15:28 UTC
798976,mainnet,252,108864000,108945096,81097,76162,4935,0.06085305251735576,2021-11-27 12:17:42 UTC
798978,mainnet,252,108864000,108945335,81336,76390,4946,0.060809481656339134,2021-11-27 12:19:52 UTC
798979,mainnet,252,108864000,108945564,81565,76596,4969,0.06092073806166861,2021-11-27 12:22:09 UTC
798981,mainnet,252,108864000,108945900,81901,76892,5009,0.061159204405318614,2021-11-27 12:24:43 UTC
798982,mainnet,252,108864000,108946156,82157,77144,5013,0.061017320496123274,2021-11-27 12:27:02 UTC
798984,mainnet,252,108864000,108946391,82392,77370,5022,0.06095251966210312,2021-11-27 12:29:13 UTC
798985,mainnet,252,108864000,108946678,82679,77644,5035,0.06089817245007801,2021-11-27 12:31:32 UTC
798987,mainnet,252,108864000,108946934,82935,77890,5045,0.060830771085790075,2021-11-27 12:33:47 UTC
798988,mainnet,252,108864000,108947194,83195,78146,5049,0.060688743313901075,2021-11-27 12:36:09 UTC
798990,mainnet,252,108864000,108947443,83444,78392,5052,0.060543598101720913,2021-11-27 12:38:31 UTC
798991,mainnet,252,108864000,108947696,83697,78633,5064,0.06050396071543783,2021-11-27 12:40:50 UTC
798993,mainnet,252,108864000,108947970,83971,78898,5073,0.060413714258494004,2021-11-27 12:43:07 UTC
798994,mainnet,252,108864000,108948223,84224,79144,5080,0.06031534954407295,2021-11-27 12:45:20 UTC
798996,mainnet,252,108864000,108948486,84487,79391,5096,0.06031697184182182,2021-11-27 12:47:45 UTC
798997,mainnet,252,108864000,108948735,84736,79629,5107,0.060269543051359516,2021-11-27 12:50:18 UTC
798999,mainnet,252,108864000,108949020,85021,79883,5138,0.060432128532950685,2021-11-27 12:52:35 UTC
799000,mainnet,252,108864000,108949296,85297,80138,5159,0.06048278368524098,2021-11-27 12:54:51 UTC
799002,mainnet,252,108864000,108949586,85587,80409,5178,0.06049984226576466,2021-11-27 12:57:11 UTC
799003,mainnet,252,108864000,108949858,85859,80674,5185,0.06038970870846388,2021-11-27 12:59:38 UTC
799004,mainnet,252,108864000,108950113,86114,80893,5221,0.060628933738997144,2021-11-27 13:02:07 UTC
799006,mainnet,252,108864000,108950372,86373,81129,5244,0.060713417387378,2021-11-27 13:04:22 UTC
799007,mainnet,252,108864000,108950611,86612,81367,5245,0.06055742853184316,2021-11-27 13:06:32 UTC
799008,mainnet,252,108864000,108950872,86873,81595,5278,0.06075535551897598,2021-11-27 13:08:51 UTC
799010,mainnet,252,108864000,108951182,87183,81877,5306,0.06086048885677254,2021-11-27 13:11:37 UTC
799011,mainnet,252,108864000,108951442,87443,82102,5341,0.06107978911976945,2021-11-27 13:13:54 UTC
799013,mainnet,252,108864000,108951773,87774,82418,5356,0.061020347711167315,2021-11-27 13:16:55 UTC
799014,mainnet,252,108864000,108952008,88009,82636,5373,0.061050574373075484,2021-11-27 13:19:19 UTC
799016,mainnet,252,108864000,108952284,88285,82890,5395,0.06110890864812822,2021-11-27 13:21:57 UTC
799017,mainnet,252,108864000,108952565,88566,83157,5409,0.061073098028588846,2021-11-27 13:24:27 UTC
799019,mainnet,252,108864000,108952855,88856,83436,5420,0.06099756910056721,2021-11-27 13:26:59 UTC
799020,mainnet,252,108864000,108953181,89182,83745,5437,0.06096521719629522,2021-11-27 13:29:45 UTC
799021,mainnet,252,108864000,108953485,89486,84036,5450,0.060903381534541716,2021-11-27 13:32:17 UTC
799023,mainnet,252,108864000,108953783,89784,84307,5477,0.06100196026017999,2021-11-27 13:35:02 UTC
799024,mainnet,252,108864000,108954010,90011,84527,5484,0.06092588683605337,2021-11-27 13:37:14 UTC
799026,mainnet,252,108864000,108954297,90298,84789,5509,0.0610091031916543,2021-11-27 13:39:39 UTC
799027,mainnet,252,108864000,108954523,90524,84997,5527,0.06105563165569352,2021-11-27 13:41:54 UTC
799029,mainnet,252,108864000,108954796,90797,85266,5531,0.06091610956309129,2021-11-27 13:44:16 UTC
799030,mainnet,252,108864000,108955070,91071,85517,5554,0.06098538502926288,2021-11-27 13:46:46 UTC
799032,mainnet,252,108864000,108955316,91317,85745,5572,0.0610182112859599,2021-11-27 13:48:59 UTC
799033,mainnet,252,108864000,108955594,91595,86014,5581,0.06093127354113216,2021-11-27 13:51:26 UTC
799034,mainnet,252,108864000,108955924,91925,86328,5597,0.06088659233070438,2021-11-27 13:54:16 UTC
799036,mainnet,252,108864000,108956176,92177,86578,5599,0.060741833646137326,2021-11-27 13:56:30 UTC
799037,mainnet,252,108864000,108956424,92425,86812,5613,0.06073032188260752,2021-11-27 13:58:36 UTC
799039,mainnet,252,108864000,108956675,92676,87047,5629,0.06073848677111658,2021-11-27 14:00:54 UTC
799040,mainnet,252,108864000,108956947,92948,87291,5657,0.060861987347764344,2021-11-27 14:03:06 UTC
799042,mainnet,252,108864000,108957192,93193,87519,5674,0.0608844011889305,2021-11-27 14:05:16 UTC
799043,mainnet,252,108864000,108957405,93406,87714,5692,0.06093826949018264,2021-11-27 14:07:25 UTC
799045,mainnet,252,108864000,108957653,93654,87939,5715,0.06102248702671536,2021-11-27 14:09:31 UTC
799046,mainnet,252,108864000,108957905,93906,88174,5732,0.06103976316742274,2021-11-27 14:11:43 UTC
799048,mainnet,252,108864000,108958162,94163,88413,5750,0.06106432462856961,2021-11-27 14:13:53 UTC
799049,mainnet,252,108864000,108958458,94459,88697,5762,0.06100001058660371,2021-11-27 14:16:31 UTC
799051,mainnet,252,108864000,108958669,94670,88898,5772,0.06096968416605049,2021-11-27 14:18:49 UTC
799052,mainnet,252,108864000,108958951,94952,89146,5806,0.061146684640660545,2021-11-27 14:21:13 UTC
799054,mainnet,252,108864000,108959228,95229,89407,5822,0.06113683856808325,2021-11-27 14:23:35 UTC
799056,mainnet,252,108864000,108959525,95526,89671,5855,0.061292213638171805,2021-11-27 14:26:10 UTC
799057,mainnet,252,108864000,108959784,95785,89915,5870,0.06128308190217675,2021-11-27 14:28:28 UTC
799059,mainnet,252,108864000,108960100,96101,90202,5899,0.061383336281620376,2021-11-27 14:31:11 UTC
799060,mainnet,252,108864000,108960353,96354,90429,5925,0.06149199825642942,2021-11-27 14:33:25 UTC
799062,mainnet,252,108864000,108960747,96748,90794,5954,0.061541323851655845,2021-11-27 14:36:42 UTC
799064,mainnet,252,108864000,108961054,97055,91077,5978,0.06159394157951677,2021-11-27 14:39:23 UTC
799065,mainnet,252,108864000,108961284,97285,91286,5999,0.06166418255640643,2021-11-27 14:41:32 UTC
799067,mainnet,252,108864000,108961463,97464,91454,6010,0.06166379381104818,2021-11-27 14:43:39 UTC
799068,mainnet,252,108864000,108961737,97738,91698,6040,0.06179786776893327,2021-11-27 14:45:50 UTC
799069,mainnet,252,108864000,108961980,97981,91924,6057,0.0618181075922883,2021-11-27 14:48:01 UTC
799070,mainnet,252,108864000,108962216,98217,92149,6068,0.06178156530946781,2021-11-27 14:50:15 UTC
799072,mainnet,252,108864000,108962431,98432,92350,6082,0.061788849154746424,2021-11-27 14:52:21 UTC
799073,mainnet,252,108864000,108962695,98696,92585,6111,0.06191740293426279,2021-11-27 14:54:34 UTC
799075,mainnet,252,108864000,108962928,98929,92810,6119,0.06185243962842038,2021-11-27 14:56:45 UTC
799076,mainnet,252,108864000,108963200,99201,93050,6151,0.062005423332426084,2021-11-27 14:58:59 UTC
799078,mainnet,252,108864000,108963489,99490,93314,6176,0.06207659061212182,2021-11-27 15:01:36 UTC
799079,mainnet,252,108864000,108963748,99749,93553,6196,0.06211591093645049,2021-11-27 15:04:05 UTC
799081,mainnet,252,108864000,108964045,100046,93829,6217,0.062141414949123404,2021-11-27 15:06:35 UTC
799083,mainnet,252,108864000,108964282,100283,94062,6221,0.06203444252764676,2021-11-27 15:08:53 UTC
799084,mainnet,252,108864000,108964521,100522,94288,6234,0.06201627504426892,2021-11-27 15:11:14 UTC
799086,mainnet,252,108864000,108964784,100785,94526,6259,0.062102495411023466,2021-11-27 15:13:38 UTC
799087,mainnet,252,108864000,108965090,101091,94796,6295,0.06227062745447171,2021-11-27 15:15:59 UTC
799089,mainnet,252,108864000,108965315,101316,95004,6312,0.06230013028544356,2021-11-27 15:18:08 UTC
799090,mainnet,252,108864000,108965663,101664,95333,6331,0.06227376455775889,2021-11-27 15:21:18 UTC
799092,mainnet,252,108864000,108965929,101930,95587,6343,0.06222898067301089,2021-11-27 15:23:36 UTC
799093,mainnet,252,108864000,108966166,102167,95819,6348,0.06213356563273856,2021-11-27 15:25:44 UTC
799095,mainnet,252,108864000,108966409,102410,96032,6378,0.062279074309149494,2021-11-27 15:27:52 UTC
799096,mainnet,252,108864000,108966637,102638,96256,6382,0.06217969952649116,2021-11-27 15:29:59 UTC
799098,mainnet,252,108864000,108966913,102914,96507,6407,0.06225586411955614,2021-11-27 15:32:12 UTC
799099,mainnet,252,108864000,108967157,103158,96730,6428,0.0623121813141007,2021-11-27 15:34:23 UTC
799101,mainnet,252,108864000,108967398,103399,96956,6443,0.06231201462296541,2021-11-27 15:36:34 UTC
799102,mainnet,252,108864000,108967640,103641,97182,6459,0.06232089617043448,2021-11-27 15:38:45 UTC
799104,mainnet,252,108864000,108967866,103867,97404,6463,0.06222380544349986,2021-11-27 15:40:52 UTC
799105,mainnet,252,108864000,108968092,104093,97622,6471,0.06216556348649765,2021-11-27 15:43:01 UTC
799107,mainnet,252,108864000,108968360,104361,97864,6497,0.062255056965724746,2021-11-27 15:45:17 UTC
799108,mainnet,252,108864000,108968637,104638,98122,6516,0.06227183241269902,2021-11-27 15:47:42 UTC
799110,mainnet,252,108864000,108968886,104887,98366,6521,0.06217167046440455,2021-11-27 15:49:56 UTC
799111,mainnet,252,108864000,108969146,105147,98613,6534,0.06214157322605495,2021-11-27 15:52:22 UTC
799113,mainnet,252,108864000,108969403,105404,98849,6555,0.062189290729004594,2021-11-27 15:54:38 UTC
799114,mainnet,252,108864000,108969672,105673,99106,6567,0.06214454023260436,2021-11-27 15:57:00 UTC
799116,mainnet,252,108864000,108969929,105930,99352,6578,0.06209761163032191,2021-11-27 15:59:23 UTC
799117,mainnet,252,108864000,108970192,106193,99594,6599,0.062141572420027685,2021-11-27 16:01:42 UTC
799119,mainnet,252,108864000,108970492,106493,99859,6634,0.062295174330707186,2021-11-27 16:04:15 UTC
799120,mainnet,252,108864000,108970739,106740,100089,6651,0.06231028667790894,2021-11-27 16:06:33 UTC
799122,mainnet,252,108864000,108970963,106964,100297,6667,0.06232938184809843,2021-11-27 16:08:50 UTC
799124,mainnet,252,108864000,108971269,107270,100581,6689,0.062356670084832665,2021-11-27 16:11:25 UTC
799125,mainnet,252,108864000,108971583,107584,100866,6718,0.06244422962522308,2021-11-27 16:14:16 UTC
799127,mainnet,252,108864000,108971826,107827,101103,6724,0.06235914937817059,2021-11-27 16:16:33 UTC
799128,mainnet,252,108864000,108972093,108094,101344,6750,0.06244564915721502,2021-11-27 16:18:51 UTC
799130,mainnet,252,108864000,108972362,108363,101595,6768,0.06245674261509925,2021-11-27 16:21:18 UTC
799131,mainnet,252,108864000,108972676,108677,101889,6788,0.06246031819060151,2021-11-27 16:24:05 UTC
799133,mainnet,252,108864000,108972924,108925,102120,6805,0.06247417948129447,2021-11-27 16:26:28 UTC
799134,mainnet,252,108864000,108973186,109187,102364,6823,0.06248912416313297,2021-11-27 16:28:39 UTC
799135,mainnet,252,108864000,108973444,109445,102613,6832,0.06242404860889031,2021-11-27 16:30:47 UTC
799137,mainnet,252,108864000,108973705,109706,102870,6836,0.06231199752064609,2021-11-27 16:33:07 UTC
799138,mainnet,252,108864000,108973960,109961,103106,6855,0.062340284282609286,2021-11-27 16:35:21 UTC
799140,mainnet,252,108864000,108974207,110208,103333,6875,0.062382041231126596,2021-11-27 16:37:33 UTC
799141,mainnet,252,108864000,108974451,110452,103562,6890,0.06238003838771593,2021-11-27 16:39:42 UTC
799143,mainnet,252,108864000,108974682,110683,103782,6901,0.062349231589313624,2021-11-27 16:41:52 UTC
799144,mainnet,252,108864000,108974924,110925,104014,6911,0.06230335812485914,2021-11-27 16:44:12 UTC
799146,mainnet,252,108864000,108975161,111162,104244,6918,0.06223349705834728,2021-11-27 16:46:25 UTC
799147,mainnet,252,108864000,108975447,111448,104521,6927,0.06215454741224607,2021-11-27 16:48:58 UTC
799149,mainnet,252,108864000,108975761,111762,104811,6951,0.06219466366027809,2021-11-27 16:51:44 UTC
799150,mainnet,252,108864000,108976032,112033,105054,6979,0.06229414547499398,2021-11-27 16:54:09 UTC
799151,mainnet,252,108864000,108976264,112265,105268,6997,0.06232574711619828,2021-11-27 16:56:20 UTC
799153,mainnet,252,108864000,108976513,112514,105505,7009,0.06229447002150843,2021-11-27 16:58:39 UTC
799154,mainnet,252,108864000,108976769,112770,105751,7019,0.062241730956814754,2021-11-27 17:01:05 UTC
799156,mainnet,252,108864000,108977034,113035,106002,7033,0.06221966647498563,2021-11-27 17:03:35 UTC
799158,mainnet,252,108864000,108977314,113315,106257,7058,0.06228654635308653,2021-11-27 17:06:15 UTC
799159,mainnet,252,108864000,108977581,113582,106507,7075,0.06228979944005212,2021-11-27 17:08:36 UTC
799161,mainnet,252,108864000,108977801,113802,106712,7090,0.06230118978576826,2021-11-27 17:10:45 UTC
799162,mainnet,252,108864000,108978044,114045,106937,7108,0.06232627471612083,2021-11-27 17:12:56 UTC
799163,mainnet,252,108864000,108978302,114303,107183,7120,0.06229057854999431,2021-11-27 17:15:05 UTC
799165,mainnet,252,108864000,108978564,114565,107420,7145,0.062366342251123814,2021-11-27 17:17:20 UTC
799167,mainnet,252,108864000,108978807,114808,107643,7165,0.062408542958678835,2021-11-27 17:19:35 UTC
799168,mainnet,252,108864000,108979041,115042,107863,7179,0.062403296187479355,2021-11-27 17:21:44 UTC
799169,mainnet,252,108864000,108979336,115337,108140,7197,0.06239975029695588,2021-11-27 17:23:53 UTC
799170,mainnet,252,108864000,108979563,115564,108348,7216,0.06244159080682565,2021-11-27 17:26:05 UTC
799172,mainnet,252,108864000,108979845,115846,108621,7225,0.062367280700239974,2021-11-27 17:28:31 UTC
799174,mainnet,252,108864000,108980115,116116,108875,7241,0.06236005373936408,2021-11-27 17:30:58 UTC
799175,mainnet,252,108864000,108980387,116388,109140,7248,0.06227446128466852,2021-11-27 17:33:18 UTC
799177,mainnet,252,108864000,108980677,116678,109424,7254,0.06217110337852894,2021-11-27 17:35:42 UTC
799178,mainnet,252,108864000,108980961,116962,109693,7269,0.06214839007540911,2021-11-27 17:38:13 UTC
799180,mainnet,252,108864000,108981262,117263,109970,7293,0.062193530781235344,2021-11-27 17:40:46 UTC
799181,mainnet,252,108864000,108981518,117519,110214,7305,0.06216016133561381,2021-11-27 17:43:04 UTC
799183,mainnet,252,108864000,108981789,117790,110479,7311,0.06206808727396214,2021-11-27 17:45:32 UTC
799184,mainnet,252,108864000,108982071,118072,110747,7325,0.062038417236940174,2021-11-27 17:48:00 UTC
799186,mainnet,252,108864000,108982337,118338,111012,7326,0.0619074177356386,2021-11-27 17:50:19 UTC
799187,mainnet,252,108864000,108982568,118569,111225,7344,0.061938618019887155,2021-11-27 17:52:28 UTC
799189,mainnet,252,108864000,108982823,118824,111460,7364,0.061974011984110955,2021-11-27 17:54:36 UTC
799190,mainnet,252,108864000,108983075,119076,111692,7384,0.06201081662131748,2021-11-27 17:56:45 UTC
799192,mainnet,252,108864000,108983326,119327,111941,7386,0.06189713979233535,2021-11-27 17:58:58 UTC
799193,mainnet,252,108864000,108983585,119586,112172,7414,0.06199722375528908,2021-11-27 18:01:14 UTC
799195,mainnet,252,108864000,108983815,119816,112388,7428,0.0619950590906056,2021-11-27 18:03:31 UTC
799196,mainnet,252,108864000,108984076,120077,112616,7461,0.062135129958276775,2021-11-27 18:05:44 UTC
799198,mainnet,252,108864000,108984309,120310,112831,7479,0.062164408611088025,2021-11-27 18:07:55 UTC
799199,mainnet,252,108864000,108984533,120534,113024,7510,0.062306071315977235,2021-11-27 18:10:04 UTC
799201,mainnet,252,108864000,108984752,120753,113218,7535,0.06240010600150721,2021-11-27 18:12:15 UTC
799202,mainnet,252,108864000,108985057,121058,113489,7569,0.06252374894678583,2021-11-27 18:14:29 UTC
799204,mainnet,252,108864000,108985326,121327,113752,7575,0.062434577629052065,2021-11-27 18:16:59 UTC
799205,mainnet,252,108864000,108985608,121609,114016,7593,0.06243781299081482,2021-11-27 18:19:26 UTC
799207,mainnet,252,108864000,108985877,121878,114276,7602,0.062373849259095164,2021-11-27 18:21:50 UTC
799209,mainnet,252,108864000,108986179,122180,114565,7615,0.062326076280897036,2021-11-27 18:24:35 UTC
799210,mainnet,252,108864000,108986498,122499,114855,7644,0.062400509391913404,2021-11-27 18:27:09 UTC
799212,mainnet,252,108864000,108986753,122754,115090,7664,0.0624338107108526,2021-11-27 18:29:24 UTC
799213,mainnet,252,108864000,108987006,123007,115305,7702,0.06261432276211923,2021-11-27 18:31:44 UTC
799215,mainnet,252,108864000,108987280,123281,115552,7729,0.06269417022898906,2021-11-27 18:34:13 UTC
799216,mainnet,252,108864000,108987550,123551,115806,7745,0.062686663806849,2021-11-27 18:36:33 UTC
799218,mainnet,252,108864000,108987797,123798,116047,7751,0.06261005832081294,2021-11-27 18:38:42 UTC
799219,mainnet,252,108864000,108988056,124057,116293,7764,0.06258413471226935,2021-11-27 18:40:52 UTC
799220,mainnet,252,108864000,108988299,124300,116531,7769,0.06250201126307321,2021-11-27 18:42:58 UTC
799222,mainnet,252,108864000,108988551,124552,116772,7780,0.0624638705119147,2021-11-27 18:45:10 UTC
799223,mainnet,252,108864000,108988798,124799,117011,7788,0.062404346188671383,2021-11-27 18:47:20 UTC
799225,mainnet,252,108864000,108989067,125068,117270,7798,0.062350081555633735,2021-11-27 18:49:54 UTC
799226,mainnet,252,108864000,108989319,125320,117495,7825,0.06244015320778806,2021-11-27 18:52:08 UTC
799228,mainnet,252,108864000,108989564,125565,117725,7840,0.06243778122884562,2021-11-27 18:54:20 UTC
799229,mainnet,252,108864000,108989834,125835,117983,7852,0.06239917352088052,2021-11-27 18:56:47 UTC
799231,mainnet,252,108864000,108990113,126114,118243,7871,0.06241178616172669,2021-11-27 18:59:28 UTC
799233,mainnet,252,108864000,108990423,126424,118522,7902,0.06250395494526356,2021-11-27 19:02:01 UTC
799234,mainnet,252,108864000,108990748,126749,118828,7921,0.06249358969301533,2021-11-27 19:04:37 UTC
799236,mainnet,252,108864000,108991020,127021,119079,7942,0.06252509427574968,2021-11-27 19:06:57 UTC
799237,mainnet,252,108864000,108991327,127328,119381,7947,0.0624136089469716,2021-11-27 19:09:34 UTC
799239,mainnet,252,108864000,108991603,127604,119638,7966,0.06242751010940096,2021-11-27 19:12:00 UTC
799240,mainnet,252,108864000,108991863,127864,119875,7989,0.062480447975974476,2021-11-27 19:14:09 UTC
799242,mainnet,252,108864000,108992143,128144,120154,7990,0.0623517293045324,2021-11-27 19:16:35 UTC
799243,mainnet,252,108864000,108992432,128433,120427,8006,0.06233600398651437,2021-11-27 19:18:58 UTC
799245,mainnet,252,108864000,108992736,128737,120711,8026,0.06234415902188182,2021-11-27 19:21:40 UTC
799246,mainnet,252,108864000,108992994,128995,120955,8040,0.06232799720919416,2021-11-27 19:24:07 UTC
799248,mainnet,252,108864000,108993284,129285,121243,8042,0.06220365858374908,2021-11-27 19:26:21 UTC
799249,mainnet,252,108864000,108993528,129529,121480,8049,0.06214052451574551,2021-11-27 19:28:38 UTC
799251,mainnet,252,108864000,108993800,129801,121726,8075,0.06221061471021024,2021-11-27 19:30:58 UTC
799252,mainnet,252,108864000,108994062,130063,121982,8081,0.062131428615363325,2021-11-27 19:33:16 UTC
799254,mainnet,252,108864000,108994361,130362,122267,8095,0.06209631641122413,2021-11-27 19:35:52 UTC
799256,mainnet,252,108864000,108994646,130647,122533,8114,0.062106286405351825,2021-11-27 19:38:12 UTC
799257,mainnet,252,108864000,108994903,130904,122783,8121,0.06203782924891524,2021-11-27 19:40:29 UTC
799259,mainnet,252,108864000,108995157,131158,123037,8121,0.06191768706445661,2021-11-27 19:42:43 UTC
799260,mainnet,252,108864000,108995444,131445,123309,8136,0.06189661074974324,2021-11-27 19:44:57 UTC
799261,mainnet,252,108864000,108995722,131723,123574,8149,0.06186467055867237,2021-11-27 19:47:14 UTC
799262,mainnet,252,108864000,108995979,131980,123826,8154,0.061782088195181085,2021-11-27 19:49:27 UTC
799264,mainnet,252,108864000,108996241,132242,124078,8164,0.06173530345881036,2021-11-27 19:51:38 UTC
799265,mainnet,252,108864000,108996527,132528,124363,8165,0.061609622117590246,2021-11-27 19:54:08 UTC
799267,mainnet,252,108864000,108996836,132837,124659,8178,0.061564172632624946,2021-11-27 19:56:37 UTC
799268,mainnet,252,108864000,108997123,133124,124931,8193,0.061544124275111925,2021-11-27 19:59:08 UTC
799270,mainnet,252,108864000,108997388,133389,125186,8203,0.06149682507553097,2021-11-27 20:01:30 UTC
799272,mainnet,252,108864000,108997670,133671,125454,8217,0.0614718226092421,2021-11-27 20:04:05 UTC
799273,mainnet,252,108864000,108997934,133935,125707,8228,0.06143278455967447,2021-11-27 20:06:33 UTC
799275,mainnet,252,108864000,108998430,134431,126163,8268,0.06150367102825985,2021-11-27 20:10:54 UTC
799277,mainnet,252,108864000,108998688,134689,126408,8281,0.061482377922473255,2021-11-27 20:13:09 UTC
799278,mainnet,252,108864000,108998993,134994,126705,8289,0.06140272901017823,2021-11-27 20:15:46 UTC
799280,mainnet,252,108864000,108999244,135245,126943,8302,0.06138489408111206,2021-11-27 20:18:33 UTC
799281,mainnet,252,108864000,108999554,135555,127231,8324,0.06140680904429936,2021-11-27 20:20:39 UTC
799283,mainnet,252,108864000,108999832,135833,127492,8341,0.06140628565959671,2021-11-27 20:23:06 UTC
799284,mainnet,252,108864000,109000090,136091,127739,8352,0.061370700487174024,2021-11-27 20:25:21 UTC
799286,mainnet,252,108864000,109000426,136427,128069,8358,0.061263532878389176,2021-11-27 20:28:14 UTC
799287,mainnet,252,108864000,109000816,136817,128409,8408,0.06145435143293596,2021-11-27 20:31:17 UTC
799289,mainnet,252,108864000,109001109,137110,128681,8429,0.061476187003136167,2021-11-27 20:33:51 UTC
799291,mainnet,252,108864000,109001381,137382,128940,8442,0.061449098135126876,2021-11-27 20:36:14 UTC
799292,mainnet,252,108864000,109001661,137662,129215,8447,0.061360433525591666,2021-11-27 20:39:05 UTC
799294,mainnet,252,108864000,109001898,137899,129442,8457,0.06132749331032132,2021-11-27 20:41:22 UTC
799295,mainnet,252,108864000,109002237,138238,129733,8505,0.06152432760890638,2021-11-27 20:44:24 UTC
799297,mainnet,252,108864000,109002487,138488,129965,8523,0.061543238403327365,2021-11-27 20:46:36 UTC
799298,mainnet,252,108864000,109002770,138771,130228,8543,0.06156185370142177,2021-11-27 20:49:10 UTC
799300,mainnet,252,108864000,109003037,139038,130469,8569,0.061630633352033254,2021-11-27 20:51:39 UTC
799302,mainnet,252,108864000,109003322,139323,130735,8588,0.06164093509327247,2021-11-27 20:54:25 UTC
799303,mainnet,252,108864000,109003568,139569,130966,8603,0.06163976241142374,2021-11-27 20:56:41 UTC
799305,mainnet,252,108864000,109003856,139857,131219,8638,0.06176308658129375,2021-11-27 20:59:28 UTC
799306,mainnet,252,108864000,109004148,140149,131492,8657,0.06176997338546832,2021-11-27 21:02:06 UTC
799308,mainnet,252,108864000,109004378,140379,131712,8667,0.06174000384672921,2021-11-27 21:04:13 UTC
799309,mainnet,252,108864000,109004605,140606,131926,8680,0.061732785229648805,2021-11-27 21:06:23 UTC
799311,mainnet,252,108864000,109004823,140824,132141,8683,0.061658524115207634,2021-11-27 21:08:28 UTC
799312,mainnet,252,108864000,109005012,141013,132312,8701,0.06170353088013162,2021-11-27 21:10:33 UTC
799314,mainnet,252,108864000,109005261,141262,132523,8739,0.061863770865483995,2021-11-27 21:12:42 UTC
799315,mainnet,252,108864000,109005486,141487,132732,8755,0.061878476467802694,2021-11-27 21:14:49 UTC
799316,mainnet,252,108864000,109005740,141741,132948,8793,0.06203568480538447,2021-11-27 21:17:00 UTC
799318,mainnet,252,108864000,109005965,141966,133158,8808,0.062043024386120624,2021-11-27 21:19:09 UTC
799319,mainnet,252,108864000,109006205,142206,133381,8825,0.06205785972462484,2021-11-27 21:21:13 UTC
799321,mainnet,252,108864000,109006446,142447,133609,8838,0.06204412869347898,2021-11-27 21:23:26 UTC
799322,mainnet,252,108864000,109006745,142746,133889,8857,0.06204727277822145,2021-11-27 21:26:02 UTC
799324,mainnet,252,108864000,109006998,142999,134133,8866,0.062000433569465524,2021-11-27 21:28:10 UTC
799325,mainnet,252,108864000,109007259,143260,134373,8887,0.062034063939690076,2021-11-27 21:30:22 UTC
799327,mainnet,252,108864000,109007525,143526,134636,8890,0.061939996934353356,2021-11-27 21:32:50 UTC
799328,mainnet,252,108864000,109007800,143801,134897,8904,0.06191890181570365,2021-11-27 21:35:08 UTC
799330,mainnet,252,108864000,109008044,144045,135128,8917,0.06190426602797737,2021-11-27 21:37:25 UTC
799331,mainnet,252,108864000,109008304,144305,135383,8922,0.06182737950867953,2021-11-27 21:39:44 UTC
799333,mainnet,252,108864000,109008556,144557,135620,8937,0.06182336379421266,2021-11-27 21:42:01 UTC
799334,mainnet,252,108864000,109008853,144854,135904,8950,0.06178635039419001,2021-11-27 21:44:32 UTC
799336,mainnet,252,108864000,109009129,145130,136165,8965,0.06177220423068973,2021-11-27 21:46:57 UTC
799337,mainnet,252,108864000,109009388,145389,136412,8977,0.06174469870485388,2021-11-27 21:49:10 UTC
799339,mainnet,252,108864000,109009652,145653,136669,8984,0.06168084419819708,2021-11-27 21:51:31 UTC
799341,mainnet,252,108864000,109009952,145953,136959,8994,0.06162257713099423,2021-11-27 21:53:57 UTC
799342,mainnet,252,108864000,109010237,146238,137237,9001,0.06155034943038061,2021-11-27 21:56:29 UTC
799344,mainnet,252,108864000,109010479,146480,137462,9018,0.06156471873293282,2021-11-27 21:58:43 UTC
799345,mainnet,252,108864000,109010734,146735,137715,9020,0.061471359934575934,2021-11-27 22:01:08 UTC
799347,mainnet,252,108864000,109010986,146987,137937,9050,0.06157007082258975,2021-11-27 22:03:28 UTC
799348,mainnet,252,108864000,109011224,147225,138168,9057,0.06151808456444218,2021-11-27 22:05:32 UTC
799349,mainnet,252,108864000,109011471,147472,138397,9075,0.06153710534881198,2021-11-27 22:07:36 UTC
799351,mainnet,252,108864000,109011709,147710,138628,9082,0.06148534290163157,2021-11-27 22:09:46 UTC
799352,mainnet,252,108864000,109012002,148003,138915,9088,0.061404160726471764,2021-11-27 22:12:17 UTC
799354,mainnet,252,108864000,109012275,148276,139165,9111,0.06144622191049125,2021-11-27 22:14:31 UTC
799355,mainnet,252,108864000,109012553,148554,139439,9115,0.06135815932253591,2021-11-27 22:16:51 UTC
799357,mainnet,252,108864000,109012817,148818,139698,9120,0.06128290932548482,2021-11-27 22:19:07 UTC
799358,mainnet,252,108864000,109013117,149118,139984,9134,0.06125350393647983,2021-11-27 22:21:43 UTC
799360,mainnet,252,108864000,109013388,149389,140254,9135,0.06114908058826286,2021-11-27 22:24:03 UTC
799361,mainnet,252,108864000,109013658,149659,140486,9173,0.0612926720076975,2021-11-27 22:26:24 UTC
799363,mainnet,252,108864000,109013909,149910,140722,9188,0.061290107397772,2021-11-27 22:28:30 UTC
799364,mainnet,252,108864000,109014166,150167,140963,9204,0.06129176183848648,2021-11-27 22:31:07 UTC
799366,mainnet,252,108864000,109014398,150399,141162,9237,0.061416631759519676,2021-11-27 22:33:20 UTC
799367,mainnet,252,108864000,109014650,150651,141386,9265,0.06149975771816981,2021-11-27 22:35:43 UTC
799369,mainnet,252,108864000,109014907,150908,141629,9279,0.061487793887666654,2021-11-27 22:37:49 UTC
799370,mainnet,252,108864000,109015146,151147,141848,9299,0.06152288831402542,2021-11-27 22:39:57 UTC
799372,mainnet,252,108864000,109015384,151385,142072,9313,0.06151864451563893,2021-11-27 22:42:05 UTC
799373,mainnet,252,108864000,109015632,151633,142303,9330,0.06153014185566466,2021-11-27 22:44:13 UTC
799375,mainnet,252,108864000,109015878,151879,142539,9340,0.06149632273059475,2021-11-27 22:46:20 UTC
799376,mainnet,252,108864000,109016139,152140,142787,9353,0.061476271854870514,2021-11-27 22:48:29 UTC
799378,mainnet,252,108864000,109016366,152367,143008,9359,0.06142406164064397,2021-11-27 22:50:33 UTC
799379,mainnet,252,108864000,109016607,152608,143243,9365,0.061366376598867685,2021-11-27 22:52:35 UTC
799380,mainnet,252,108864000,109016859,152860,143478,9382,0.06137642287060055,2021-11-27 22:54:46 UTC
799382,mainnet,252,108864000,109017133,153134,143736,9398,0.06137108676061489,2021-11-27 22:57:05 UTC
799383,mainnet,252,108864000,109017418,153419,144017,9402,0.061283152673397685,2021-11-27 22:59:28 UTC
799385,mainnet,252,108864000,109017679,153680,144272,9408,0.061218115564809994,2021-11-27 23:01:48 UTC
799386,mainnet,252,108864000,109017996,153997,144572,9425,0.061202490957616054,2021-11-27 23:04:27 UTC
799388,mainnet,252,108864000,109018312,154313,144867,9446,0.06121324839773707,2021-11-27 23:07:12 UTC
799389,mainnet,252,108864000,109018569,154570,145107,9463,0.061221453063337,2021-11-27 23:09:26 UTC
799391,mainnet,252,108864000,109018812,154813,145337,9476,0.06120932996582974,2021-11-27 23:11:31 UTC
799393,mainnet,252,108864000,109019137,155138,145656,9482,0.061119777230594696,2021-11-27 23:14:11 UTC
799394,mainnet,252,108864000,109019492,155493,146003,9490,0.061031686313853355,2021-11-27 23:17:03 UTC
799396,mainnet,252,108864000,109019737,155738,146247,9491,0.06094209505708305,2021-11-27 23:19:18 UTC
799397,mainnet,252,108864000,109020013,156014,146514,9500,0.060891971233350856,2021-11-27 23:21:38 UTC
799399,mainnet,252,108864000,109020292,156293,146783,9510,0.06084725483546928,2021-11-27 23:24:02 UTC
799400,mainnet,252,108864000,109020544,156545,147027,9518,0.060800408828132486,2021-11-27 23:26:15 UTC
799402,mainnet,252,108864000,109020914,156915,147389,9526,0.060708026638626005,2021-11-27 23:29:26 UTC
799404,mainnet,252,108864000,109021200,157201,147654,9547,0.06073116583227842,2021-11-27 23:31:59 UTC
799405,mainnet,252,108864000,109021509,157510,147953,9557,0.060675512665862484,2021-11-27 23:34:44 UTC
799407,mainnet,252,108864000,109021855,157856,148257,9599,0.0608085850395297,2021-11-27 23:37:20 UTC
799408,mainnet,252,108864000,109022112,158113,148510,9603,0.060735043924282,2021-11-27 23:39:32 UTC
799410,mainnet,252,108864000,109022390,158391,148771,9620,0.06073577412858054,2021-11-27 23:42:00 UTC
799411,mainnet,252,108864000,109022654,158655,149021,9634,0.06072295231792254,2021-11-27 23:44:16 UTC
799413,mainnet,252,108864000,109022886,158887,149239,9648,0.06072240019636597,2021-11-27 23:46:26 UTC
799414,mainnet,252,108864000,109023127,159128,149460,9668,0.060756120858679805,2021-11-27 23:48:41 UTC
799416,mainnet,252,108864000,109023417,159418,149732,9686,0.06075850907676674,2021-11-27 23:51:13 UTC
799417,mainnet,252,108864000,109023729,159730,150035,9695,0.06069617479496651,2021-11-27 23:53:58 UTC
799419,mainnet,252,108864000,109024072,160073,150378,9695,0.060566116709251404,2021-11-27 23:56:49 UTC
799421,mainnet,252,108864000,109024415,160416,150715,9701,0.06047401755435867,2021-11-27 23:59:48 UTC
799422,mainnet,252,108864000,109024695,160696,150977,9719,0.06048065913277244,2021-11-28 00:02:19 UTC
799424,mainnet,252,108864000,109024968,160969,151240,9729,0.0604402089843386,2021-11-28 00:04:36 UTC
799425,mainnet,252,108864000,109025207,161208,151471,9737,0.060400228276512334,2021-11-28 00:06:43 UTC
799427,mainnet,252,108864000,109025465,161466,151715,9751,0.060390422751539025,2021-11-28 00:08:51 UTC
799428,mainnet,252,108864000,109025725,161726,151961,9765,0.0603799018092329,2021-11-28 00:11:05 UTC
799430,mainnet,252,108864000,109025969,161970,152188,9782,0.06039390010495771,2021-11-28 00:13:13 UTC
799431,mainnet,252,108864000,109026216,162217,152431,9786,0.060326599554917176,2021-11-28 00:15:22 UTC
799433,mainnet,252,108864000,109026458,162459,152671,9788,0.0602490474519725,2021-11-28 00:17:33 UTC
799434,mainnet,252,108864000,109026709,162710,152908,9802,0.0602421486079528,2021-11-28 00:19:41 UTC
799436,mainnet,252,108864000,109026957,162958,153155,9803,0.06015660476932706,2021-11-28 00:21:55 UTC
799437,mainnet,252,108864000,109027218,163219,153401,9818,0.06015231069912204,2021-11-28 00:24:03 UTC
799438,mainnet,252,108864000,109027452,163453,153608,9845,0.06023138149804531,2021-11-28 00:26:12 UTC
799440,mainnet,252,108864000,109027807,163808,153942,9866,0.06022904864231295,2021-11-28 00:29:37 UTC
799441,mainnet,252,108864000,109028108,164109,154214,9895,0.060295291544034756,2021-11-28 00:32:05 UTC
799443,mainnet,252,108864000,109028402,164403,154491,9912,0.06029087060455101,2021-11-28 00:34:35 UTC
799444,mainnet,252,108864000,109028662,164663,154749,9914,0.060207818392717244,2021-11-28 00:36:49 UTC
799446,mainnet,252,108864000,109028915,164916,155001,9915,0.060121516408353344,2021-11-28 00:39:06 UTC
799447,mainnet,252,108864000,109029169,165170,155211,9959,0.06029545316946177,2021-11-28 00:41:19 UTC
799449,mainnet,252,108864000,109029393,165394,155421,9973,0.0602984388792822,2021-11-28 00:43:45 UTC
799450,mainnet,252,108864000,109029642,165643,155665,9978,0.06023798168350006,2021-11-28 00:46:09 UTC
799452,mainnet,252,108864000,109029942,165943,155950,9993,0.06021947295155566,2021-11-28 00:48:37 UTC
799453,mainnet,252,108864000,109030215,166216,156198,10018,0.060270972710208405,2021-11-28 00:51:05 UTC
799455,mainnet,252,108864000,109030458,166459,156421,10038,0.060303137709586146,2021-11-28 00:53:12 UTC
799456,mainnet,252,108864000,109030709,166710,156657,10053,0.060302321396436924,2021-11-28 00:55:30 UTC
799458,mainnet,252,108864000,109030981,166982,156910,10072,0.060317878573738486,2021-11-28 00:57:42 UTC
799459,mainnet,252,108864000,109031203,167204,157127,10077,0.06026769694504916,2021-11-28 00:59:44 UTC
799461,mainnet,252,108864000,109031471,167472,157384,10088,0.06023693512945447,2021-11-28 01:02:07 UTC
799462,mainnet,252,108864000,109031754,167755,157658,10097,0.060188966051682516,2021-11-28 01:04:29 UTC
799464,mainnet,252,108864000,109032023,168024,157919,10105,0.060140218064086086,2021-11-28 01:06:48 UTC
799465,mainnet,252,108864000,109032364,168365,158221,10144,0.06025005197042141,2021-11-28 01:09:37 UTC
799467,mainnet,252,108864000,109032649,168650,158500,10150,0.06018381262970649,2021-11-28 01:12:04 UTC
799468,mainnet,252,108864000,109032921,168922,158757,10165,0.06017570239518831,2021-11-28 01:14:46 UTC
799470,mainnet,252,108864000,109033070,169071,158894,10177,0.060193646456222535,2021-11-28 01:17:04 UTC
799471,mainnet,252,108864000,109033430,169431,159206,10225,0.06034905064598568,2021-11-28 01:19:25 UTC
799473,mainnet,252,108864000,109033745,169746,159495,10251,0.060390230108515075,2021-11-28 01:22:14 UTC
799474,mainnet,252,108864000,109034020,170021,159745,10276,0.06043959275618894,2021-11-28 01:24:41 UTC
799476,mainnet,252,108864000,109034269,170270,159973,10297,0.06047454043577847,2021-11-28 01:26:53 UTC
799477,mainnet,252,108864000,109034533,170534,160231,10303,0.06041610470639286,2021-11-28 01:29:15 UTC
799479,mainnet,252,108864000,109034828,170829,160508,10321,0.06041714228848732,2021-11-28 01:31:53 UTC
799481,mainnet,252,108864000,109035100,171101,160762,10339,0.06042629791760422,2021-11-28 01:34:16 UTC
799482,mainnet,252,108864000,109035336,171337,160989,10348,0.06039559464680717,2021-11-28 01:36:37 UTC
799484,mainnet,252,108864000,109035598,171599,161226,10373,0.0604490702160269,2021-11-28 01:38:53 UTC
799485,mainnet,252,108864000,109035822,171823,161427,10396,0.060504123429342985,2021-11-28 01:41:02 UTC
799486,mainnet,252,108864000,109036095,172096,161687,10409,0.060483683525474154,2021-11-28 01:43:30 UTC
799487,mainnet,252,108864000,109036356,172357,161926,10431,0.06051973520077514,2021-11-28 01:45:41 UTC
799489,mainnet,252,108864000,109036652,172653,162204,10449,0.06052023422703341,2021-11-28 01:48:12 UTC
799490,mainnet,252,108864000,109036910,172911,162439,10472,0.06056294856891696,2021-11-28 01:50:25 UTC
799492,mainnet,252,108864000,109037167,173168,162689,10479,0.06051348979026148,2021-11-28 01:52:41 UTC
799493,mainnet,252,108864000,109037378,173379,162882,10497,0.060543664457633276,2021-11-28 01:54:48 UTC
799495,mainnet,252,108864000,109037632,173633,163127,10506,0.060506931286103446,2021-11-28 01:57:09 UTC
799496,mainnet,252,108864000,109037860,173861,163344,10517,0.06049085188742731,2021-11-28 01:59:13 UTC
799498,mainnet,252,108864000,109038104,174105,163569,10536,0.06051520634100112,2021-11-28 02:01:28 UTC
799499,mainnet,252,108864000,109038363,174364,163803,10561,0.06056869537289807,2021-11-28 02:03:48 UTC
799500,mainnet,252,108864000,109038587,174588,164008,10580,0.06059981212912686,2021-11-28 02:05:56 UTC
799501,mainnet,252,108864000,109038828,174829,164212,10617,0.06072791127330134,2021-11-28 02:08:07 UTC
799503,mainnet,252,108864000,109039045,175046,164409,10637,0.06076688413331353,2021-11-28 02:10:12 UTC
799504,mainnet,252,108864000,109039260,175261,164610,10651,0.060772219718020555,2021-11-28 02:12:19 UTC
799506,mainnet,252,108864000,109039488,175489,164832,10657,0.060727453002752306,2021-11-28 02:14:25 UTC
799507,mainnet,252,108864000,109039707,175708,165036,10672,0.06073713206000865,2021-11-28 02:16:40 UTC
799509,mainnet,252,108864000,109039962,175963,165274,10689,0.06074572495354137,2021-11-28 02:18:46 UTC
799510,mainnet,252,108864000,109040209,176210,165514,10696,0.06070030077748141,2021-11-28 02:20:57 UTC
799512,mainnet,252,108864000,109040441,176442,165734,10708,0.060688498203375615,2021-11-28 02:23:00 UTC
799513,mainnet,252,108864000,109040669,176670,165942,10728,0.06072338257768722,2021-11-28 02:25:09 UTC
799515,mainnet,252,108864000,109040893,176894,166155,10739,0.06070867299060454,2021-11-28 02:27:17 UTC
799516,mainnet,252,108864000,109041133,177134,166386,10748,0.06067722740975758,2021-11-28 02:29:26 UTC
799518,mainnet,252,108864000,109041365,177366,166606,10760,0.060665516502599146,2021-11-28 02:31:31 UTC
799519,mainnet,252,108864000,109041576,177577,166798,10779,0.060700428546489694,2021-11-28 02:33:37 UTC
799520,mainnet,252,108864000,109041784,177785,166999,10786,0.06066878533059594,2021-11-28 02:35:45 UTC
799522,mainnet,252,108864000,109041986,177987,167193,10794,0.06064487855854641,2021-11-28 02:37:54 UTC
799523,mainnet,252,108864000,109042192,178193,167388,10805,0.06063650087264932,2021-11-28 02:40:02 UTC
799525,mainnet,252,108864000,109042419,178420,167598,10822,0.06065463513059074,2021-11-28 02:42:13 UTC
799526,mainnet,252,108864000,109042627,178628,167792,10836,0.06066238215733256,2021-11-28 02:44:19 UTC
799528,mainnet,252,108864000,109042867,178868,168001,10867,0.06075429925978934,2021-11-28 02:46:31 UTC
799529,mainnet,252,108864000,109043093,179094,168220,10874,0.060716718594704455,2021-11-28 02:48:43 UTC
799530,mainnet,252,108864000,109043387,179388,168476,10912,0.06082904096149129,2021-11-28 02:51:33 UTC
799532,mainnet,252,108864000,109043642,179643,168711,10932,0.06085402715385515,2021-11-28 02:53:53 UTC
799534,mainnet,252,108864000,109043935,179936,168979,10957,0.060893873377200786,2021-11-28 02:56:32 UTC
799535,mainnet,252,108864000,109044179,180180,169211,10969,0.060878010878010876,2021-11-28 02:58:55 UTC
799537,mainnet,252,108864000,109044488,180489,169496,10993,0.060906758860650785,2021-11-28 03:01:56 UTC
799538,mainnet,252,108864000,109044722,180723,169723,11000,0.060866630146688576,2021-11-28 03:04:13 UTC
799540,mainnet,252,108864000,109045000,181001,169973,11028,0.06092784017767858,2021-11-28 03:06:26 UTC
799541,mainnet,252,108864000,109045257,181258,170215,11043,0.06092420748325591,2021-11-28 03:08:49 UTC
799543,mainnet,252,108864000,109045515,181516,170464,11052,0.06088719451728773,2021-11-28 03:11:08 UTC
799544,mainnet,252,108864000,109045760,181761,170699,11062,0.06086014051419171,2021-11-28 03:13:19 UTC
799546,mainnet,252,108864000,109046040,182041,170963,11078,0.060854422904730254,2021-11-28 03:15:44 UTC
799547,mainnet,252,108864000,109046264,182265,171166,11099,0.060894850903903654,2021-11-28 03:17:48 UTC
799549,mainnet,252,108864000,109046523,182524,171418,11106,0.060846792750542396,2021-11-28 03:19:59 UTC
799550,mainnet,252,108864000,109046759,182760,171640,11120,0.060844823812650474,2021-11-28 03:22:07 UTC
799551,mainnet,252,108864000,109047039,183040,171911,11129,0.06080091783216783,2021-11-28 03:24:22 UTC
799552,mainnet,252,108864000,109047267,183268,172123,11145,0.06081258048322675,2021-11-28 03:26:29 UTC
799554,mainnet,252,108864000,109047533,183534,172373,11161,0.06081162073512265,2021-11-28 03:28:35 UTC
799555,mainnet,252,108864000,109047717,183718,172539,11179,0.06084869201711318,2021-11-28 03:30:40 UTC
799557,mainnet,252,108864000,109047991,183992,172786,11206,0.06090482194878038,2021-11-28 03:32:53 UTC
799558,mainnet,252,108864000,109048199,184200,172968,11232,0.060977198697068406,2021-11-28 03:34:59 UTC
799560,mainnet,252,108864000,109048445,184446,173192,11254,0.06101514806501632,2021-11-28 03:37:14 UTC
799561,mainnet,252,108864000,109048721,184722,173459,11263,0.06097270492956984,2021-11-28 03:39:32 UTC
799563,mainnet,252,108864000,109048976,184977,173710,11267,0.0609102753315277,2021-11-28 03:41:42 UTC
799564,mainnet,252,108864000,109049212,185213,173933,11280,0.06090285239157078,2021-11-28 03:43:52 UTC
799566,mainnet,252,108864000,109049458,185459,174152,11307,0.06096765322793717,2021-11-28 03:46:05 UTC
799567,mainnet,252,108864000,109049673,185674,174352,11322,0.06097784288591833,2021-11-28 03:48:08 UTC
799568,mainnet,252,108864000,109049940,185941,174605,11336,0.0609655751017796,2021-11-28 03:50:21 UTC
799570,mainnet,252,108864000,109050171,186172,174826,11346,0.06094364351245085,2021-11-28 03:52:23 UTC
799571,mainnet,252,108864000,109050436,186437,175085,11352,0.06088920117787778,2021-11-28 03:54:35 UTC
799573,mainnet,252,108864000,109050629,186630,175275,11355,0.060842308310561005,2021-11-28 03:56:46 UTC
799574,mainnet,252,108864000,109050913,186914,175460,11454,0.061279518923141124,2021-11-28 03:59:04 UTC
799575,mainnet,252,108864000,109051159,187160,175671,11489,0.06138597991023723,2021-11-28 04:01:19 UTC
799577,mainnet,252,108864000,109051385,187386,175885,11501,0.06137598326449148,2021-11-28 04:03:31 UTC
799578,mainnet,252,108864000,109051632,187633,176120,11513,0.06135914258152884,2021-11-28 04:05:53 UTC
799580,mainnet,252,108864000,109051860,187861,176320,11541,0.061433719611840666,2021-11-28 04:08:10 UTC
799581,mainnet,252,108864000,109052135,188136,176576,11560,0.061444912191180846,2021-11-28 04:10:38 UTC
799583,mainnet,252,108864000,109052468,188469,176878,11591,0.06150083037528718,2021-11-28 04:13:32 UTC
799584,mainnet,252,108864000,109052726,188727,177123,11604,0.06148563798502599,2021-11-28 04:15:57 UTC
799586,mainnet,252,108864000,109052979,188980,177342,11638,0.061583236321303844,2021-11-28 04:18:15 UTC
799587,mainnet,252,108864000,109053259,189260,177614,11646,0.06153439712564726,2021-11-28 04:20:52 UTC
799589,mainnet,252,108864000,109053539,189540,177884,11656,0.06149625408884668,2021-11-28 04:23:29 UTC
799591,mainnet,252,108864000,109053784,189785,178105,11680,0.06154332534183418,2021-11-28 04:25:43 UTC
799592,mainnet,252,108864000,109054028,190029,178333,11696,0.061548500492030166,2021-11-28 04:28:03 UTC
799594,mainnet,252,108864000,109054262,190263,178535,11728,0.06164099167993777,2021-11-28 04:30:25 UTC
799595,mainnet,252,108864000,109054494,190495,178752,11743,0.06164466258956928,2021-11-28 04:32:36 UTC
799597,mainnet,252,108864000,109054725,190726,178964,11762,0.06166962029298575,2021-11-28 04:34:46 UTC
799598,mainnet,252,108864000,109054978,190979,179200,11779,0.061676938302116985,2021-11-28 04:37:00 UTC
799600,mainnet,252,108864000,109055207,191208,179421,11787,0.06164491025480105,2021-11-28 04:39:03 UTC
799601,mainnet,252,108864000,109055451,191452,179646,11806,0.06166558719679084,2021-11-28 04:41:12 UTC
799602,mainnet,252,108864000,109055689,191690,179863,11827,0.061698575825551674,2021-11-28 04:43:15 UTC
799603,mainnet,252,108864000,109055950,191951,180118,11833,0.06164594089116493,2021-11-28 04:45:29 UTC
799605,mainnet,252,108864000,109056261,192262,180410,11852,0.061645046863134684,2021-11-28 04:48:07 UTC
799607,mainnet,252,108864000,109056544,192545,180684,11861,0.061601184138772754,2021-11-28 04:50:32 UTC
799608,mainnet,252,108864000,109056806,192807,180939,11868,0.061553781761035646,2021-11-28 04:52:47 UTC
799610,mainnet,252,108864000,109057097,193098,181221,11877,0.06150762825093994,2021-11-28 04:55:10 UTC
799611,mainnet,252,108864000,109057422,193423,181540,11883,0.06143529983507649,2021-11-28 04:58:04 UTC
799613,mainnet,252,108864000,109057681,193682,181781,11901,0.06144608172158487,2021-11-28 05:00:22 UTC
799614,mainnet,252,108864000,109057929,193930,182019,11911,0.061419068736141905,2021-11-28 05:02:36 UTC
799616,mainnet,252,108864000,109058165,194166,182240,11926,0.06142167011732229,2021-11-28 05:05:11 UTC
799617,mainnet,252,108864000,109058465,194466,182516,11950,0.06145033064905948,2021-11-28 05:07:21 UTC
799619,mainnet,252,108864000,109058718,194719,182759,11960,0.0614218437851468,2021-11-28 05:09:44 UTC
799620,mainnet,252,108864000,109058981,194982,183004,11978,0.06143131160825102,2021-11-28 05:12:04 UTC
799622,mainnet,252,108864000,109059259,195260,183266,11994,0.061425791252688725,2021-11-28 05:14:33 UTC
799624,mainnet,252,108864000,109059604,195605,183591,12014,0.06141969786048414,2021-11-28 05:17:29 UTC
799625,mainnet,252,108864000,109059924,195925,183903,12022,0.061360214367742756,2021-11-28 05:20:15 UTC
799627,mainnet,252,108864000,109060185,196186,184159,12027,0.06130406858797264,2021-11-28 05:22:30 UTC
799628,mainnet,252,108864000,109060504,196505,184473,12032,0.06122999414773161,2021-11-28 05:25:21 UTC
799630,mainnet,252,108864000,109060833,196834,184780,12054,0.06123942001889918,2021-11-28 05:28:05 UTC
799632,mainnet,252,108864000,109061103,197104,185026,12078,0.06127729523500284,2021-11-28 05:30:33 UTC
799633,mainnet,252,108864000,109061339,197340,185259,12081,0.06121921556704166,2021-11-28 05:32:42 UTC
799635,mainnet,252,108864000,109061600,197601,185511,12090,0.06118390089118982,2021-11-28 05:34:52 UTC
799636,mainnet,252,108864000,109061841,197842,185722,12120,0.061261006257518624,2021-11-28 05:36:53 UTC
799638,mainnet,252,108864000,109062097,198098,185972,12126,0.06121212733091702,2021-11-28 05:39:05 UTC
799639,mainnet,252,108864000,109062367,198368,186221,12147,0.06123467494757219,2021-11-28 05:41:21 UTC
799641,mainnet,252,108864000,109062644,198645,186484,12161,0.061219763900425384,2021-11-28 05:43:41 UTC
799642,mainnet,252,108864000,109062912,198913,186745,12168,0.06117247238742566,2021-11-28 05:45:55 UTC
799644,mainnet,252,108864000,109063141,199142,186962,12180,0.061162386638679934,2021-11-28 05:48:12 UTC
799645,mainnet,252,108864000,109063436,199437,187232,12205,0.06119727031593937,2021-11-28 05:50:43 UTC
799647,mainnet,252,108864000,109063715,199716,187507,12209,0.06113180716617597,2021-11-28 05:53:00 UTC
799648,mainnet,252,108864000,109063999,200000,187775,12225,0.061125,2021-11-28 05:55:30 UTC
799650,mainnet,252,108864000,109064308,200309,188077,12232,0.0610656535652417,2021-11-28 05:57:58 UTC
799652,mainnet,252,108864000,109064688,200689,188438,12251,0.061044701005037644,2021-11-28 06:01:17 UTC
799653,mainnet,252,108864000,109065072,201073,188816,12257,0.06095796054169381,2021-11-28 06:04:23 UTC
799655,mainnet,252,108864000,109065345,201346,189083,12263,0.06090510861899417,2021-11-28 06:06:49 UTC
799656,mainnet,252,108864000,109065630,201631,189352,12279,0.060898373761971124,2021-11-28 06:09:14 UTC
799658,mainnet,252,108864000,109065923,201924,189586,12338,0.06110219686614766,2021-11-28 06:11:31 UTC
799659,mainnet,252,108864000,109066234,202235,189888,12347,0.06105273567878953,2021-11-28 06:14:05 UTC
799660,mainnet,252,108864000,109066505,202506,190151,12355,0.06101053795936911,2021-11-28 06:16:33 UTC
799662,mainnet,252,108864000,109066789,202790,190417,12373,0.061013856699048276,2021-11-28 06:18:56 UTC
799663,mainnet,252,108864000,109067029,203030,190649,12381,0.06098113579273999,2021-11-28 06:21:01 UTC
799665,mainnet,252,108864000,109067286,203287,190895,12392,0.060958152759399274,2021-11-28 06:23:10 UTC
799666,mainnet,252,108864000,109067529,203530,191130,12400,0.06092467940844102,2021-11-28 06:25:16 UTC
799668,mainnet,252,108864000,109067755,203756,191348,12408,0.0608963662419757,2021-11-28 06:27:24 UTC
799669,mainnet,252,108864000,109068007,204008,191586,12422,0.060889769028665545,2021-11-28 06:29:28 UTC
799671,mainnet,252,108864000,109068248,204249,191817,12432,0.06086688306919495,2021-11-28 06:31:35 UTC
799672,mainnet,252,108864000,109068470,204471,192024,12447,0.06087415819358247,2021-11-28 06:33:44 UTC
799673,mainnet,252,108864000,109068731,204732,192283,12449,0.06080632241173827,2021-11-28 06:35:56 UTC
799675,mainnet,252,108864000,109068991,204992,192526,12466,0.06081212925382454,2021-11-28 06:38:09 UTC
799676,mainnet,252,108864000,109069258,205259,192786,12473,0.0607671283597796,2021-11-28 06:40:28 UTC
799678,mainnet,252,108864000,109069409,205410,192933,12477,0.06074193077260114,2021-11-28 06:42:44 UTC
799680,mainnet,252,108864000,109069782,205783,193283,12500,0.06074359883955429,2021-11-28 06:45:01 UTC
799681,mainnet,252,108864000,109070027,206028,193523,12505,0.060695633603199566,2021-11-28 06:47:16 UTC
799683,mainnet,252,108864000,109070364,206365,193843,12522,0.06067889419232913,2021-11-28 06:50:07 UTC
799684,mainnet,252,108864000,109070677,206678,194135,12543,0.06068860739894909,2021-11-28 06:53:07 UTC
799686,mainnet,252,108864000,109070948,206949,194385,12564,0.06071060986040039,2021-11-28 06:55:30 UTC
799688,mainnet,252,108864000,109071250,207251,194669,12582,0.06070899537276057,2021-11-28 06:58:09 UTC
799689,mainnet,252,108864000,109071548,207549,194940,12609,0.06075191882398855,2021-11-28 07:00:39 UTC
799691,mainnet,252,108864000,109071817,207818,195198,12620,0.06072621235889095,2021-11-28 07:02:51 UTC
799692,mainnet,252,108864000,109072070,208071,195441,12630,0.06070043398647577,2021-11-28 07:05:01 UTC
799693,mainnet,252,108864000,109072308,208309,195674,12635,0.06065508451387122,2021-11-28 07:07:07 UTC
799695,mainnet,252,108864000,109072568,208569,195926,12643,0.060617829111708835,2021-11-28 07:09:20 UTC
799696,mainnet,252,108864000,109072815,208816,196160,12656,0.06060838249942533,2021-11-28 07:11:24 UTC
799698,mainnet,252,108864000,109073085,209086,196412,12674,0.06061620577178769,2021-11-28 07:13:36 UTC
799699,mainnet,252,108864000,109073323,209324,196637,12687,0.060609390227589766,2021-11-28 07:15:43 UTC
799700,mainnet,252,108864000,109073593,209594,196881,12713,0.06065536227182076,2021-11-28 07:17:52 UTC
799702,mainnet,252,108864000,109073832,209833,197113,12720,0.060619635614989065,2021-11-28 07:19:59 UTC
799703,mainnet,252,108864000,109074064,210065,197336,12729,0.060595529955013924,2021-11-28 07:22:11 UTC
799705,mainnet,252,108864000,109074295,210296,197556,12740,0.06058127591585194,2021-11-28 07:24:16 UTC
799706,mainnet,252,108864000,109074563,210564,197814,12750,0.06055166125263578,2021-11-28 07:26:28 UTC
799707,mainnet,252,108864000,109074800,210801,198046,12755,0.060507303096285124,2021-11-28 07:28:31 UTC
799709,mainnet,252,108864000,109075058,211059,198293,12766,0.0604854566732525,2021-11-28 07:30:41 UTC
799710,mainnet,252,108864000,109075309,211310,198532,12778,0.06047039893994605,2021-11-28 07:32:47 UTC
799712,mainnet,252,108864000,109075596,211597,198814,12783,0.06041200962206458,2021-11-28 07:35:03 UTC
799713,mainnet,252,108864000,109075841,211842,199045,12797,0.060408228774275166,2021-11-28 07:37:09 UTC
799715,mainnet,252,108864000,109076116,212117,199309,12808,0.06038177043801298,2021-11-28 07:39:19 UTC
799716,mainnet,252,108864000,109076365,212366,199549,12817,0.06035335223152482,2021-11-28 07:41:27 UTC
799718,mainnet,252,108864000,109076624,212625,199807,12818,0.06028453850676073,2021-11-28 07:43:34 UTC
799719,mainnet,252,108864000,109076912,212913,200067,12846,0.06033450282509757,2021-11-28 07:45:54 UTC
799721,mainnet,252,108864000,109077187,213188,200322,12866,0.060350488770474886,2021-11-28 07:48:15 UTC
799722,mainnet,252,108864000,109077427,213428,200560,12868,0.06029199542702925,2021-11-28 07:50:16 UTC
799724,mainnet,252,108864000,109077686,213687,200810,12877,0.06026103600125417,2021-11-28 07:52:25 UTC
799725,mainnet,252,108864000,109077943,213944,201066,12878,0.06019332161687171,2021-11-28 07:54:36 UTC
799727,mainnet,252,108864000,109078266,214267,201382,12885,0.06013525181199158,2021-11-28 07:57:18 UTC
799728,mainnet,252,108864000,109078580,214581,201690,12891,0.060075216351867126,2021-11-28 07:59:57 UTC
799730,mainnet,252,108864000,109078853,214854,201951,12903,0.060054734843195845,2021-11-28 08:02:15 UTC
799731,mainnet,252,108864000,109079122,215123,202214,12909,0.06000753057553121,2021-11-28 08:04:30 UTC
799733,mainnet,252,108864000,109079720,215721,202780,12941,0.05998952350489753,2021-11-28 08:09:36 UTC
799735,mainnet,252,108864000,109080028,216029,203080,12949,0.059941026436265504,2021-11-28 08:12:12 UTC
799737,mainnet,252,108864000,109080292,216293,203340,12953,0.05988635785716597,2021-11-28 08:14:38 UTC
799738,mainnet,252,108864000,109080592,216593,203626,12967,0.05986804744382321,2021-11-28 08:17:05 UTC
799739,mainnet,252,108864000,109080877,216878,203903,12975,0.059826261769289645,2021-11-28 08:19:29 UTC
799741,mainnet,252,108864000,109081138,217139,204158,12981,0.05978198296943433,2021-11-28 08:21:47 UTC
799742,mainnet,252,108864000,109081403,217404,204406,12998,0.0597873084211882,2021-11-28 08:24:00 UTC
799744,mainnet,252,108864000,109081663,217664,204643,13021,0.05982155983534255,2021-11-28 08:26:11 UTC
799745,mainnet,252,108864000,109081932,217933,204904,13029,0.05978442915942055,2021-11-28 08:28:19 UTC
799747,mainnet,252,108864000,109082181,218182,205148,13034,0.059739116884069264,2021-11-28 08:30:24 UTC
799748,mainnet,252,108864000,109082421,218422,205383,13039,0.05969636758202013,2021-11-28 08:32:32 UTC
799749,mainnet,252,108864000,109082672,218673,205619,13054,0.059696441718913626,2021-11-28 08:34:44 UTC
799751,mainnet,252,108864000,109082937,218938,205862,13076,0.059724670911399574,2021-11-28 08:36:55 UTC
799752,mainnet,252,108864000,109083239,219240,206147,13093,0.05971994161649334,2021-11-28 08:39:32 UTC
799754,mainnet,252,108864000,109083524,219525,206430,13095,0.05965152032798087,2021-11-28 08:41:51 UTC
799755,mainnet,252,108864000,109083825,219826,206720,13106,0.059619881178750465,2021-11-28 08:44:20 UTC
799757,mainnet,252,108864000,109084107,220108,206990,13118,0.05959801551965399,2021-11-28 08:46:48 UTC
799758,mainnet,252,108864000,109084383,220384,207257,13127,0.05956421518803543,2021-11-28 08:49:16 UTC
799760,mainnet,252,108864000,109084631,220632,207491,13141,0.05956071648718227,2021-11-28 08:51:27 UTC
799761,mainnet,252,108864000,109084914,220915,207755,13160,0.059570423013376186,2021-11-28 08:53:51 UTC
799763,mainnet,252,108864000,109085229,221230,208057,13173,0.05954436559236993,2021-11-28 08:56:25 UTC
799765,mainnet,252,108864000,109085535,221536,208348,13188,0.05952982810920121,2021-11-28 08:58:55 UTC
799766,mainnet,252,108864000,109085812,221813,208611,13202,0.05951860350836065,2021-11-28 09:01:23 UTC
799768,mainnet,252,108864000,109086085,222086,208870,13216,0.05950847869744153,2021-11-28 09:03:42 UTC
799769,mainnet,252,108864000,109086345,222346,209122,13224,0.059474872496019716,2021-11-28 09:05:54 UTC
799770,mainnet,252,108864000,109086570,222571,209337,13234,0.05945967803532356,2021-11-28 09:08:05 UTC
799771,mainnet,252,108864000,109086823,222824,209566,13258,0.0594998743402865,2021-11-28 09:10:20 UTC
799773,mainnet,252,108864000,109087090,223091,209832,13259,0.05943314611526238,2021-11-28 09:12:33 UTC
799774,mainnet,252,108864000,109087373,223374,210094,13280,0.059451861004414124,2021-11-28 09:14:49 UTC
799776,mainnet,252,108864000,109087615,223616,210326,13290,0.059432240984544936,2021-11-28 09:17:09 UTC
799777,mainnet,252,108864000,109087868,223869,210567,13302,0.05941867788751457,2021-11-28 09:19:18 UTC
799778,mainnet,252,108864000,109088101,224102,210787,13315,0.05941490928238034,2021-11-28 09:21:28 UTC
799780,mainnet,252,108864000,109088352,224353,211026,13327,0.05940192464553627,2021-11-28 09:23:45 UTC
799781,mainnet,252,108864000,109088810,224811,211481,13330,0.05929425161580172,2021-11-28 09:27:39 UTC
799783,mainnet,252,108864000,109089070,225071,211734,13337,0.05925685672521116,2021-11-28 09:29:54 UTC
799785,mainnet,252,108864000,109089398,225399,212049,13350,0.05922830181145435,2021-11-28 09:32:40 UTC
799787,mainnet,252,108864000,109089944,225945,212567,13378,0.059209099559627346,2021-11-28 09:37:32 UTC
799788,mainnet,252,108864000,109090228,226229,212833,13396,0.059214335916261844,2021-11-28 09:39:50 UTC
799790,mainnet,252,108864000,109090469,226470,213068,13402,0.05917781604627544,2021-11-28 09:42:01 UTC
799791,mainnet,252,108864000,109090746,226747,213340,13407,0.05912757390395463,2021-11-28 09:44:28 UTC
799793,mainnet,252,108864000,109091040,227041,213626,13415,0.05908624433472368,2021-11-28 09:46:55 UTC
799794,mainnet,252,108864000,109091279,227280,213859,13421,0.05905051038366772,2021-11-28 09:49:07 UTC
799796,mainnet,252,108864000,109091592,227593,214153,13440,0.059052782818452235,2021-11-28 09:51:55 UTC
799797,mainnet,252,108864000,109091892,227893,214436,13457,0.05904964171782372,2021-11-28 09:54:09 UTC
799799,mainnet,252,108864000,109092191,228192,214723,13469,0.059024856261393914,2021-11-28 09:56:41 UTC
799801,mainnet,252,108864000,109092437,228438,214963,13475,0.05898755898755899,2021-11-28 09:58:58 UTC
799802,mainnet,252,108864000,109092711,228712,215222,13490,0.0589824757773969,2021-11-28 10:01:13 UTC
799804,mainnet,252,108864000,109092980,228981,215487,13494,0.05893065363501775,2021-11-28 10:03:31 UTC
799805,mainnet,252,108864000,109093276,229277,215770,13507,0.058911273263345214,2021-11-28 10:06:02 UTC
799807,mainnet,252,108864000,109093511,229512,215991,13521,0.05891195231621876,2021-11-28 10:08:11 UTC
799808,mainnet,252,108864000,109093762,229763,216227,13536,0.05891287979352637,2021-11-28 10:10:31 UTC
799810,mainnet,252,108864000,109094060,230061,216510,13551,0.058901769530689686,2021-11-28 10:12:51 UTC
799811,mainnet,252,108864000,109094343,230344,216754,13590,0.05899871496544299,2021-11-28 10:15:08 UTC
799813,mainnet,252,108864000,109094610,230611,217019,13592,0.058939079228657786,2021-11-28 10:17:18 UTC
799814,mainnet,252,108864000,109094857,230858,217253,13605,0.05893233069679197,2021-11-28 10:19:26 UTC
799816,mainnet,252,108864000,109095106,231107,217491,13616,0.05891643264808076,2021-11-28 10:21:38 UTC
799817,mainnet,252,108864000,109095376,231377,217750,13627,0.058895222947829735,2021-11-28 10:23:55 UTC
799819,mainnet,252,108864000,109095627,231628,217997,13631,0.05884867114511199,2021-11-28 10:26:03 UTC
799820,mainnet,252,108864000,109095854,231855,218217,13638,0.05882124603739406,2021-11-28 10:28:06 UTC
799821,mainnet,252,108864000,109096102,232103,218452,13651,0.0588144056733433,2021-11-28 10:30:16 UTC
799823,mainnet,252,108864000,109096390,232391,218715,13676,0.05884909484446472,2021-11-28 10:32:31 UTC
799824,mainnet,252,108864000,109096663,232664,218983,13681,0.05880153354193171,2021-11-28 10:34:47 UTC
799826,mainnet,252,108864000,109096936,232937,219244,13693,0.058784134766052626,2021-11-28 10:37:04 UTC
799828,mainnet,252,108864000,109097200,233201,219495,13706,0.05877333287593106,2021-11-28 10:39:21 UTC
799829,mainnet,252,108864000,109097465,233466,219748,13718,0.05875802043980708,2021-11-28 10:41:52 UTC
799831,mainnet,252,108864000,109097876,233877,220142,13735,0.058727450754028826,2021-11-28 10:45:11 UTC
799833,mainnet,252,108864000,109098186,234187,220430,13757,0.058743653575988417,2021-11-28 10:48:11 UTC
799834,mainnet,252,108864000,109098448,234449,220677,13772,0.058741986530119555,2021-11-28 10:50:32 UTC
799836,mainnet,252,108864000,109098716,234717,220920,13797,0.058781426142972173,2021-11-28 10:52:54 UTC
799837,mainnet,252,108864000,109098981,234982,221172,13810,0.058770459013881914,2021-11-28 10:55:24 UTC
799838,mainnet,252,108864000,109099267,235268,221433,13835,0.05880527738578982,2021-11-28 10:57:44 UTC
799839,mainnet,252,108864000,109099523,235524,221682,13842,0.05877108065420084,2021-11-28 11:00:05 UTC
799841,mainnet,252,108864000,109099778,235779,221913,13866,0.05880930871706132,2021-11-28 11:02:25 UTC
799842,mainnet,252,108864000,109100031,236032,222156,13876,0.0587886388286334,2021-11-28 11:04:34 UTC
799843,mainnet,252,108864000,109100254,236255,222370,13885,0.05877124293665743,2021-11-28 11:06:42 UTC
799844,mainnet,252,108864000,109100519,236520,222612,13908,0.05880263825469305,2021-11-28 11:08:56 UTC
799846,mainnet,252,108864000,109100769,236770,222857,13913,0.058761667440976474,2021-11-28 11:11:08 UTC
799847,mainnet,252,108864000,109101034,237035,223112,13923,0.05873816103107136,2021-11-28 11:13:24 UTC
799849,mainnet,252,108864000,109101287,237288,223361,13927,0.058692390681366106,2021-11-28 11:15:32 UTC
799850,mainnet,252,108864000,109101542,237543,223612,13931,0.05864622405206636,2021-11-28 11:17:45 UTC
799852,mainnet,252,108864000,109101800,237801,223857,13944,0.05863726393076564,2021-11-28 11:19:53 UTC
799853,mainnet,252,108864000,109102090,238091,224127,13964,0.058649843967222615,2021-11-28 11:22:23 UTC
799855,mainnet,252,108864000,109102361,238362,224380,13982,0.05865867881625427,2021-11-28 11:24:37 UTC
799856,mainnet,252,108864000,109102638,238639,224641,13998,0.05865763768705031,2021-11-28 11:26:54 UTC
799858,mainnet,252,108864000,109102926,238927,224917,14010,0.05863715695589029,2021-11-28 11:29:16 UTC
799859,mainnet,252,108864000,109103221,239222,225198,14024,0.058623370760214365,2021-11-28 11:31:47 UTC
799861,mainnet,252,108864000,109103496,239497,225464,14033,0.05859363582842374,2021-11-28 11:34:07 UTC
799862,mainnet,252,108864000,109103785,239786,225748,14038,0.05854386828255194,2021-11-28 11:36:27 UTC
799864,mainnet,252,108864000,109104066,240067,226009,14058,0.05855865237621164,2021-11-28 11:38:49 UTC
799866,mainnet,252,108864000,109104344,240345,226277,14068,0.05853252616031122,2021-11-28 11:41:24 UTC
799867,mainnet,252,108864000,109104632,240633,226539,14094,0.05857052025283315,2021-11-28 11:43:46 UTC
799869,mainnet,252,108864000,109104884,240885,226773,14112,0.058583971604707644,2021-11-28 11:45:58 UTC
799870,mainnet,252,108864000,109105141,241142,227026,14116,0.058538122765839216,2021-11-28 11:48:18 UTC
799872,mainnet,252,108864000,109105394,241395,227270,14125,0.05851405372936473,2021-11-28 11:50:30 UTC
799873,mainnet,252,108864000,109105647,241648,227517,14131,0.05847762034032974,2021-11-28 11:52:44 UTC
799875,mainnet,252,108864000,109105883,241884,227736,14148,0.05849084685221015,2021-11-28 11:54:59 UTC
799876,mainnet,252,108864000,109106169,242170,228005,14165,0.05849196845191394,2021-11-28 11:57:14 UTC
799878,mainnet,252,108864000,109106452,242453,228276,14177,0.05847318861800019,2021-11-28 11:59:46 UTC
799879,mainnet,252,108864000,109106731,242732,228539,14193,0.05847189492938714,2021-11-28 12:02:10 UTC
799881,mainnet,252,108864000,109107032,243033,228834,14199,0.05842416461961956,2021-11-28 12:04:46 UTC
799882,mainnet,252,108864000,109107346,243347,229142,14205,0.0583734338208402,2021-11-28 12:07:24 UTC
799884,mainnet,252,108864000,109107600,243601,229385,14216,0.05835772431147655,2021-11-28 12:09:39 UTC
799885,mainnet,252,108864000,109107893,243894,229664,14230,0.05834501873764832,2021-11-28 12:12:18 UTC
799887,mainnet,252,108864000,109108162,244163,229914,14249,0.058358555555100486,2021-11-28 12:14:37 UTC
799888,mainnet,252,108864000,109108435,244436,230168,14268,0.05837110736552717,2021-11-28 12:17:07 UTC
799890,mainnet,252,108864000,109108757,244758,230474,14284,0.05835968589382165,2021-11-28 12:19:53 UTC
799891,mainnet,252,108864000,109109037,245038,230737,14301,0.058362376447734635,2021-11-28 12:22:25 UTC
799893,mainnet,252,108864000,109109302,245303,230992,14311,0.05834009368006098,2021-11-28 12:24:44 UTC
799895,mainnet,252,108864000,109109586,245587,231270,14317,0.05829705969778531,2021-11-28 12:27:07 UTC
799896,mainnet,252,108864000,109109892,245893,231543,14350,0.05835871700292403,2021-11-28 12:29:52 UTC
799898,mainnet,252,108864000,109110170,246171,231812,14359,0.058329372671841934,2021-11-28 12:32:13 UTC
799899,mainnet,252,108864000,109110478,246479,232109,14370,0.05830111287371338,2021-11-28 12:34:46 UTC
799901,mainnet,252,108864000,109110736,246737,232360,14377,0.05826852073260192,2021-11-28 12:36:55 UTC
799902,mainnet,252,108864000,109110999,247000,232618,14382,0.05822672064777328,2021-11-28 12:39:07 UTC
799904,mainnet,252,108864000,109111242,247243,232852,14391,0.05820589460571179,2021-11-28 12:41:14 UTC
799905,mainnet,252,108864000,109111509,247510,233109,14401,0.05818350773706113,2021-11-28 12:43:24 UTC
799907,mainnet,252,108864000,109111747,247748,233336,14412,0.05817201349758626,2021-11-28 12:45:36 UTC
799908,mainnet,252,108864000,109111979,247980,233549,14431,0.05819420921042019,2021-11-28 12:47:42 UTC
799910,mainnet,252,108864000,109112234,248235,233790,14445,0.058190827240316635,2021-11-28 12:49:56 UTC
799911,mainnet,252,108864000,109112495,248496,234033,14463,0.05820214409889898,2021-11-28 12:52:12 UTC
799913,mainnet,252,108864000,109112792,248793,234309,14484,0.05821707202373057,2021-11-28 12:54:36 UTC
799914,mainnet,252,108864000,109113088,249089,234596,14493,0.058184022578275235,2021-11-28 12:57:15 UTC
799916,mainnet,252,108864000,109113348,249349,234840,14509,0.05818752030286867,2021-11-28 12:59:30 UTC
799917,mainnet,252,108864000,109113694,249695,235157,14538,0.05822303209916098,2021-11-28 13:02:27 UTC
799919,mainnet,252,108864000,109114063,250064,235494,14570,0.05826508413846056,2021-11-28 13:05:24 UTC
799920,mainnet,252,108864000,109114309,250310,235728,14582,0.05825576285406096,2021-11-28 13:07:37 UTC
799922,mainnet,252,108864000,109114632,250633,236030,14603,0.05826447435094341,2021-11-28 13:10:25 UTC
799923,mainnet,252,108864000,109114888,250889,236276,14613,0.05824488120244411,2021-11-28 13:12:45 UTC
799925,mainnet,252,108864000,109115207,251208,236586,14622,0.05820674500812076,2021-11-28 13:15:19 UTC
799926,mainnet,252,108864000,109115491,251492,236855,14637,0.05820065847024955,2021-11-28 13:17:56 UTC
799928,mainnet,252,108864000,109115771,251772,237127,14645,0.058167707290723354,2021-11-28 13:20:23 UTC
799929,mainnet,252,108864000,109116064,252065,237407,14658,0.058151667228691015,2021-11-28 13:22:51 UTC
799931,mainnet,252,108864000,109116360,252361,237662,14699,0.05824592547976906,2021-11-28 13:25:18 UTC
799932,mainnet,252,108864000,109116648,252649,237941,14708,0.05821515224679298,2021-11-28 13:27:44 UTC
799934,mainnet,252,108864000,109116949,252950,238216,14734,0.05824866574421823,2021-11-28 13:30:13 UTC
799935,mainnet,252,108864000,109117225,253226,238479,14747,0.05823651599756739,2021-11-28 13:32:35 UTC
799937,mainnet,252,108864000,109117506,253507,238745,14762,0.05823113365705878,2021-11-28 13:34:57 UTC
799938,mainnet,252,108864000,109117770,253771,238998,14773,0.05821390150962876,2021-11-28 13:37:22 UTC
799940,mainnet,252,108864000,109118095,254096,239307,14789,0.05820241168692148,2021-11-28 13:40:10 UTC
799941,mainnet,252,108864000,109118392,254393,239586,14807,0.05820521791087019,2021-11-28 13:42:37 UTC
799943,mainnet,252,108864000,109118639,254640,239821,14819,0.05819588438579956,2021-11-28 13:44:57 UTC
799944,mainnet,252,108864000,109118913,254914,240080,14834,0.05819217461575276,2021-11-28 13:47:25 UTC
799946,mainnet,252,108864000,109119192,255193,240344,14849,0.0581873327246437,2021-11-28 13:49:47 UTC
799947,mainnet,252,108864000,109119462,255463,240601,14862,0.058176722265063825,2021-11-28 13:52:00 UTC
799949,mainnet,252,108864000,109119746,255747,240872,14875,0.05816295010303151,2021-11-28 13:54:25 UTC
799950,mainnet,252,108864000,109120009,256010,241129,14881,0.05812663567829382,2021-11-28 13:56:43 UTC
799952,mainnet,252,108864000,109120285,256286,241404,14882,0.058067939723590055,2021-11-28 13:59:01 UTC
799953,mainnet,252,108864000,109120546,256547,241663,14884,0.05801665971537379,2021-11-28 14:01:31 UTC
799955,mainnet,252,108864000,109120858,256859,241955,14904,0.058024052106408576,2021-11-28 14:04:17 UTC
799956,mainnet,252,108864000,109121208,257209,242274,14935,0.058065619787799026,2021-11-28 14:07:12 UTC
799958,mainnet,252,108864000,109121453,257454,242504,14950,0.05806862585160844,2021-11-28 14:09:24 UTC
799959,mainnet,252,108864000,109121703,257704,242725,14979,0.058124825381057336,2021-11-28 14:11:38 UTC
799961,mainnet,252,108864000,109121912,257913,242921,14992,0.05812812847743231,2021-11-28 14:13:47 UTC
799962,mainnet,252,108864000,109122090,258091,243074,15017,0.05818490377425017,2021-11-28 14:15:57 UTC
799964,mainnet,252,108864000,109122379,258380,243338,15042,0.05821658023066801,2021-11-28 14:18:07 UTC
799965,mainnet,252,108864000,109122592,258593,243532,15061,0.058242102454436125,2021-11-28 14:20:15 UTC
799967,mainnet,252,108864000,109122838,258839,243763,15076,0.05824470037359131,2021-11-28 14:22:26 UTC
799968,mainnet,252,108864000,109123082,259083,244004,15079,0.05820142579791032,2021-11-28 14:24:40 UTC
799970,mainnet,252,108864000,109123313,259314,244209,15105,0.058249843818690854,2021-11-28 14:26:54 UTC
799971,mainnet,252,108864000,109123548,259549,244438,15111,0.05822022045933523,2021-11-28 14:29:05 UTC
799972,mainnet,252,108864000,109123794,259795,244683,15112,0.05816894089570623,2021-11-28 14:31:13 UTC
799974,mainnet,252,108864000,109124052,260053,244922,15131,0.05818429320177041,2021-11-28 14:33:25 UTC
799975,mainnet,252,108864000,109124300,260301,245165,15136,0.05814806704545891,2021-11-28 14:35:39 UTC
799976,mainnet,252,108864000,109124593,260594,245445,15149,0.0581325740423801,2021-11-28 14:37:51 UTC
799977,mainnet,252,108864000,109124834,260835,245680,15155,0.05810186516380087,2021-11-28 14:39:55 UTC
799979,mainnet,252,108864000,109125102,261103,245927,15176,0.05812265657614045,2021-11-28 14:42:04 UTC
799980,mainnet,252,108864000,109125359,261360,246165,15195,0.05813820018365473,2021-11-28 14:44:13 UTC
799982,mainnet,252,108864000,109125619,261620,246417,15203,0.058111000688020796,2021-11-28 14:46:25 UTC
799983,mainnet,252,108864000,109125857,261858,246644,15214,0.05810019170695568,2021-11-28 14:48:32 UTC
799985,mainnet,252,108864000,109126118,262119,246894,15225,0.058084305220148104,2021-11-28 14:50:45 UTC
799986,mainnet,252,108864000,109126352,262353,247127,15226,0.058036309857329625,2021-11-28 14:53:00 UTC
799987,mainnet,252,108864000,109126617,262618,247374,15244,0.05804628776397657,2021-11-28 14:55:16 UTC
799989,mainnet,252,108864000,109126886,262887,247627,15260,0.05804775435833647,2021-11-28 14:57:37 UTC
799991,mainnet,252,108864000,109127166,263167,247888,15279,0.058058191186584944,2021-11-28 15:00:13 UTC
799992,mainnet,252,108864000,109127419,263420,248123,15297,0.05807076152152456,2021-11-28 15:02:27 UTC
799994,mainnet,252,108864000,109127670,263671,248360,15311,0.058068577886836246,2021-11-28 15:04:50 UTC
799995,mainnet,252,108864000,109127966,263967,248633,15334,0.05809059465766554,2021-11-28 15:07:20 UTC
799997,mainnet,252,108864000,109128245,264246,248900,15346,0.05807467284272988,2021-11-28 15:09:41 UTC
799998,mainnet,252,108864000,109128484,264485,249135,15350,0.058037317806302814,2021-11-28 15:12:01 UTC
800000,mainnet,252,108864000,109128801,264802,249431,15371,0.05804714465902826,2021-11-28 15:14:20 UTC
800001,mainnet,252,108864000,109129043,265044,249664,15380,0.05802810099455185,2021-11-28 15:16:35 UTC
800003,mainnet,252,108864000,109129301,265302,249913,15389,0.05800559362537787,2021-11-28 15:19:03 UTC
800004,mainnet,252,108864000,109129550,265551,250155,15396,0.05797756363184473,2021-11-28 15:21:23 UTC
800006,mainnet,252,108864000,109129787,265788,250378,15410,0.0579785392869505,2021-11-28 15:23:28 UTC
800007,mainnet,252,108864000,109130049,266050,250622,15428,0.057989099793271943,2021-11-28 15:25:39 UTC
800008,mainnet,252,108864000,109130291,266292,250854,15438,0.05797395340453337,2021-11-28 15:27:51 UTC
800010,mainnet,252,108864000,109130568,266569,251101,15468,0.05802625211483706,2021-11-28 15:30:08 UTC
800011,mainnet,252,108864000,109130886,266887,251401,15486,0.058024557209605566,2021-11-28 15:32:53 UTC
800013,mainnet,252,108864000,109131174,267175,251676,15499,0.05801066716571535,2021-11-28 15:35:12 UTC
800014,mainnet,252,108864000,109131505,267506,251995,15511,0.05798374615896466,2021-11-28 15:38:03 UTC
800016,mainnet,252,108864000,109131831,267832,252304,15528,0.057976642074136026,2021-11-28 15:40:46 UTC
800018,mainnet,252,108864000,109132152,268153,252607,15546,0.05797436538095788,2021-11-28 15:43:17 UTC
800019,mainnet,252,108864000,109132435,268436,252872,15564,0.0579803007048235,2021-11-28 15:45:44 UTC
800021,mainnet,252,108864000,109132812,268813,253210,15603,0.058044067809220536,2021-11-28 15:48:41 UTC
800022,mainnet,252,108864000,109133096,269097,253493,15604,0.05798652530500154,2021-11-28 15:50:59 UTC
800024,mainnet,252,108864000,109133347,269348,253740,15608,0.05794733950131428,2021-11-28 15:53:10 UTC
800025,mainnet,252,108864000,109133632,269633,254011,15622,0.057938012038585784,2021-11-28 15:55:30 UTC
800027,mainnet,252,108864000,109133922,269923,254279,15644,0.057957269295317554,2021-11-28 15:58:08 UTC
800028,mainnet,252,108864000,109134181,270182,254525,15657,0.057949826413306586,2021-11-28 16:00:28 UTC
800029,mainnet,252,108864000,109134489,270490,254811,15679,0.0579651743132833,2021-11-28 16:03:02 UTC
800031,mainnet,252,108864000,109134751,270752,255061,15691,0.057953403852972464,2021-11-28 16:05:21 UTC
800032,mainnet,252,108864000,109135086,271087,255390,15697,0.0579039201437177,2021-11-28 16:08:08 UTC
800034,mainnet,252,108864000,109135318,271319,255608,15711,0.05790600731979699,2021-11-28 16:10:19 UTC
800035,mainnet,252,108864000,109135580,271581,255862,15719,0.05787960129758709,2021-11-28 16:12:39 UTC
800037,mainnet,252,108864000,109135848,271849,256128,15721,0.05782989821555349,2021-11-28 16:14:58 UTC
800038,mainnet,252,108864000,109136117,272118,256374,15744,0.05785725310343307,2021-11-28 16:17:25 UTC
800040,mainnet,252,108864000,109136369,272370,256600,15770,0.057899181260784964,2021-11-28 16:19:40 UTC
800041,mainnet,252,108864000,109136661,272662,256878,15784,0.05788852131943578,2021-11-28 16:22:17 UTC
800042,mainnet,252,108864000,109136943,272944,257138,15806,0.057909314731226916,2021-11-28 16:25:13 UTC
800044,mainnet,252,108864000,109137246,273247,257430,15817,0.05788535647234919,2021-11-28 16:27:42 UTC
800045,mainnet,252,108864000,109137484,273485,257655,15830,0.057882516408578166,2021-11-28 16:30:12 UTC
800047,mainnet,252,108864000,109137774,273775,257932,15843,0.05786868779106931,2021-11-28 16:32:41 UTC
800048,mainnet,252,108864000,109138076,274077,258216,15861,0.05787059840847645,2021-11-28 16:35:22 UTC
800050,mainnet,252,108864000,109138372,274373,258499,15874,0.05785554701082104,2021-11-28 16:38:06 UTC
800052,mainnet,252,108864000,109138612,274613,258724,15889,0.057859606063806156,2021-11-28 16:40:29 UTC
800053,mainnet,252,108864000,109138890,274891,258984,15907,0.05786657256876362,2021-11-28 16:43:00 UTC
800054,mainnet,252,108864000,109139128,275129,259189,15940,0.05793645889746264,2021-11-28 16:45:28 UTC
800056,mainnet,252,108864000,109139391,275392,259413,15979,0.05802274575877295,2021-11-28 16:48:08 UTC
800058,mainnet,252,108864000,109139752,275753,259762,15991,0.05799030291601542,2021-11-28 16:51:17 UTC
800059,mainnet,252,108864000,109140010,276011,259996,16015,0.05802304980598599,2021-11-28 16:53:33 UTC
800061,mainnet,252,108864000,109140265,276266,260233,16033,0.05803464776700716,2021-11-28 16:55:55 UTC
800062,mainnet,252,108864000,109140519,276520,260471,16049,0.058039201504411976,2021-11-28 16:58:23 UTC
800064,mainnet,252,108864000,109140827,276828,260751,16077,0.05807577268195414,2021-11-28 17:01:06 UTC
800065,mainnet,252,108864000,109141138,277139,261054,16085,0.05803946755960006,2021-11-28 17:04:00 UTC
800067,mainnet,252,108864000,109141412,277413,261321,16092,0.05800737528522456,2021-11-28 17:06:28 UTC
800068,mainnet,252,108864000,109141666,277667,261558,16109,0.05801553659599448,2021-11-28 17:08:49 UTC
800070,mainnet,252,108864000,109141934,277935,261807,16128,0.05802795617680393,2021-11-28 17:11:07 UTC
800071,mainnet,252,108864000,109142228,278229,262088,16141,0.058013363092991745,2021-11-28 17:13:44 UTC
800073,mainnet,252,108864000,109142479,278480,262337,16143,0.057968256248204536,2021-11-28 17:16:00 UTC
800074,mainnet,252,108864000,109142749,278750,262595,16155,0.057955156950672645,2021-11-28 17:18:21 UTC
800075,mainnet,252,108864000,109143010,279011,262837,16174,0.05796904064714294,2021-11-28 17:20:40 UTC
800077,mainnet,252,108864000,109143298,279299,263107,16192,0.05797371275944418,2021-11-28 17:23:08 UTC
800078,mainnet,252,108864000,109143531,279532,263326,16206,0.05797547329107222,2021-11-28 17:25:30 UTC
800080,mainnet,252,108864000,109143802,279803,263583,16220,0.057969357011897656,2021-11-28 17:27:59 UTC
800081,mainnet,252,108864000,109144059,280060,263840,16220,0.057916160822680855,2021-11-28 17:30:13 UTC
800083,mainnet,252,108864000,109144297,280298,264054,16244,0.05795260758193066,2021-11-28 17:32:32 UTC
800084,mainnet,252,108864000,109144506,280507,264245,16262,0.05797359780682835,2021-11-28 17:34:54 UTC
800086,mainnet,252,108864000,109144840,280841,264550,16291,0.058007911950178216,2021-11-28 17:37:28 UTC
800087,mainnet,252,108864000,109145075,281076,264766,16310,0.05802701048826652,2021-11-28 17:39:51 UTC
800089,mainnet,252,108864000,109145351,281352,265015,16337,0.058066052489408285,2021-11-28 17:42:11 UTC
800090,mainnet,252,108864000,109145591,281592,265240,16352,0.05806983152930481,2021-11-28 17:44:31 UTC
800092,mainnet,252,108864000,109145833,281834,265472,16362,0.058055451081132865,2021-11-28 17:46:51 UTC
800093,mainnet,252,108864000,109146132,282133,265754,16379,0.058054180120723206,2021-11-28 17:49:26 UTC
800095,mainnet,252,108864000,109146398,282399,266002,16397,0.05806323676783558,2021-11-28 17:51:45 UTC
800096,mainnet,252,108864000,109146647,282648,266234,16414,0.05807223118507826,2021-11-28 17:54:01 UTC
800097,mainnet,252,108864000,109146908,282909,266483,16426,0.05806107264173285,2021-11-28 17:56:20 UTC
800099,mainnet,252,108864000,109147176,283177,266732,16445,0.05807321922331263,2021-11-28 17:58:48 UTC
800100,mainnet,252,108864000,109147468,283469,267006,16463,0.05807689729741171,2021-11-28 18:01:35 UTC
800102,mainnet,252,108864000,109147704,283705,267221,16484,0.05810260658077933,2021-11-28 18:03:55 UTC
800103,mainnet,252,108864000,109147969,283970,267465,16505,0.05812233686657041,2021-11-28 18:06:17 UTC
800105,mainnet,252,108864000,109148248,284249,267732,16517,0.05810750433598711,2021-11-28 18:08:44 UTC
800106,mainnet,252,108864000,109148536,284537,267992,16545,0.05814709510538173,2021-11-28 18:11:15 UTC
800108,mainnet,252,108864000,109148821,284822,268263,16559,0.058138065177549485,2021-11-28 18:13:44 UTC
800109,mainnet,252,108864000,109149126,285127,268551,16576,0.058135497515142374,2021-11-28 18:16:20 UTC
800111,mainnet,252,108864000,109149395,285396,268793,16603,0.05817530729232365,2021-11-28 18:18:42 UTC
800112,mainnet,252,108864000,109149671,285672,269043,16629,0.05821011509703436,2021-11-28 18:21:24 UTC
800114,mainnet,252,108864000,109149916,285917,269260,16657,0.05825816583134266,2021-11-28 18:23:39 UTC
800115,mainnet,252,108864000,109150150,286151,269490,16661,0.058224503845871585,2021-11-28 18:26:03 UTC
800117,mainnet,252,108864000,109150409,286410,269718,16692,0.05828008798575469,2021-11-28 18:28:19 UTC
800118,mainnet,252,108864000,109150659,286660,269943,16717,0.058316472476104095,2021-11-28 18:30:47 UTC
800120,mainnet,252,108864000,109150912,286913,270186,16727,0.0582999027579789,2021-11-28 18:33:09 UTC
800121,mainnet,252,108864000,109151161,287162,270418,16744,0.05830855057424032,2021-11-28 18:35:30 UTC
800123,mainnet,252,108864000,109151395,287396,270642,16754,0.058295870506200505,2021-11-28 18:37:50 UTC
800124,mainnet,252,108864000,109151618,287619,270860,16759,0.05826805600464503,2021-11-28 18:40:16 UTC
800126,mainnet,252,108864000,109151842,287843,271058,16785,0.05831303870512745,2021-11-28 18:42:39 UTC
800127,mainnet,252,108864000,109152068,288069,271265,16804,0.05833324654856996,2021-11-28 18:45:07 UTC
800129,mainnet,252,108864000,109152311,288312,271492,16820,0.058339576569827134,2021-11-28 18:47:47 UTC
800130,mainnet,252,108864000,109152511,288512,271671,16841,0.05837192213842059,2021-11-28 18:50:14 UTC
800131,mainnet,252,108864000,109152818,288819,271936,16883,0.05845529553111118,2021-11-28 18:53:01 UTC
800133,mainnet,252,108864000,109153085,289086,272175,16911,0.058498163176355825,2021-11-28 18:55:43 UTC
800134,mainnet,252,108864000,109153355,289356,272406,16950,0.05857836022062788,2021-11-28 18:58:07 UTC
800136,mainnet,252,108864000,109153626,289627,272661,16966,0.058578792723054135,2021-11-28 19:00:37 UTC
800137,mainnet,252,108864000,109153920,289921,272939,16982,0.058574577212413034,2021-11-28 19:03:04 UTC
800139,mainnet,252,108864000,109154187,290188,273201,16987,0.05853791335272306,2021-11-28 19:05:40 UTC
800140,mainnet,252,108864000,109154465,290466,273451,17015,0.05857828454965469,2021-11-28 19:08:09 UTC
800142,mainnet,252,108864000,109154671,290672,273645,17027,0.05857805361369516,2021-11-28 19:10:33 UTC
800143,mainnet,252,108864000,109154948,290949,273895,17054,0.05861508374319898,2021-11-28 19:13:14 UTC
800145,mainnet,252,108864000,109155266,291267,274190,17077,0.058630054211428,2021-11-28 19:15:53 UTC
800146,mainnet,252,108864000,109155503,291504,274382,17122,0.05873675832921675,2021-11-28 19:18:06 UTC
800148,mainnet,252,108864000,109155781,291782,274644,17138,0.05873563139604225,2021-11-28 19:20:43 UTC
800149,mainnet,252,108864000,109156052,292053,274899,17154,0.058735914371706506,2021-11-28 19:22:59 UTC
800151,mainnet,252,108864000,109156372,292373,275211,17162,0.05869899067287335,2021-11-28 19:25:47 UTC
800152,mainnet,252,108864000,109156604,292605,275426,17179,0.0587105483501649,2021-11-28 19:27:58 UTC
800154,mainnet,252,108864000,109156857,292858,275659,17199,0.058728120795744014,2021-11-28 19:30:15 UTC
800155,mainnet,252,108864000,109157085,293086,275880,17206,0.05870631828200597,2021-11-28 19:32:27 UTC
800157,mainnet,252,108864000,109157348,293349,276124,17225,0.05871845480979993,2021-11-28 19:34:42 UTC
800158,mainnet,252,108864000,109157611,293612,276373,17239,0.05871354031851559,2021-11-28 19:37:04 UTC
800159,mainnet,252,108864000,109157878,293879,276610,17269,0.058762279713759746,2021-11-28 19:39:39 UTC
800161,mainnet,252,108864000,109158139,294140,276850,17290,0.05878153260352213,2021-11-28 19:42:07 UTC
800162,mainnet,252,108864000,109158399,294400,277097,17303,0.05877377717391304,2021-11-28 19:44:30 UTC
800164,mainnet,252,108864000,109158725,294726,277390,17336,0.05882073519133025,2021-11-28 19:47:26 UTC
800166,mainnet,252,108864000,109159017,295018,277652,17366,0.05886420489597245,2021-11-28 19:50:03 UTC
800167,mainnet,252,108864000,109159288,295289,277903,17386,0.0588779128243856,2021-11-28 19:52:28 UTC
800169,mainnet,252,108864000,109159584,295585,278177,17408,0.05889338092257726,2021-11-28 19:54:54 UTC
800170,mainnet,252,108864000,109159839,295840,278420,17420,0.05888318009734992,2021-11-28 19:57:13 UTC
800172,mainnet,252,108864000,109160093,296094,278655,17439,0.05889683681533567,2021-11-28 19:59:31 UTC
800173,mainnet,252,108864000,109160374,296375,278916,17459,0.058908477435681145,2021-11-28 20:02:07 UTC
800174,mainnet,252,108864000,109160666,296667,279195,17472,0.05889431584908331,2021-11-28 20:04:38 UTC
800176,mainnet,252,108864000,109160914,296915,279430,17485,0.05888890759981813,2021-11-28 20:06:54 UTC
800177,mainnet,252,108864000,109161165,297166,279678,17488,0.05884926270165497,2021-11-28 20:09:14 UTC
800179,mainnet,252,108864000,109161428,297429,279936,17493,0.05881403629101399,2021-11-28 20:11:30 UTC
800180,mainnet,252,108864000,109161736,297737,280239,17498,0.05876998827824557,2021-11-28 20:14:05 UTC
800181,mainnet,252,108864000,109161979,297980,280461,17519,0.05879253641183972,2021-11-28 20:16:23 UTC
800183,mainnet,252,108864000,109162237,298238,280696,17542,0.05881879572690268,2021-11-28 20:19:07 UTC
800184,mainnet,252,108864000,109162587,298588,281006,17582,0.05888381314721288,2021-11-28 20:21:46 UTC
800186,mainnet,252,108864000,109162841,298842,281242,17600,0.05889399749700511,2021-11-28 20:24:05 UTC
800187,mainnet,252,108864000,109163110,299111,281505,17606,0.05886109170174283,2021-11-28 20:26:23 UTC
800189,mainnet,252,108864000,109163369,299370,281741,17629,0.0588869960249858,2021-11-28 20:28:43 UTC
800190,mainnet,252,108864000,109163654,299655,282020,17635,0.05885101199713003,2021-11-28 20:31:10 UTC
800192,mainnet,252,108864000,109163916,299917,282273,17644,0.058829609525302,2021-11-28 20:33:40 UTC
800193,mainnet,252,108864000,109164199,300200,282540,17660,0.05882744836775483,2021-11-28 20:36:09 UTC
800194,mainnet,252,108864000,109164434,300435,282746,17689,0.05887796029091151,2021-11-28 20:38:39 UTC
800195,mainnet,252,108864000,109164679,300680,282954,17726,0.05895303977650659,2021-11-28 20:41:01 UTC
800196,mainnet,252,108864000,109164955,300956,283191,17765,0.05902856231475698,2021-11-28 20:43:40 UTC
800197,mainnet,252,108864000,109165231,301232,283447,17785,0.05904087215169703,2021-11-28 20:46:08 UTC
800199,mainnet,252,108864000,109165489,301490,283663,17827,0.059129656041659755,2021-11-28 20:48:32 UTC
800200,mainnet,252,108864000,109165730,301731,283889,17842,0.05913214088045312,2021-11-28 20:50:43 UTC
800202,mainnet,252,108864000,109165969,301970,284111,17859,0.05914163658641587,2021-11-28 20:53:02 UTC
800204,mainnet,252,108864000,109166223,302224,284358,17866,0.05911509344062682,2021-11-28 20:55:27 UTC
800205,mainnet,252,108864000,109166480,302481,284602,17879,0.05910784479025129,2021-11-28 20:57:44 UTC
800207,mainnet,252,108864000,109166707,302708,284817,17891,0.05910316212323427,2021-11-28 20:59:52 UTC
800208,mainnet,252,108864000,109166942,302943,285037,17906,0.05910682867734194,2021-11-28 21:02:21 UTC
800210,mainnet,252,108864000,109167198,303199,285242,17957,0.059225129370479454,2021-11-28 21:04:38 UTC
800212,mainnet,252,108864000,109167502,303503,285515,17988,0.05926794792802707,2021-11-28 21:07:34 UTC
800213,mainnet,252,108864000,109167721,303722,285721,18001,0.05926801482935053,2021-11-28 21:09:42 UTC
800215,mainnet,252,108864000,109168004,304005,285992,18013,0.05925231492903077,2021-11-28 21:12:21 UTC
800216,mainnet,252,108864000,109168221,304222,286203,18019,0.05922977299472096,2021-11-28 21:14:33 UTC
800217,mainnet,252,108864000,109168464,304465,286420,18045,0.05926789614569819,2021-11-28 21:16:43 UTC
800219,mainnet,252,108864000,109168680,304681,286626,18055,0.05925870008303767,2021-11-28 21:18:58 UTC
800220,mainnet,252,108864000,109168969,304970,286880,18090,0.05931730989933436,2021-11-28 21:21:17 UTC
800222,mainnet,252,108864000,109169198,305199,287086,18113,0.0593481630018447,2021-11-28 21:23:36 UTC
800223,mainnet,252,108864000,109169506,305507,287364,18143,0.05938652796826259,2021-11-28 21:26:23 UTC
800225,mainnet,252,108864000,109169730,305731,287557,18174,0.05944441355309079,2021-11-28 21:28:32 UTC
800227,mainnet,252,108864000,109169965,305966,287752,18214,0.059529490204794,2021-11-28 21:31:02 UTC
800228,mainnet,252,108864000,109170191,306192,287944,18248,0.0595965929874066,2021-11-28 21:33:18 UTC
800229,mainnet,252,108864000,109170456,306457,288178,18279,0.059646214640226854,2021-11-28 21:35:43 UTC
800231,mainnet,252,108864000,109170686,306687,288401,18286,0.05962430751874061,2021-11-28 21:37:53 UTC
800232,mainnet,252,108864000,109170929,306930,288625,18305,0.05963900563646434,2021-11-28 21:40:07 UTC
800234,mainnet,252,108864000,109171162,307163,288838,18325,0.059658878185198085,2021-11-28 21:42:39 UTC
800236,mainnet,252,108864000,109171401,307402,289048,18354,0.05970683339731036,2021-11-28 21:44:51 UTC
800237,mainnet,252,108864000,109171692,307693,289298,18395,0.05978361548686516,2021-11-28 21:47:07 UTC
800239,mainnet,252,108864000,109171948,307949,289539,18410,0.05978262634397254,2021-11-28 21:49:32 UTC
800240,mainnet,252,108864000,109172162,308163,289742,18421,0.05977680643036315,2021-11-28 21:51:38 UTC
800242,mainnet,252,108864000,109172405,308406,289977,18429,0.05975564677730005,2021-11-28 21:53:51 UTC
800243,mainnet,252,108864000,109172628,308629,290183,18446,0.05976755262791248,2021-11-28 21:55:59 UTC
800244,mainnet,252,108864000,109172883,308884,290407,18477,0.05981857266805662,2021-11-28 21:58:08 UTC
800245,mainnet,252,108864000,109173102,309103,290610,18493,0.059827953788866496,2021-11-28 22:00:28 UTC
800247,mainnet,252,108864000,109173354,309355,290837,18518,0.05986003135556238,2021-11-28 22:02:44 UTC
800248,mainnet,252,108864000,109173562,309563,291027,18536,0.05987795699098406,2021-11-28 22:04:55 UTC
800250,mainnet,252,108864000,109173777,309778,291226,18552,0.059888048860797086,2021-11-28 22:07:05 UTC
800251,mainnet,252,108864000,109174017,310018,291441,18577,0.059922327090685054,2021-11-28 22:09:27 UTC
800253,mainnet,252,108864000,109174248,310249,291634,18615,0.06000019339304881,2021-11-28 22:11:52 UTC
800254,mainnet,252,108864000,109174447,310448,291806,18642,0.06004870380868938,2021-11-28 22:14:00 UTC
800256,mainnet,252,108864000,109174712,310713,292037,18676,0.060106915384937225,2021-11-28 22:16:20 UTC
800257,mainnet,252,108864000,109174941,310942,292231,18711,0.06017520952460587,2021-11-28 22:18:37 UTC
800259,mainnet,252,108864000,109175166,311167,292430,18737,0.06021525418826547,2021-11-28 22:20:53 UTC
800260,mainnet,252,108864000,109175393,311394,292636,18758,0.060238797150876384,2021-11-28 22:23:12 UTC
800262,mainnet,252,108864000,109175649,311650,292871,18779,0.06025669821915611,2021-11-28 22:25:32 UTC
800263,mainnet,252,108864000,109175885,311886,293092,18794,0.06025919727079766,2021-11-28 22:27:46 UTC
800265,mainnet,252,108864000,109176094,312095,293274,18821,0.06030535574104039,2021-11-28 22:30:14 UTC
800266,mainnet,252,108864000,109176326,312327,293481,18846,0.06034060455868369,2021-11-28 22:32:23 UTC
800268,mainnet,252,108864000,109176535,312536,293674,18862,0.060351447513246476,2021-11-28 22:34:32 UTC
800269,mainnet,252,108864000,109176771,312772,293884,18888,0.060389037381862826,2021-11-28 22:36:54 UTC
800270,mainnet,252,108864000,109176997,312998,294102,18896,0.060370992785896395,2021-11-28 22:39:09 UTC
800272,mainnet,252,108864000,109177211,313212,294296,18916,0.06039359922352911,2021-11-28 22:41:14 UTC
800273,mainnet,252,108864000,109177439,313440,294510,18930,0.06039433384379786,2021-11-28 22:43:27 UTC
800274,mainnet,252,108864000,109177632,313633,294690,18943,0.06039861876779548,2021-11-28 22:45:34 UTC
800276,mainnet,252,108864000,109177792,313793,294831,18962,0.060428371569792826,2021-11-28 22:47:49 UTC
800277,mainnet,252,108864000,109178090,314091,295074,19017,0.06054614745408178,2021-11-28 22:49:56 UTC
800279,mainnet,252,108864000,109178283,314284,295261,19023,0.06052805742576778,2021-11-28 22:52:07 UTC
800280,mainnet,252,108864000,109178505,314506,295464,19042,0.06054574475526699,2021-11-28 22:54:23 UTC
800282,mainnet,252,108864000,109178698,314699,295650,19049,0.06053085646919755,2021-11-28 22:56:33 UTC
800283,mainnet,252,108864000,109178922,314923,295864,19059,0.06051955557390219,2021-11-28 22:58:52 UTC
800285,mainnet,252,108864000,109179176,315177,296098,19079,0.06053423949082579,2021-11-28 23:01:21 UTC
800286,mainnet,252,108864000,109179397,315398,296294,19104,0.060571087958706145,2021-11-28 23:03:37 UTC
800288,mainnet,252,108864000,109179620,315621,296467,19154,0.060686709692954525,2021-11-28 23:05:50 UTC
800289,mainnet,252,108864000,109179861,315862,296673,19189,0.060751214137819684,2021-11-28 23:08:28 UTC
800291,mainnet,252,108864000,109180066,316067,296858,19209,0.06077508882610333,2021-11-28 23:10:44 UTC
800292,mainnet,252,108864000,109180280,316281,297046,19235,0.06081617296012091,2021-11-28 23:12:58 UTC
800294,mainnet,252,108864000,109180526,316527,297259,19268,0.0608731640586743,2021-11-28 23:15:29 UTC
800295,mainnet,252,108864000,109180741,316742,297425,19317,0.06098654425368281,2021-11-28 23:17:43 UTC
800296,mainnet,252,108864000,109180940,316941,297597,19344,0.06103344155536835,2021-11-28 23:20:12 UTC
800298,mainnet,252,108864000,109181171,317172,297803,19369,0.06106781178666465,2021-11-28 23:22:42 UTC
800299,mainnet,252,108864000,109181357,317358,297945,19413,0.06117066530542794,2021-11-28 23:24:50 UTC
800301,mainnet,252,108864000,109181582,317583,298130,19453,0.0612532786704578,2021-11-28 23:27:16 UTC
800302,mainnet,252,108864000,109181814,317815,298332,19483,0.06130295926875698,2021-11-28 23:29:36 UTC
800304,mainnet,252,108864000,109182063,318064,298550,19514,0.061352432214900145,2021-11-28 23:32:03 UTC
800306,mainnet,252,108864000,109182260,318261,298723,19538,0.06138986555060155,2021-11-28 23:34:15 UTC
800307,mainnet,252,108864000,109182480,318481,298903,19578,0.061473054907514105,2021-11-28 23:36:33 UTC
800309,mainnet,252,108864000,109182669,318670,299071,19599,0.06150249474377883,2021-11-28 23:38:45 UTC
800310,mainnet,252,108864000,109182895,318896,299257,19639,0.061584340976368473,2021-11-28 23:41:02 UTC
800312,mainnet,252,108864000,109183092,319093,299438,19655,0.06159646247332282,2021-11-28 23:43:17 UTC
800313,mainnet,252,108864000,109183299,319300,299615,19685,0.06165048543689321,2021-11-28 23:45:42 UTC
800315,mainnet,252,108864000,109183559,319560,299844,19716,0.06169733383402178,2021-11-28 23:47:57 UTC
800316,mainnet,252,108864000,109183782,319783,300045,19738,0.06172310598124353,2021-11-28 23:50:14 UTC
800318,mainnet,252,108864000,109183983,319984,300225,19759,0.06174996249812491,2021-11-28 23:52:27 UTC
800319,mainnet,252,108864000,109184212,320213,300413,19800,0.061833841849019244,2021-11-28 23:54:51 UTC
800321,mainnet,252,108864000,109184421,320422,300595,19827,0.061877773685951654,2021-11-28 23:57:03 UTC
800322,mainnet,252,108864000,109184649,320650,300793,19857,0.061927335100576957,2021-11-28 23:59:28 UTC
800324,mainnet,252,108864000,109184796,320797,300927,19870,0.061939481977699294,2021-11-29 00:01:49 UTC
800325,mainnet,252,108864000,109185127,321128,301216,19912,0.06200642734361376,2021-11-29 00:03:59 UTC
800327,mainnet,252,108864000,109185330,321331,301402,19929,0.06202015989742664,2021-11-29 00:06:11 UTC
800328,mainnet,252,108864000,109185545,321546,301603,19943,0.06202223010082539,2021-11-29 00:08:26 UTC
800330,mainnet,252,108864000,109185756,321757,301784,19973,0.06207479557554303,2021-11-29 00:10:51 UTC
800331,mainnet,252,108864000,109185968,321969,301976,19993,0.06209604030201665,2021-11-29 00:13:01 UTC
800332,mainnet,252,108864000,109186186,322187,302163,20024,0.06215024194023967,2021-11-29 00:15:13 UTC
800333,mainnet,252,108864000,109186383,322384,302338,20046,0.06218050523599186,2021-11-29 00:17:20 UTC
800335,mainnet,252,108864000,109186600,322601,302528,20073,0.062222373768215225,2021-11-29 00:19:35 UTC
800336,mainnet,252,108864000,109186828,322829,302721,20108,0.06228684535775906,2021-11-29 00:21:50 UTC
800338,mainnet,252,108864000,109187048,323049,302910,20139,0.06234038799067634,2021-11-29 00:24:02 UTC
800339,mainnet,252,108864000,109187262,323263,303109,20154,0.06234552052044311,2021-11-29 00:26:16 UTC
800341,mainnet,252,108864000,109187480,323481,303304,20177,0.06237460623653321,2021-11-29 00:28:27 UTC
800342,mainnet,252,108864000,109187667,323668,303478,20190,0.06237873376422754,2021-11-29 00:30:42 UTC
800343,mainnet,252,108864000,109187795,323796,303585,20211,0.062418930437682985,2021-11-29 00:32:49 UTC
800345,mainnet,252,108864000,109188093,324094,303823,20271,0.06254666855912173,2021-11-29 00:35:01 UTC
800346,mainnet,252,108864000,109188339,324340,304042,20298,0.06258247518036628,2021-11-29 00:37:23 UTC
800348,mainnet,252,108864000,109188536,324537,304231,20306,0.06256913695510835,2021-11-29 00:39:36 UTC
800349,mainnet,252,108864000,109188725,324726,304406,20320,0.06257583316395977,2021-11-29 00:41:40 UTC
800351,mainnet,252,108864000,109188930,324931,304589,20342,0.06260406055439463,2021-11-29 00:43:56 UTC
800352,mainnet,252,108864000,109189141,325142,304772,20370,0.06264955004275055,2021-11-29 00:46:11 UTC
800354,mainnet,252,108864000,109189333,325334,304937,20397,0.06269556824678638,2021-11-29 00:48:24 UTC
800355,mainnet,252,108864000,109189569,325570,305134,20436,0.06276991123260743,2021-11-29 00:50:34 UTC
800356,mainnet,252,108864000,109189803,325804,305344,20460,0.06279849234509091,2021-11-29 00:52:45 UTC
800358,mainnet,252,108864000,109190013,326014,305525,20489,0.06284699430085824,2021-11-29 00:54:59 UTC
800359,mainnet,252,108864000,109190227,326228,305723,20505,0.06285481319813137,2021-11-29 00:57:15 UTC
800361,mainnet,252,108864000,109190461,326462,305918,20544,0.06292922300298351,2021-11-29 00:59:32 UTC
800362,mainnet,252,108864000,109190694,326695,306122,20573,0.06297310947519857,2021-11-29 01:02:01 UTC
800364,mainnet,252,108864000,109190914,326915,306303,20612,0.06305002829481669,2021-11-29 01:04:15 UTC
800365,mainnet,252,108864000,109191095,327096,306456,20640,0.06310074106684276,2021-11-29 01:06:32 UTC
800367,mainnet,252,108864000,109191309,327310,306647,20663,0.06312975466682962,2021-11-29 01:08:55 UTC
800368,mainnet,252,108864000,109191364,327365,306698,20667,0.06313136712843462,2021-11-29 01:11:13 UTC
800370,mainnet,252,108864000,109191705,327706,307007,20699,0.06316332322264469,2021-11-29 01:13:55 UTC
800371,mainnet,252,108864000,109192029,328030,307311,20719,0.06316190592323873,2021-11-29 01:16:45 UTC
800373,mainnet,252,108864000,109192266,328267,307520,20747,0.06320160113566091,2021-11-29 01:19:30 UTC
800374,mainnet,252,108864000,109192533,328534,307744,20790,0.06328112158863314,2021-11-29 01:22:20 UTC
800376,mainnet,252,108864000,109192677,328678,307873,20805,0.06329903431321841,2021-11-29 01:24:59 UTC
800377,mainnet,252,108864000,109192923,328924,308092,20832,0.06333377923167662,2021-11-29 01:27:22 UTC
800379,mainnet,252,108864000,109193213,329214,308331,20883,0.06343290382547523,2021-11-29 01:29:39 UTC
800380,mainnet,252,108864000,109193492,329493,308554,20939,0.06354914975431951,2021-11-29 01:32:13 UTC
800382,mainnet,252,108864000,109193748,329749,308784,20965,0.0635786613454476,2021-11-29 01:34:40 UTC
800383,mainnet,252,108864000,109193942,329943,308951,20992,0.06362311065850768,2021-11-29 01:36:52 UTC
800385,mainnet,252,108864000,109194127,330128,309121,21007,0.06363289390781757,2021-11-29 01:39:01 UTC
800386,mainnet,252,108864000,109194365,330366,309334,21032,0.06366272558314112,2021-11-29 01:41:14 UTC
800388,mainnet,252,108864000,109194578,330579,309524,21055,0.06369128105536044,2021-11-29 01:43:24 UTC
800389,mainnet,252,108864000,109194798,330799,309731,21068,0.06368822154843273,2021-11-29 01:45:45 UTC
800391,mainnet,252,108864000,109195030,331031,309934,21097,0.06373119133857554,2021-11-29 01:47:56 UTC
800392,mainnet,252,108864000,109195233,331234,310119,21115,0.06374647530144853,2021-11-29 01:50:00 UTC
800394,mainnet,252,108864000,109195417,331418,310298,21120,0.06372617057613045,2021-11-29 01:52:14 UTC
800395,mainnet,252,108864000,109195642,331643,310509,21134,0.06372515023685107,2021-11-29 01:54:24 UTC
800397,mainnet,252,108864000,109195891,331892,310743,21149,0.06372253624673087,2021-11-29 01:56:45 UTC
800398,mainnet,252,108864000,109196083,332084,310924,21160,0.06371881813035256,2021-11-29 01:58:54 UTC
800400,mainnet,252,108864000,109196339,332340,311142,21198,0.06378407654811338,2021-11-29 02:01:15 UTC
800401,mainnet,252,108864000,109196600,332601,311385,21216,0.06378814254918055,2021-11-29 02:03:43 UTC
800403,mainnet,252,108864000,109196836,332837,311604,21233,0.06379398924999324,2021-11-29 02:05:57 UTC
800405,mainnet,252,108864000,109197105,333106,311852,21254,0.06380551536147652,2021-11-29 02:08:40 UTC
800406,mainnet,252,108864000,109197320,333321,312054,21267,0.0638033607243468,2021-11-29 02:10:54 UTC
800408,mainnet,252,108864000,109197561,333562,312276,21286,0.0638142234427183,2021-11-29 02:13:11 UTC
800409,mainnet,252,108864000,109197833,333834,312527,21307,0.06382513464775906,2021-11-29 02:15:42 UTC
800411,mainnet,252,108864000,109198075,334076,312753,21323,0.0638267939031837,2021-11-29 02:17:55 UTC
800412,mainnet,252,108864000,109198332,334333,312982,21351,0.0638614794232098,2021-11-29 02:20:21 UTC
800414,mainnet,252,108864000,109198577,334578,313214,21364,0.06385357076675693,2021-11-29 02:22:38 UTC
800415,mainnet,252,108864000,109198798,334799,313416,21383,0.06386817164925822,2021-11-29 02:24:50 UTC
800417,mainnet,252,108864000,109199057,335058,313657,21401,0.06387252356308461,2021-11-29 02:27:06 UTC
800418,mainnet,252,108864000,109199321,335322,313911,21411,0.06385205861828332,2021-11-29 02:29:22 UTC
800419,mainnet,252,108864000,109199540,335541,314115,21426,0.06385508775380654,2021-11-29 02:31:44 UTC
800421,mainnet,252,108864000,109199813,335814,314357,21457,0.06389548976516762,2021-11-29 02:34:01 UTC
800422,mainnet,252,108864000,109200072,336073,314597,21476,0.06390278302630678,2021-11-29 02:36:13 UTC
800423,mainnet,252,108864000,109200266,336267,314785,21482,0.06388375903671785,2021-11-29 02:38:23 UTC
800424,mainnet,252,108864000,109200575,336576,315075,21501,0.0638815601825442,2021-11-29 02:40:44 UTC
800426,mainnet,252,108864000,109200822,336823,315313,21510,0.06386143464074603,2021-11-29 02:42:59 UTC
800427,mainnet,252,108864000,109201079,337080,315562,21518,0.06383647798742138,2021-11-29 02:45:14 UTC
800429,mainnet,252,108864000,109201251,337252,315721,21531,0.06384246794681722,2021-11-29 02:47:30 UTC
800430,mainnet,252,108864000,109201554,337555,315994,21561,0.06387403534238864,2021-11-29 02:49:33 UTC
800432,mainnet,252,108864000,109201833,337834,316256,21578,0.06387160558143941,2021-11-29 02:51:48 UTC
800433,mainnet,252,108864000,109202109,338110,316517,21593,0.06386383129750672,2021-11-29 02:54:15 UTC
800435,mainnet,252,108864000,109202412,338413,316800,21613,0.06386574983821544,2021-11-29 02:56:53 UTC
800436,mainnet,252,108864000,109202643,338644,317026,21618,0.06383694971710704,2021-11-29 02:59:08 UTC
800438,mainnet,252,108864000,109202879,338880,317247,21633,0.06383675637393768,2021-11-29 03:01:19 UTC
800439,mainnet,252,108864000,109203136,339137,317487,21650,0.0638385077417091,2021-11-29 03:03:38 UTC
800441,mainnet,252,108864000,109203381,339382,317696,21686,0.06389849785787108,2021-11-29 03:05:51 UTC
800442,mainnet,252,108864000,109203647,339648,317952,21696,0.06387789711701526,2021-11-29 03:08:12 UTC
800444,mainnet,252,108864000,109203885,339886,318185,21701,0.06384787840628917,2021-11-29 03:10:21 UTC
800445,mainnet,252,108864000,109204132,340133,318425,21708,0.06382209312239624,2021-11-29 03:12:34 UTC
800447,mainnet,252,108864000,109204376,340377,318665,21712,0.06378809379012096,2021-11-29 03:14:39 UTC
800448,mainnet,252,108864000,109204640,340641,318912,21729,0.06378856332619973,2021-11-29 03:16:56 UTC
800450,mainnet,252,108864000,109204913,340914,319154,21760,0.06382841420416879,2021-11-29 03:19:31 UTC
800451,mainnet,252,108864000,109205187,341188,319406,21782,0.06384163569644888,2021-11-29 03:21:46 UTC
800453,mainnet,252,108864000,109205422,341423,319619,21804,0.0638621299678112,2021-11-29 03:23:54 UTC
800454,mainnet,252,108864000,109205652,341653,319849,21804,0.06381913813137892,2021-11-29 03:26:00 UTC
800456,mainnet,252,108864000,109205907,341908,320098,21810,0.06378908946266247,2021-11-29 03:28:14 UTC
800457,mainnet,252,108864000,109206139,342140,320313,21827,0.06379552230081253,2021-11-29 03:30:22 UTC
800459,mainnet,252,108864000,109206408,342409,320564,21845,0.06379797260001928,2021-11-29 03:32:44 UTC
800460,mainnet,252,108864000,109206678,342679,320789,21890,0.06387902380945433,2021-11-29 03:35:07 UTC
800462,mainnet,252,108864000,109206926,342927,321013,21914,0.06390281313515704,2021-11-29 03:37:19 UTC
800463,mainnet,252,108864000,109207174,343175,321241,21934,0.06391491221679901,2021-11-29 03:39:34 UTC
800465,mainnet,252,108864000,109207435,343436,321484,21952,0.06391875050955637,2021-11-29 03:41:51 UTC
800466,mainnet,252,108864000,109207735,343736,321772,21964,0.06389787511345917,2021-11-29 03:44:24 UTC
800468,mainnet,252,108864000,109207972,343973,321991,21982,0.06390617868262916,2021-11-29 03:46:36 UTC
800469,mainnet,252,108864000,109208213,344214,322222,21992,0.06389048673209108,2021-11-29 03:48:50 UTC
800471,mainnet,252,108864000,109208435,344436,322435,22001,0.0638754369461961,2021-11-29 03:51:02 UTC
800472,mainnet,252,108864000,109208701,344702,322685,22017,0.06387256238722143,2021-11-29 03:53:24 UTC
800474,mainnet,252,108864000,109208969,344970,322948,22022,0.06383743513928747,2021-11-29 03:55:45 UTC
800475,mainnet,252,108864000,109209233,345234,323191,22043,0.06384944704171663,2021-11-29 03:58:00 UTC
800477,mainnet,252,108864000,109209473,345474,323410,22064,0.06386587702692532,2021-11-29 04:00:05 UTC
800478,mainnet,252,108864000,109209703,345704,323629,22075,0.0638552056094231,2021-11-29 04:02:17 UTC
800479,mainnet,252,108864000,109209925,345926,323835,22091,0.06386047883073258,2021-11-29 04:04:22 UTC
800481,mainnet,252,108864000,109210157,346158,324040,22118,0.06389567769631209,2021-11-29 04:06:36 UTC
800482,mainnet,252,108864000,109210379,346380,324243,22137,0.06390957907500433,2021-11-29 04:08:55 UTC
800484,mainnet,252,108864000,109210672,346673,324448,22225,0.06410940569354982,2021-11-29 04:11:00 UTC
800485,mainnet,252,108864000,109210898,346899,324660,22239,0.06410799685210969,2021-11-29 04:13:13 UTC
800486,mainnet,252,108864000,109211164,347165,324910,22255,0.0641049644981493,2021-11-29 04:15:30 UTC
800488,mainnet,252,108864000,109211402,347403,325137,22266,0.06409271077106415,2021-11-29 04:17:45 UTC
800489,mainnet,252,108864000,109211692,347693,325411,22282,0.06408527062667353,2021-11-29 04:20:19 UTC
800491,mainnet,252,108864000,109212028,348029,325725,22304,0.06408661347186585,2021-11-29 04:23:09 UTC
800492,mainnet,252,108864000,109212288,348289,325982,22307,0.06404738593524344,2021-11-29 04:25:23 UTC
800494,mainnet,252,108864000,109212543,348544,326214,22330,0.06406651670951156,2021-11-29 04:27:49 UTC
800496,mainnet,252,108864000,109212882,348883,326542,22341,0.06403579423474345,2021-11-29 04:30:46 UTC
800497,mainnet,252,108864000,109213137,349138,326765,22373,0.06408067870011284,2021-11-29 04:32:55 UTC
800499,mainnet,252,108864000,109213365,349366,326985,22381,0.0640617575837374,2021-11-29 04:35:03 UTC
800500,mainnet,252,108864000,109213616,349617,327231,22386,0.06403006718780838,2021-11-29 04:37:17 UTC
800502,mainnet,252,108864000,109213890,349891,327491,22400,0.06401993763772146,2021-11-29 04:39:35 UTC
800503,mainnet,252,108864000,109214141,350142,327738,22404,0.06398546875267748,2021-11-29 04:41:53 UTC
800504,mainnet,252,108864000,109214414,350415,327997,22418,0.0639755718219825,2021-11-29 04:44:05 UTC
800506,mainnet,252,108864000,109214656,350657,328220,22437,0.06398560416589431,2021-11-29 04:46:16 UTC
800507,mainnet,252,108864000,109214883,350884,328438,22446,0.0639698589847357,2021-11-29 04:48:22 UTC
800509,mainnet,252,108864000,109215141,351142,328674,22468,0.06398551013550073,2021-11-29 04:50:31 UTC
800510,mainnet,252,108864000,109215386,351387,328904,22483,0.06398358505010146,2021-11-29 04:52:39 UTC
800512,mainnet,252,108864000,109215648,351649,329157,22492,0.06396150707097134,2021-11-29 04:54:55 UTC
800513,mainnet,252,108864000,109215912,351913,329409,22504,0.06394762341828804,2021-11-29 04:57:15 UTC
800515,mainnet,252,108864000,109216146,352147,329630,22517,0.06394204692926533,2021-11-29 04:59:21 UTC
800516,mainnet,252,108864000,109216390,352391,329868,22523,0.06391479918613131,2021-11-29 05:01:33 UTC
800518,mainnet,252,108864000,109216649,352650,330121,22529,0.06388487168580746,2021-11-29 05:03:51 UTC
800519,mainnet,252,108864000,109216895,352896,330364,22532,0.06384883931809938,2021-11-29 05:05:59 UTC
800520,mainnet,252,108864000,109217153,353154,330616,22538,0.06381918369889623,2021-11-29 05:08:16 UTC
800522,mainnet,252,108864000,109217425,353426,330874,22552,0.0638096801027655,2021-11-29 05:10:37 UTC
800523,mainnet,252,108864000,109217675,353676,331105,22571,0.0638182969723702,2021-11-29 05:12:50 UTC
800525,mainnet,252,108864000,109217907,353908,331319,22589,0.0638273223549623,2021-11-29 05:14:56 UTC
800526,mainnet,252,108864000,109218166,354167,331559,22608,0.06383429286184202,2021-11-29 05:17:16 UTC
800528,mainnet,252,108864000,109218402,354403,331778,22625,0.0638397530494945,2021-11-29 05:19:39 UTC
800529,mainnet,252,108864000,109218687,354688,332034,22654,0.06387021833273186,2021-11-29 05:21:47 UTC
800531,mainnet,252,108864000,109218936,354937,332263,22674,0.06388175929812896,2021-11-29 05:23:56 UTC
800532,mainnet,252,108864000,109219212,355213,332528,22685,0.06386309059634641,2021-11-29 05:26:32 UTC
800534,mainnet,252,108864000,109219458,355459,332758,22701,0.0638639055418487,2021-11-29 05:28:36 UTC
800535,mainnet,252,108864000,109219712,355713,333001,22712,0.06384922676427345,2021-11-29 05:30:51 UTC
800537,mainnet,252,108864000,109220007,356008,333286,22722,0.06382440844025977,2021-11-29 05:33:26 UTC
800539,mainnet,252,108864000,109220264,356265,333537,22728,0.06379520862279484,2021-11-29 05:35:37 UTC
800540,mainnet,252,108864000,109220508,356509,333778,22731,0.06375996117910067,2021-11-29 05:37:48 UTC
800541,mainnet,252,108864000,109220743,356744,334005,22739,0.06374038526226089,2021-11-29 05:39:59 UTC
800543,mainnet,252,108864000,109220997,356998,334227,22771,0.06378467106258298,2021-11-29 05:42:17 UTC
800544,mainnet,252,108864000,109221242,357243,334444,22799,0.06381930506685925,2021-11-29 05:44:24 UTC
800545,mainnet,252,108864000,109221492,357493,334685,22808,0.06379985062644583,2021-11-29 05:46:37 UTC
800547,mainnet,252,108864000,109221718,357719,334900,22819,0.06379029349852817,2021-11-29 05:48:45 UTC
800548,mainnet,252,108864000,109221965,357966,335120,22846,0.06382170373722644,2021-11-29 05:51:01 UTC
800550,mainnet,252,108864000,109222202,358203,335343,22860,0.06381856098357636,2021-11-29 05:53:12 UTC
800551,mainnet,252,108864000,109222473,358474,335599,22875,0.0638121593197833,2021-11-29 05:55:30 UTC
800553,mainnet,252,108864000,109222712,358713,335837,22876,0.06377243088485782,2021-11-29 05:57:40 UTC
800554,mainnet,252,108864000,109222999,359000,336113,22887,0.06375208913649025,2021-11-29 06:00:09 UTC
800556,mainnet,252,108864000,109223255,359256,336363,22893,0.06372336161400227,2021-11-29 06:02:30 UTC
800557,mainnet,252,108864000,109223511,359512,336607,22905,0.06371136429382052,2021-11-29 06:04:47 UTC
800559,mainnet,252,108864000,109223750,359751,336829,22922,0.06371629265797732,2021-11-29 06:06:50 UTC
800560,mainnet,252,108864000,109224009,360010,337071,22939,0.06371767450904142,2021-11-29 06:09:05 UTC
800562,mainnet,252,108864000,109224250,360251,337295,22956,0.06372223810620928,2021-11-29 06:11:12 UTC
800563,mainnet,252,108864000,109224508,360509,337535,22974,0.06372656438535515,2021-11-29 06:13:27 UTC
800565,mainnet,252,108864000,109224732,360733,337743,22990,0.06373134700734338,2021-11-29 06:15:34 UTC
800566,mainnet,252,108864000,109225039,361040,338029,23011,0.06373532018612896,2021-11-29 06:18:04 UTC
800568,mainnet,252,108864000,109225293,361294,338281,23013,0.06369604809379618,2021-11-29 06:20:16 UTC
800569,mainnet,252,108864000,109225552,361553,338519,23034,0.06370850193470944,2021-11-29 06:22:33 UTC
800571,mainnet,252,108864000,109225800,361801,338749,23052,0.06371458343122324,2021-11-29 06:24:42 UTC
800572,mainnet,252,108864000,109226044,362045,338984,23061,0.06369650181607259,2021-11-29 06:26:50 UTC
800574,mainnet,252,108864000,109226285,362286,339223,23063,0.06365965011068603,2021-11-29 06:29:01 UTC
800575,mainnet,252,108864000,109226532,362533,339456,23077,0.06365489486474335,2021-11-29 06:31:21 UTC
800577,mainnet,252,108864000,109226775,362776,339669,23107,0.06369495225704015,2021-11-29 06:33:27 UTC
800578,mainnet,252,108864000,109227033,363034,339898,23136,0.06372956802944077,2021-11-29 06:35:41 UTC
800580,mainnet,252,108864000,109227266,363267,340119,23148,0.06372172534251666,2021-11-29 06:37:50 UTC
800581,mainnet,252,108864000,109227514,363515,340354,23161,0.06371401455235685,2021-11-29 06:40:07 UTC
800583,mainnet,252,108864000,109227748,363749,340578,23171,0.06370051876431275,2021-11-29 06:42:15 UTC
800584,mainnet,252,108864000,109227996,363997,340808,23189,0.06370656901018415,2021-11-29 06:44:25 UTC
800586,mainnet,252,108864000,109228226,364227,341029,23198,0.0636910498123423,2021-11-29 06:46:33 UTC
800587,mainnet,252,108864000,109228475,364476,341253,23223,0.06371612945708359,2021-11-29 06:48:46 UTC
800589,mainnet,252,108864000,109228739,364740,341498,23242,0.06372210341613203,2021-11-29 06:51:05 UTC
800590,mainnet,252,108864000,109229000,365001,341729,23272,0.06375872942813855,2021-11-29 06:53:21 UTC
800591,mainnet,252,108864000,109229233,365234,341947,23287,0.06375912428744313,2021-11-29 06:55:31 UTC
800593,mainnet,252,108864000,109229488,365489,342192,23297,0.0637420004432418,2021-11-29 06:57:42 UTC
800594,mainnet,252,108864000,109229733,365734,342428,23306,0.06372390863305025,2021-11-29 06:59:58 UTC
800595,mainnet,252,108864000,109229977,365978,342658,23320,0.063719677139063,2021-11-29 07:02:18 UTC
800597,mainnet,252,108864000,109230228,366229,342889,23340,0.0637306166360392,2021-11-29 07:04:35 UTC
800598,mainnet,252,108864000,109230461,366462,343115,23347,0.06370919767943198,2021-11-29 07:06:46 UTC
800600,mainnet,252,108864000,109230708,366709,343355,23354,0.0636853745067615,2021-11-29 07:08:55 UTC
800601,mainnet,252,108864000,109230956,366957,343578,23379,0.06371046198873437,2021-11-29 07:11:04 UTC
800602,mainnet,252,108864000,109231209,367210,343829,23381,0.06367201328939844,2021-11-29 07:13:18 UTC
800604,mainnet,252,108864000,109231465,367466,344071,23395,0.06366575411058438,2021-11-29 07:15:33 UTC
800606,mainnet,252,108864000,109231717,367718,344322,23396,0.06362484295030431,2021-11-29 07:17:42 UTC
800607,mainnet,252,108864000,109231973,367974,344560,23414,0.06362949556218646,2021-11-29 07:19:59 UTC
800609,mainnet,252,108864000,109232222,368223,344790,23433,0.06363806714952625,2021-11-29 07:22:23 UTC
800610,mainnet,252,108864000,109232492,368493,345041,23452,0.06364300000271375,2021-11-29 07:24:40 UTC
800612,mainnet,252,108864000,109232759,368760,345298,23462,0.06362403731424232,2021-11-29 07:26:52 UTC
800613,mainnet,252,108864000,109232993,368994,345520,23474,0.06361621056168935,2021-11-29 07:29:02 UTC
800615,mainnet,252,108864000,109233247,369248,345743,23505,0.06365640436779617,2021-11-29 07:31:21 UTC
800616,mainnet,252,108864000,109233516,369517,346000,23517,0.06364253877358822,2021-11-29 07:33:38 UTC
800618,mainnet,252,108864000,109233745,369746,346205,23541,0.06366803156761669,2021-11-29 07:35:52 UTC
800619,mainnet,252,108864000,109234032,370033,346472,23561,0.06367269946193987,2021-11-29 07:38:18 UTC
800621,mainnet,252,108864000,109234304,370305,346723,23582,0.06368263998595752,2021-11-29 07:40:30 UTC
800622,mainnet,252,108864000,109234589,370590,346992,23598,0.06367683963409698,2021-11-29 07:43:10 UTC
800624,mainnet,252,108864000,109234858,370859,347251,23608,0.06365761650654292,2021-11-29 07:45:33 UTC
800625,mainnet,252,108864000,109235161,371162,347554,23608,0.06360564928521778,2021-11-29 07:48:08 UTC
800627,mainnet,252,108864000,109235452,371453,347818,23635,0.0636285075096984,2021-11-29 07:50:21 UTC
800628,mainnet,252,108864000,109235694,371695,348046,23649,0.06362474609558913,2021-11-29 07:52:38 UTC
800630,mainnet,252,108864000,109235969,371970,348297,23673,0.06364222921203323,2021-11-29 07:54:55 UTC
800631,mainnet,252,108864000,109236221,372222,348536,23686,0.06363406784123453,2021-11-29 07:57:11 UTC
800633,mainnet,252,108864000,109236490,372491,348794,23697,0.06361764445315457,2021-11-29 07:59:26 UTC
800634,mainnet,252,108864000,109236716,372717,349004,23713,0.06362199738675725,2021-11-29 08:01:46 UTC
800636,mainnet,252,108864000,109236966,372967,349238,23729,0.06362225076213177,2021-11-29 08:04:02 UTC
800637,mainnet,252,108864000,109237207,373208,349452,23756,0.06365351225054125,2021-11-29 08:06:15 UTC
800638,mainnet,252,108864000,109237420,373421,349655,23766,0.06364398360027958,2021-11-29 08:08:25 UTC
800640,mainnet,252,108864000,109237665,373666,349886,23780,0.06363972103429266,2021-11-29 08:10:44 UTC
800641,mainnet,252,108864000,109237909,373910,350118,23792,0.06363028536278784,2021-11-29 08:12:57 UTC
800643,mainnet,252,108864000,109238225,374226,350406,23820,0.06365137644097417,2021-11-29 08:15:40 UTC
800644,mainnet,252,108864000,109238481,374482,350633,23849,0.06368530396654579,2021-11-29 08:18:07 UTC
800646,mainnet,252,108864000,109238728,374729,350861,23868,0.06369402955202293,2021-11-29 08:20:31 UTC
800647,mainnet,252,108864000,109238971,374972,351102,23870,0.06365808647045645,2021-11-29 08:23:01 UTC
800649,mainnet,252,108864000,109239220,375221,351334,23887,0.06366114902950527,2021-11-29 08:25:17 UTC
800650,mainnet,252,108864000,109239491,375492,351585,23907,0.0636684669713336,2021-11-29 08:27:49 UTC
800652,mainnet,252,108864000,109239740,375741,351817,23924,0.06367151841294935,2021-11-29 08:30:21 UTC
800653,mainnet,252,108864000,109239982,375983,352050,23933,0.06365447373950418,2021-11-29 08:32:34 UTC
800655,mainnet,252,108864000,109240397,376398,352449,23949,0.06362679929223854,2021-11-29 08:34:51 UTC
800656,mainnet,252,108864000,109240540,376541,352587,23954,0.06361591433602184,2021-11-29 08:37:07 UTC
800658,mainnet,252,108864000,109240788,376789,352827,23962,0.06359527480897798,2021-11-29 08:39:19 UTC
800660,mainnet,252,108864000,109241085,377086,353123,23963,0.06354783789374308,2021-11-29 08:41:48 UTC
800661,mainnet,252,108864000,109241382,377383,353415,23968,0.06351107495568163,2021-11-29 08:44:09 UTC
800663,mainnet,252,108864000,109241719,377720,353732,23988,0.0635073599491687,2021-11-29 08:46:44 UTC
800664,mainnet,252,108864000,109241993,377994,353987,24007,0.06351159013106028,2021-11-29 08:49:07 UTC
800666,mainnet,252,108864000,109242245,378246,354228,24018,0.06349835821132278,2021-11-29 08:51:19 UTC
800667,mainnet,252,108864000,109242472,378473,354446,24027,0.06348405302359746,2021-11-29 08:53:37 UTC
800669,mainnet,252,108864000,109242777,378778,354709,24069,0.06354381722275317,2021-11-29 08:55:57 UTC
800670,mainnet,252,108864000,109243011,379012,354935,24077,0.063525693117896,2021-11-29 08:58:06 UTC
800672,mainnet,252,108864000,109243264,379265,355179,24086,0.06350704652419813,2021-11-29 09:00:22 UTC
800673,mainnet,252,108864000,109243507,379508,355413,24095,0.06349009770545022,2021-11-29 09:02:37 UTC
800675,mainnet,252,108864000,109243763,379764,355649,24115,0.06349996313499963,2021-11-29 09:04:54 UTC
800676,mainnet,252,108864000,109244001,380002,355872,24130,0.06349966579123267,2021-11-29 09:07:05 UTC
800678,mainnet,252,108864000,109244269,380270,356129,24141,0.06348384042916874,2021-11-29 09:09:29 UTC
800679,mainnet,252,108864000,109244503,380504,356345,24159,0.06349210520782962,2021-11-29 09:11:42 UTC
800681,mainnet,252,108864000,109244793,380794,356599,24195,0.06353829104450175,2021-11-29 09:14:14 UTC
800682,mainnet,252,108864000,109245132,381133,356914,24219,0.06354474684690121,2021-11-29 09:17:06 UTC
800684,mainnet,252,108864000,109245431,381432,357201,24231,0.06352639526835714,2021-11-29 09:19:56 UTC
800686,mainnet,252,108864000,109245650,381651,357405,24246,0.06352924530526581,2021-11-29 09:22:42 UTC
800687,mainnet,252,108864000,109245980,381981,357716,24265,0.0635241019841301,2021-11-29 09:25:23 UTC
800689,mainnet,252,108864000,109246235,382236,357963,24273,0.06350265281135214,2021-11-29 09:27:37 UTC
800690,mainnet,252,108864000,109246502,382503,358212,24291,0.06350538427149591,2021-11-29 09:29:51 UTC
800692,mainnet,252,108864000,109246776,382777,358473,24304,0.06349388808627478,2021-11-29 09:32:08 UTC
800693,mainnet,252,108864000,109247050,383051,358724,24327,0.06350851453200748,2021-11-29 09:34:18 UTC
800695,mainnet,252,108864000,109247304,383305,358946,24359,0.06354991455890217,2021-11-29 09:36:30 UTC
800696,mainnet,252,108864000,109247517,383518,359148,24370,0.06354330174854896,2021-11-29 09:38:35 UTC
800698,mainnet,252,108864000,109247742,383743,359369,24374,0.06351646805283745,2021-11-29 09:40:51 UTC
800699,mainnet,252,108864000,109247989,383990,359596,24394,0.06352769603375089,2021-11-29 09:43:12 UTC
800700,mainnet,252,108864000,109248201,384202,359800,24402,0.0635134642713989,2021-11-29 09:45:20 UTC
800702,mainnet,252,108864000,109248442,384443,360003,24440,0.0635724931914484,2021-11-29 09:47:36 UTC
800703,mainnet,252,108864000,109248663,384664,360215,24449,0.06355936609612545,2021-11-29 09:49:42 UTC
800705,mainnet,252,108864000,109248879,384880,360415,24465,0.06356526709623779,2021-11-29 09:51:57 UTC
800706,mainnet,252,108864000,109249149,385150,360667,24483,0.06356744125665326,2021-11-29 09:54:21 UTC
800708,mainnet,252,108864000,109249396,385397,360891,24506,0.06358637975905365,2021-11-29 09:56:36 UTC
800709,mainnet,252,108864000,109249623,385624,361100,24524,0.06359562682820571,2021-11-29 09:58:44 UTC
800711,mainnet,252,108864000,109249891,385892,361360,24532,0.0635721911830253,2021-11-29 10:01:05 UTC
800712,mainnet,252,108864000,109250169,386170,361604,24566,0.06361447031100292,2021-11-29 10:03:18 UTC
800713,mainnet,252,108864000,109250417,386418,361840,24578,0.06360469750373947,2021-11-29 10:05:34 UTC
800715,mainnet,252,108864000,109250667,386668,362080,24588,0.0635894358984969,2021-11-29 10:07:45 UTC
800716,mainnet,252,108864000,109250938,386939,362326,24613,0.06360950950925082,2021-11-29 10:10:00 UTC
800718,mainnet,252,108864000,109251177,387178,362550,24628,0.06360898604776098,2021-11-29 10:12:09 UTC
800719,mainnet,252,108864000,109251414,387415,362771,24644,0.06361137281726315,2021-11-29 10:14:18 UTC
800721,mainnet,252,108864000,109251693,387694,363029,24665,0.06361976197722946,2021-11-29 10:16:30 UTC
800722,mainnet,252,108864000,109251945,387946,363269,24677,0.06360936831414682,2021-11-29 10:18:42 UTC
800724,mainnet,252,108864000,109252205,388206,363520,24686,0.06358994966589904,2021-11-29 10:20:55 UTC
800725,mainnet,252,108864000,109252441,388442,363743,24699,0.06358478228409904,2021-11-29 10:23:05 UTC
800727,mainnet,252,108864000,109252704,388705,363990,24715,0.06358292278205838,2021-11-29 10:25:21 UTC
800728,mainnet,252,108864000,109252941,388942,364216,24726,0.06357246067537062,2021-11-29 10:27:37 UTC
800730,mainnet,252,108864000,109253226,389227,364479,24748,0.06358243390103975,2021-11-29 10:30:32 UTC
800731,mainnet,252,108864000,109253520,389521,364761,24760,0.06356525065400838,2021-11-29 10:33:01 UTC
800733,mainnet,252,108864000,109253787,389788,365025,24763,0.06352940572824202,2021-11-29 10:35:25 UTC
800734,mainnet,252,108864000,109254048,390049,365276,24773,0.06351253304072052,2021-11-29 10:37:41 UTC
800736,mainnet,252,108864000,109254281,390282,365493,24789,0.06351561178839915,2021-11-29 10:39:55 UTC
800737,mainnet,252,108864000,109254549,390550,365749,24801,0.06350275252848547,2021-11-29 10:42:11 UTC
800739,mainnet,252,108864000,109254802,390803,365997,24806,0.06347443596901764,2021-11-29 10:44:21 UTC
800740,mainnet,252,108864000,109255031,391032,366204,24828,0.06349352482661265,2021-11-29 10:46:32 UTC
800742,mainnet,252,108864000,109255284,391285,366429,24856,0.06352402979925119,2021-11-29 10:48:48 UTC
800743,mainnet,252,108864000,109255545,391546,366672,24874,0.06352765703135775,2021-11-29 10:51:08 UTC
800745,mainnet,252,108864000,109255774,391775,366889,24886,0.0635211537234382,2021-11-29 10:53:14 UTC
800746,mainnet,252,108864000,109256039,392040,367142,24898,0.06350882563003775,2021-11-29 10:55:30 UTC
800748,mainnet,252,108864000,109256285,392286,367369,24917,0.0635174337090796,2021-11-29 10:57:41 UTC
800749,mainnet,252,108864000,109256547,392548,367622,24926,0.06349796712758694,2021-11-29 10:59:57 UTC
800751,mainnet,252,108864000,109256791,392792,367852,24940,0.06349416485060795,2021-11-29 11:02:08 UTC
800752,mainnet,252,108864000,109257092,393093,368139,24954,0.06348116094664621,2021-11-29 11:04:51 UTC
800754,mainnet,252,108864000,109257344,393345,368381,24964,0.06346591414661429,2021-11-29 11:07:06 UTC
800755,mainnet,252,108864000,109257672,393673,368692,24981,0.06345621873991866,2021-11-29 11:10:03 UTC
800757,mainnet,252,108864000,109257924,393925,368936,24989,0.06343593323602209,2021-11-29 11:12:14 UTC
800758,mainnet,252,108864000,109258178,394179,369169,25010,0.06344833184923601,2021-11-29 11:14:26 UTC
800759,mainnet,252,108864000,109258451,394452,369424,25028,0.06345005222435175,2021-11-29 11:16:52 UTC
800761,mainnet,252,108864000,109258738,394739,369663,25076,0.06352551939382732,2021-11-29 11:19:30 UTC
800762,mainnet,252,108864000,109258995,394996,369901,25095,0.0635322889345715,2021-11-29 11:21:42 UTC
800764,mainnet,252,108864000,109259242,395243,370126,25117,0.06354824753379566,2021-11-29 11:23:58 UTC
800765,mainnet,252,108864000,109259505,395506,370367,25139,0.06356161474162213,2021-11-29 11:26:18 UTC
800767,mainnet,252,108864000,109259750,395751,370589,25162,0.06358038261432063,2021-11-29 11:28:29 UTC
800768,mainnet,252,108864000,109259996,395997,370810,25187,0.06360401720215052,2021-11-29 11:30:41 UTC
800770,mainnet,252,108864000,109260222,396223,371021,25202,0.063605595838707,2021-11-29 11:32:53 UTC
800772,mainnet,252,108864000,109260498,396499,371286,25213,0.06358906327632605,2021-11-29 11:35:28 UTC
800773,mainnet,252,108864000,109260755,396756,371497,25259,0.06366381352770972,2021-11-29 11:37:38 UTC
800774,mainnet,252,108864000,109261016,397017,371734,25283,0.0636824115843906,2021-11-29 11:39:51 UTC
800776,mainnet,252,108864000,109261283,397284,371983,25301,0.06368492061094834,2021-11-29 11:42:18 UTC
800778,mainnet,252,108864000,109261535,397536,372214,25322,0.0636973758351445,2021-11-29 11:44:40 UTC
800779,mainnet,252,108864000,109261789,397790,372455,25335,0.06368938384574775,2021-11-29 11:47:00 UTC
800781,mainnet,252,108864000,109262044,398045,372689,25356,0.06370134030071976,2021-11-29 11:49:14 UTC
800782,mainnet,252,108864000,109262274,398275,372907,25368,0.06369468332182537,2021-11-29 11:51:31 UTC
800784,mainnet,252,108864000,109262517,398518,373138,25380,0.0636859564687166,2021-11-29 11:53:41 UTC
800785,mainnet,252,108864000,109262802,398803,373399,25404,0.06370062411767213,2021-11-29 11:55:54 UTC
800787,mainnet,252,108864000,109263056,399057,373611,25446,0.06376532675783159,2021-11-29 11:58:11 UTC
800788,mainnet,252,108864000,109263317,399318,373851,25467,0.06377623848661969,2021-11-29 12:00:41 UTC
800790,mainnet,252,108864000,109263570,399571,374083,25488,0.06378841307302081,2021-11-29 12:02:54 UTC
800791,mainnet,252,108864000,109263842,399843,374338,25505,0.06378753660811869,2021-11-29 12:05:27 UTC
800793,mainnet,252,108864000,109264105,400106,374584,25522,0.06378809615451905,2021-11-29 12:07:42 UTC
800794,mainnet,252,108864000,109264351,400352,374817,25535,0.06378137239229478,2021-11-29 12:09:58 UTC
800796,mainnet,252,108864000,109264608,400609,375044,25565,0.06381534114310962,2021-11-29 12:12:16 UTC
800797,mainnet,252,108864000,109264885,400886,375309,25577,0.06380118038544624,2021-11-29 12:14:37 UTC
800799,mainnet,252,108864000,109265121,401122,375543,25579,0.06376862899566715,2021-11-29 12:16:48 UTC
800800,mainnet,252,108864000,109265366,401367,375777,25590,0.0637571100763142,2021-11-29 12:18:58 UTC
800802,mainnet,252,108864000,109265634,401635,376021,25614,0.06377432245695719,2021-11-29 12:21:21 UTC
800803,mainnet,252,108864000,109265874,401875,376247,25628,0.0637710730948678,2021-11-29 12:23:48 UTC
800805,mainnet,252,108864000,109266183,402184,376524,25660,0.06380164302906133,2021-11-29 12:26:35 UTC
800807,mainnet,252,108864000,109266502,402503,376824,25679,0.06379828224882796,2021-11-29 12:29:12 UTC
800808,mainnet,252,108864000,109266746,402747,377061,25686,0.0637770113743864,2021-11-29 12:31:41 UTC
800810,mainnet,252,108864000,109267004,403005,377295,25710,0.06379573454423643,2021-11-29 12:34:05 UTC
800811,mainnet,252,108864000,109267256,403257,377538,25719,0.0637781861195218,2021-11-29 12:36:33 UTC
800813,mainnet,252,108864000,109267479,403480,377748,25732,0.06377515614156835,2021-11-29 12:38:43 UTC
800814,mainnet,252,108864000,109267712,403713,377963,25750,0.06378293490672829,2021-11-29 12:40:58 UTC
800816,mainnet,252,108864000,109267997,403998,378204,25794,0.0638468507269838,2021-11-29 12:43:14 UTC
800817,mainnet,252,108864000,109268234,404235,378423,25812,0.06385394634309251,2021-11-29 12:45:29 UTC
800819,mainnet,252,108864000,109268563,404564,378726,25838,0.06386628568038678,2021-11-29 12:48:18 UTC
800820,mainnet,252,108864000,109268782,404783,378929,25854,0.0638712594155387,2021-11-29 12:50:33 UTC
800822,mainnet,252,108864000,109269006,405007,379147,25860,0.06385074825867207,2021-11-29 12:52:45 UTC
800823,mainnet,252,108864000,109269240,405241,379365,25876,0.06385336133313263,2021-11-29 12:54:59 UTC
800825,mainnet,252,108864000,109269501,405502,379612,25890,0.06384678743877958,2021-11-29 12:57:24 UTC
800826,mainnet,252,108864000,109269760,405761,379860,25901,0.06383314315570003,2021-11-29 13:00:28 UTC
800828,mainnet,252,108864000,109270129,406130,380202,25928,0.06384162706522542,2021-11-29 13:03:21 UTC
800830,mainnet,252,108864000,109270376,406377,380433,25944,0.06384219579356115,2021-11-29 13:06:12 UTC
800831,mainnet,252,108864000,109270776,406777,380785,25992,0.06389741799560938,2021-11-29 13:08:38 UTC
800833,mainnet,252,108864000,109270932,406933,380924,26009,0.06391469848844895,2021-11-29 13:11:29 UTC
800834,mainnet,252,108864000,109271172,407173,381155,26018,0.06389912887151161,2021-11-29 13:13:53 UTC
800836,mainnet,252,108864000,109271462,407463,381425,26038,0.0639027347268341,2021-11-29 13:16:35 UTC
800837,mainnet,252,108864000,109271674,407675,381618,26057,0.06391610964616422,2021-11-29 13:18:51 UTC
800839,mainnet,252,108864000,109271933,407934,381834,26100,0.06398093809292679,2021-11-29 13:21:13 UTC
800840,mainnet,252,108864000,109272208,408209,382081,26128,0.06400642807973367,2021-11-29 13:23:40 UTC
800842,mainnet,252,108864000,109272452,408453,382305,26148,0.06401715742080484,2021-11-29 13:26:06 UTC
800843,mainnet,252,108864000,109272703,408704,382540,26164,0.06401699029126214,2021-11-29 13:28:29 UTC
800845,mainnet,252,108864000,109272964,408965,382777,26188,0.06403481960558972,2021-11-29 13:30:44 UTC
800846,mainnet,252,108864000,109273202,409203,382995,26208,0.06404645127235138,2021-11-29 13:32:58 UTC
800848,mainnet,252,108864000,109273410,409411,383191,26220,0.06404322306923849,2021-11-29 13:35:10 UTC
800849,mainnet,252,108864000,109273616,409617,383388,26229,0.06403298691216429,2021-11-29 13:37:27 UTC
800851,mainnet,252,108864000,109273856,409857,383622,26235,0.06401013036254108,2021-11-29 13:39:49 UTC
800852,mainnet,252,108864000,109274103,410104,383841,26263,0.06403985330550299,2021-11-29 13:42:11 UTC
800854,mainnet,252,108864000,109274297,410298,384030,26268,0.06402175979410088,2021-11-29 13:44:33 UTC
800855,mainnet,252,108864000,109274545,410546,384244,26302,0.06406590248108616,2021-11-29 13:46:45 UTC
800857,mainnet,252,108864000,109274815,410816,384478,26338,0.06411142701355352,2021-11-29 13:49:20 UTC
800858,mainnet,252,108864000,109275057,411058,384687,26371,0.06415396367422602,2021-11-29 13:51:35 UTC
800860,mainnet,252,108864000,109275208,411209,384824,26385,0.0641644516535387,2021-11-29 13:53:55 UTC
800861,mainnet,252,108864000,109275592,411593,385156,26437,0.06423092715376598,2021-11-29 13:56:41 UTC
800863,mainnet,252,108864000,109275875,411876,385412,26464,0.06425234779399625,2021-11-29 13:59:33 UTC
800864,mainnet,252,108864000,109276153,412154,385651,26503,0.06430363407852405,2021-11-29 14:02:01 UTC
800866,mainnet,252,108864000,109276423,412424,385857,26567,0.0644167167769092,2021-11-29 14:04:31 UTC
800867,mainnet,252,108864000,109276663,412664,386050,26614,0.06449314696702402,2021-11-29 14:06:44 UTC
800869,mainnet,252,108864000,109276877,412878,386244,26634,0.0645081597953875,2021-11-29 14:08:55 UTC
800870,mainnet,252,108864000,109277077,413078,386420,26658,0.06453502728298287,2021-11-29 14:11:11 UTC
800872,mainnet,252,108864000,109277278,413279,386605,26674,0.06454235516442887,2021-11-29 14:13:27 UTC
800873,mainnet,252,108864000,109277531,413532,386834,26698,0.06456090459746767,2021-11-29 14:15:46 UTC
800875,mainnet,252,108864000,109277743,413744,387023,26721,0.06458341389844928,2021-11-29 14:17:58 UTC
800876,mainnet,252,108864000,109277969,413970,387227,26743,0.06460129961108294,2021-11-29 14:20:17 UTC
800878,mainnet,252,108864000,109278165,414166,387401,26765,0.06462384647701647,2021-11-29 14:22:29 UTC
800879,mainnet,252,108864000,109278403,414404,387612,26792,0.06465188559955985,2021-11-29 14:24:52 UTC
800881,mainnet,252,108864000,109278622,414623,387814,26809,0.06465873817902046,2021-11-29 14:27:07 UTC
800882,mainnet,252,108864000,109279004,415005,388153,26852,0.06470283490560355,2021-11-29 14:29:23 UTC
800884,mainnet,252,108864000,109279106,415107,388243,26864,0.06471584434856555,2021-11-29 14:31:48 UTC
800885,mainnet,252,108864000,109279361,415362,388473,26889,0.06473630230979242,2021-11-29 14:34:09 UTC
800887,mainnet,252,108864000,109279600,415601,388706,26895,0.06471351127644062,2021-11-29 14:36:34 UTC
800888,mainnet,252,108864000,109279816,415817,388882,26935,0.06477609140559429,2021-11-29 14:38:45 UTC
800890,mainnet,252,108864000,109280049,416050,389094,26956,0.0647902896286504,2021-11-29 14:40:58 UTC
800891,mainnet,252,108864000,109280339,416340,389358,26982,0.06480760916558582,2021-11-29 14:43:10 UTC
800893,mainnet,252,108864000,109280650,416651,389648,27003,0.06480963684234527,2021-11-29 14:45:33 UTC
800894,mainnet,252,108864000,109280935,416936,389897,27039,0.06485167987412936,2021-11-29 14:48:08 UTC
800896,mainnet,252,108864000,109281154,417155,390083,27072,0.06489674101952511,2021-11-29 14:50:23 UTC
800897,mainnet,252,108864000,109281352,417353,390268,27085,0.0648971014944184,2021-11-29 14:52:37 UTC
800899,mainnet,252,108864000,109281563,417564,390454,27110,0.06492417928748646,2021-11-29 14:54:45 UTC
800900,mainnet,252,108864000,109281778,417779,390651,27128,0.06493385258713338,2021-11-29 14:56:56 UTC
800902,mainnet,252,108864000,109282029,418030,390879,27151,0.06494988397961869,2021-11-29 14:59:18 UTC
800903,mainnet,252,108864000,109282278,418279,391101,27178,0.06497576976133156,2021-11-29 15:01:40 UTC
800905,mainnet,252,108864000,109282506,418507,391306,27201,0.06499532863249599,2021-11-29 15:03:58 UTC
800906,mainnet,252,108864000,109282763,418764,391535,27229,0.06502230373193493,2021-11-29 15:06:20 UTC
800908,mainnet,252,108864000,109282986,418987,391737,27250,0.06503781740244924,2021-11-29 15:08:31 UTC
800909,mainnet,252,108864000,109283175,419176,391920,27256,0.06502280664923564,2021-11-29 15:10:40 UTC
800911,mainnet,252,108864000,109283372,419373,392102,27271,0.06502802993993415,2021-11-29 15:12:49 UTC
800912,mainnet,252,108864000,109283595,419596,392286,27310,0.06508641645773554,2021-11-29 15:15:02 UTC
800914,mainnet,252,108864000,109283842,419843,392492,27351,0.06514578068468452,2021-11-29 15:17:26 UTC
800915,mainnet,252,108864000,109284067,420068,392702,27366,0.06514659531313978,2021-11-29 15:19:44 UTC
800917,mainnet,252,108864000,109284256,420257,392884,27373,0.06513395374734983,2021-11-29 15:21:55 UTC
800918,mainnet,252,108864000,109284491,420492,393095,27397,0.06515462838769823,2021-11-29 15:24:24 UTC
800920,mainnet,252,108864000,109284741,420742,393339,27403,0.0651301747864487,2021-11-29 15:27:11 UTC
800921,mainnet,252,108864000,109285052,421053,393623,27430,0.06514619299708113,2021-11-29 15:29:34 UTC
800922,mainnet,252,108864000,109285274,421275,393832,27443,0.06514272150020771,2021-11-29 15:31:49 UTC
800924,mainnet,252,108864000,109285486,421487,394019,27468,0.065169269752092,2021-11-29 15:33:57 UTC
800925,mainnet,252,108864000,109285643,421644,394159,27485,0.0651853222149491,2021-11-29 15:36:09 UTC
800927,mainnet,252,108864000,109285921,421922,394394,27528,0.06524428685870848,2021-11-29 15:38:30 UTC
800928,mainnet,252,108864000,109286208,422209,394645,27564,0.06528520235238945,2021-11-29 15:40:17 UTC
800929,mainnet,252,108864000,109286416,422417,394825,27592,0.0653193408409226,2021-11-29 15:42:45 UTC
800931,mainnet,252,108864000,109286643,422644,395021,27623,0.06535760592839364,2021-11-29 15:44:58 UTC
800932,mainnet,252,108864000,109286942,422943,395294,27649,0.06537287530471009,2021-11-29 15:47:15 UTC
800934,mainnet,252,108864000,109287136,423137,395466,27671,0.06539489574298632,2021-11-29 15:49:24 UTC
800935,mainnet,252,108864000,109287366,423367,395679,27688,0.06539952334499383,2021-11-29 15:51:40 UTC
800937,mainnet,252,108864000,109287561,423562,395865,27697,0.06539066299620835,2021-11-29 15:53:54 UTC
800938,mainnet,252,108864000,109287797,423798,396074,27724,0.06541795855572702,2021-11-29 15:56:06 UTC
800940,mainnet,252,108864000,109287991,423992,396243,27749,0.06544698956584087,2021-11-29 15:58:20 UTC
800941,mainnet,252,108864000,109288309,424310,396516,27794,0.0655039947208409,2021-11-29 16:00:34 UTC
800942,mainnet,252,108864000,109288523,424524,396711,27813,0.065515730559403,2021-11-29 16:02:50 UTC
800943,mainnet,252,108864000,109288725,424726,396883,27843,0.06555520500275472,2021-11-29 16:05:01 UTC
800945,mainnet,252,108864000,109288947,424948,397080,27868,0.06557978858589757,2021-11-29 16:07:10 UTC
800946,mainnet,252,108864000,109289187,425188,397277,27911,0.06564390340273009,2021-11-29 16:09:23 UTC
800948,mainnet,252,108864000,109289415,425416,397476,27940,0.06567689038494086,2021-11-29 16:11:46 UTC
800949,mainnet,252,108864000,109289617,425618,397657,27961,0.06569505988938437,2021-11-29 16:14:00 UTC
800951,mainnet,252,108864000,109289823,425824,397837,27987,0.06572433681521005,2021-11-29 16:16:09 UTC
800952,mainnet,252,108864000,109290075,426076,398047,28029,0.06578403852833767,2021-11-29 16:18:20 UTC
800954,mainnet,252,108864000,109290251,426252,398206,28046,0.06579675872488575,2021-11-29 16:20:40 UTC
800955,mainnet,252,108864000,109290529,426530,398458,28072,0.06581483131315499,2021-11-29 16:22:53 UTC
800957,mainnet,252,108864000,109290755,426756,398665,28091,0.06582449924547049,2021-11-29 16:25:03 UTC
800958,mainnet,252,108864000,109291010,427011,398905,28106,0.06582031844612903,2021-11-29 16:27:57 UTC
800960,mainnet,252,108864000,109291269,427270,399148,28122,0.06581786692255483,2021-11-29 16:30:28 UTC
800961,mainnet,252,108864000,109291479,427480,399339,28141,0.06582998034995789,2021-11-29 16:32:38 UTC
800963,mainnet,252,108864000,109291694,427695,399543,28152,0.06582260723178901,2021-11-29 16:34:48 UTC
800964,mainnet,252,108864000,109291940,427941,399768,28173,0.0658338415809656,2021-11-29 16:37:03 UTC
800966,mainnet,252,108864000,109292158,428159,399967,28192,0.06584469788092741,2021-11-29 16:39:16 UTC
800967,mainnet,252,108864000,109292356,428357,400138,28219,0.06587729393940102,2021-11-29 16:41:28 UTC
800969,mainnet,252,108864000,109292583,428584,400351,28233,0.06587506766468183,2021-11-29 16:43:35 UTC
800970,mainnet,252,108864000,109292795,428796,400524,28272,0.06593345087174321,2021-11-29 16:45:45 UTC
800972,mainnet,252,108864000,109293030,429031,400731,28300,0.06596259943920137,2021-11-29 16:47:58 UTC
800973,mainnet,252,108864000,109293238,429239,400919,28320,0.06597722946889728,2021-11-29 16:50:08 UTC
800975,mainnet,252,108864000,109293456,429457,401120,28337,0.06598332312664597,2021-11-29 16:52:27 UTC
800976,mainnet,252,108864000,109293646,429647,401286,28361,0.06601000356106292,2021-11-29 16:54:38 UTC
800977,mainnet,252,108864000,109293840,429841,401459,28382,0.0660290665618217,2021-11-29 16:56:51 UTC
800979,mainnet,252,108864000,109294056,430057,401658,28399,0.06603543251243439,2021-11-29 16:58:58 UTC
800980,mainnet,252,108864000,109294287,430288,401866,28422,0.06605343397910236,2021-11-29 17:01:18 UTC
800981,mainnet,252,108864000,109294483,430484,402046,28438,0.06606052722052387,2021-11-29 17:03:33 UTC
800982,mainnet,252,108864000,109294757,430758,402280,28478,0.06611136647491167,2021-11-29 17:06:07 UTC
800984,mainnet,252,108864000,109294980,430981,402489,28492,0.0661096428844891,2021-11-29 17:08:49 UTC
800986,mainnet,252,108864000,109295272,431273,402758,28515,0.06611821282575074,2021-11-29 17:11:52 UTC
800987,mainnet,252,108864000,109295646,431647,403065,28582,0.0662161442104312,2021-11-29 17:14:57 UTC
800989,mainnet,252,108864000,109295849,431850,403244,28606,0.06624059279842538,2021-11-29 17:17:25 UTC
800990,mainnet,252,108864000,109295967,431968,403341,28627,0.06627111267501297,2021-11-29 17:19:39 UTC
800992,mainnet,252,108864000,109295967,431968,403341,28627,0.06627111267501297,2021-11-29 17:21:53 UTC
800996,mainnet,253,109296000,109297035,1036,760,276,0.26640926640926643,2021-11-29 17:33:04 UTC
800997,mainnet,253,109296000,109297209,1210,904,306,0.2528925619834711,2021-11-29 17:34:59 UTC
800998,mainnet,253,109296000,109297375,1376,1042,334,0.24273255813953487,2021-11-29 17:37:00 UTC
800999,mainnet,253,109296000,109297497,1498,1141,357,0.2383177570093458,2021-11-29 17:38:58 UTC
801001,mainnet,253,109296000,109297811,1812,1400,412,0.22737306843267108,2021-11-29 17:41:05 UTC
801003,mainnet,253,109296000,109298203,2204,1740,464,0.21052631578947367,2021-11-29 17:45:13 UTC
801004,mainnet,253,109296000,109298414,2415,1905,510,0.2111801242236025,2021-11-29 17:47:23 UTC
801006,mainnet,253,109296000,109298585,2586,2062,524,0.2026295436968291,2021-11-29 17:49:35 UTC
801007,mainnet,253,109296000,109298822,2823,2261,562,0.19907899397803755,2021-11-29 17:51:40 UTC
801008,mainnet,253,109296000,109299029,3030,2446,584,0.19273927392739273,2021-11-29 17:54:02 UTC
801010,mainnet,253,109296000,109299228,3229,2621,608,0.1882935893465469,2021-11-29 17:56:03 UTC
801011,mainnet,253,109296000,109299408,3409,2779,630,0.18480492813141683,2021-11-29 17:58:02 UTC
801013,mainnet,253,109296000,109299645,3646,2992,654,0.1793746571585299,2021-11-29 18:00:14 UTC
801014,mainnet,253,109296000,109299854,3855,3185,670,0.17380025940337224,2021-11-29 18:02:21 UTC
801016,mainnet,253,109296000,109300027,4028,3343,685,0.17005958291956305,2021-11-29 18:04:21 UTC
801017,mainnet,253,109296000,109300221,4222,3518,704,0.16674561819043107,2021-11-29 18:06:20 UTC
801019,mainnet,253,109296000,109300408,4409,3690,719,0.16307552733046043,2021-11-29 18:08:23 UTC
801020,mainnet,253,109296000,109300608,4609,3874,735,0.1594706009980473,2021-11-29 18:10:26 UTC
801021,mainnet,253,109296000,109300799,4800,4050,750,0.15625,2021-11-29 18:12:29 UTC
801023,mainnet,253,109296000,109300999,5000,4238,762,0.1524,2021-11-29 18:14:42 UTC
801024,mainnet,253,109296000,109301204,5205,4421,784,0.15062439961575408,2021-11-29 18:16:49 UTC
801025,mainnet,253,109296000,109301452,5453,4635,818,0.150009169264625,2021-11-29 18:18:59 UTC
801027,mainnet,253,109296000,109301693,5694,4846,848,0.14892869687390237,2021-11-29 18:21:24 UTC
801028,mainnet,253,109296000,109301913,5914,5044,870,0.1471085559688874,2021-11-29 18:23:44 UTC
801030,mainnet,253,109296000,109302076,6077,5189,888,0.14612473259832154,2021-11-29 18:26:04 UTC
801031,mainnet,253,109296000,109302302,6303,5389,914,0.14501031254957958,2021-11-29 18:28:10 UTC
801033,mainnet,253,109296000,109302512,6513,5563,950,0.1458621219100261,2021-11-29 18:30:11 UTC
801034,mainnet,253,109296000,109302725,6726,5752,974,0.1448111804936069,2021-11-29 18:32:13 UTC
801035,mainnet,253,109296000,109302970,6971,5970,1001,0.14359489312867593,2021-11-29 18:34:28 UTC
801037,mainnet,253,109296000,109303189,7190,6173,1017,0.14144645340751044,2021-11-29 18:36:47 UTC
801038,mainnet,253,109296000,109303393,7394,6353,1041,0.14078982959156072,2021-11-29 18:38:54 UTC
801040,mainnet,253,109296000,109303627,7628,6563,1065,0.13961719979024645,2021-11-29 18:40:54 UTC
801041,mainnet,253,109296000,109303833,7834,6746,1088,0.13888179729384734,2021-11-29 18:43:22 UTC
801043,mainnet,253,109296000,109304136,8137,7003,1134,0.1393634017451149,2021-11-29 18:45:41 UTC
801044,mainnet,253,109296000,109304362,8363,7201,1162,0.13894535453784526,2021-11-29 18:47:53 UTC
801046,mainnet,253,109296000,109304564,8565,7390,1175,0.13718622300058378,2021-11-29 18:49:58 UTC
801047,mainnet,253,109296000,109304723,8724,7532,1192,0.13663457129756992,2021-11-29 18:52:24 UTC
801049,mainnet,253,109296000,109305092,9093,7852,1241,0.13647860991971847,2021-11-29 18:54:29 UTC
801050,mainnet,253,109296000,109305296,9297,8033,1264,0.13595783586103044,2021-11-29 18:56:36 UTC
801052,mainnet,253,109296000,109305478,9479,8201,1278,0.1348243485599747,2021-11-29 18:58:40 UTC
801053,mainnet,253,109296000,109305682,9683,8391,1292,0.13342972219353505,2021-11-29 19:00:44 UTC
801055,mainnet,253,109296000,109305894,9895,8571,1324,0.13380495199595754,2021-11-29 19:02:50 UTC
801056,mainnet,253,109296000,109306088,10089,8746,1343,0.13311527406085835,2021-11-29 19:04:59 UTC
801058,mainnet,253,109296000,109306318,10319,8958,1361,0.1318926252543851,2021-11-29 19:07:04 UTC
801059,mainnet,253,109296000,109306535,10536,9150,1386,0.1315489749430524,2021-11-29 19:09:12 UTC
801061,mainnet,253,109296000,109306767,10768,9363,1405,0.13047919762258545,2021-11-29 19:11:33 UTC
801062,mainnet,253,109296000,109306981,10982,9559,1423,0.12957566927699873,2021-11-29 19:13:32 UTC
801064,mainnet,253,109296000,109307216,11217,9769,1448,0.1290897744494963,2021-11-29 19:15:45 UTC
801065,mainnet,253,109296000,109307436,11437,9969,1468,0.12835533793827053,2021-11-29 19:17:47 UTC
801066,mainnet,253,109296000,109307664,11665,10172,1493,0.1279897128161166,2021-11-29 19:20:02 UTC
801068,mainnet,253,109296000,109307859,11860,10341,1519,0.12807757166947722,2021-11-29 19:22:14 UTC
801069,mainnet,253,109296000,109308108,12109,10560,1549,0.1279213807911471,2021-11-29 19:24:23 UTC
801071,mainnet,253,109296000,109308331,12332,10751,1581,0.12820304897826793,2021-11-29 19:26:32 UTC
801072,mainnet,253,109296000,109308551,12552,10931,1621,0.1291427660930529,2021-11-29 19:28:31 UTC
801074,mainnet,253,109296000,109308774,12775,11137,1638,0.12821917808219177,2021-11-29 19:30:33 UTC
801075,mainnet,253,109296000,109309020,13021,11364,1657,0.12725597112356962,2021-11-29 19:32:48 UTC
801077,mainnet,253,109296000,109309253,13254,11569,1685,0.1271314320205221,2021-11-29 19:35:08 UTC
801078,mainnet,253,109296000,109309480,13481,11774,1707,0.1266226541057785,2021-11-29 19:37:23 UTC
801080,mainnet,253,109296000,109309719,13720,11996,1724,0.12565597667638484,2021-11-29 19:39:50 UTC
801081,mainnet,253,109296000,109309944,13945,12207,1738,0.12463248476156329,2021-11-29 19:41:59 UTC
801083,mainnet,253,109296000,109310164,14165,12418,1747,0.1233321567243205,2021-11-29 19:44:07 UTC
801084,mainnet,253,109296000,109310393,14394,12629,1765,0.12262053633458385,2021-11-29 19:46:32 UTC
801086,mainnet,253,109296000,109310700,14701,12904,1797,0.12223658254540508,2021-11-29 19:49:24 UTC
801087,mainnet,253,109296000,109310919,14920,13103,1817,0.1217828418230563,2021-11-29 19:51:43 UTC
801089,mainnet,253,109296000,109311140,15141,13309,1832,0.12099597120401559,2021-11-29 19:54:01 UTC
801090,mainnet,253,109296000,109311366,15367,13502,1865,0.12136396173618794,2021-11-29 19:56:08 UTC
801092,mainnet,253,109296000,109311575,15576,13697,1879,0.12063430919363123,2021-11-29 19:58:19 UTC
801093,mainnet,253,109296000,109311845,15846,13948,1898,0.11977786192098952,2021-11-29 20:00:58 UTC
801094,mainnet,253,109296000,109312071,16072,14146,1926,0.11983573917371827,2021-11-29 20:03:08 UTC
801096,mainnet,253,109296000,109312266,16267,14332,1935,0.11895248048195733,2021-11-29 20:05:18 UTC
801097,mainnet,253,109296000,109312504,16505,14544,1961,0.11881248106634353,2021-11-29 20:07:29 UTC
801099,mainnet,253,109296000,109312736,16737,14759,1978,0.11818127501941805,2021-11-29 20:09:49 UTC
801100,mainnet,253,109296000,109312955,16956,14961,1995,0.11765746638358103,2021-11-29 20:12:10 UTC
801102,mainnet,253,109296000,109313306,17307,15286,2021,0.11677355983128214,2021-11-29 20:15:26 UTC
801103,mainnet,253,109296000,109313543,17544,15508,2036,0.11605107159142727,2021-11-29 20:17:48 UTC
801105,mainnet,253,109296000,109313820,17821,15739,2082,0.11682846080466865,2021-11-29 20:20:06 UTC
801106,mainnet,253,109296000,109314038,18039,15952,2087,0.11569377459947891,2021-11-29 20:22:21 UTC
801108,mainnet,253,109296000,109314307,18308,16203,2105,0.11497705920908892,2021-11-29 20:24:31 UTC
801109,mainnet,253,109296000,109314553,18554,16425,2129,0.11474614638352916,2021-11-29 20:27:03 UTC
801111,mainnet,253,109296000,109314795,18796,16638,2158,0.11481166205575655,2021-11-29 20:29:12 UTC
801112,mainnet,253,109296000,109315023,19024,16845,2179,0.11453952901597982,2021-11-29 20:31:23 UTC
801114,mainnet,253,109296000,109315280,19281,17088,2193,0.11373891395674499,2021-11-29 20:34:05 UTC
801115,mainnet,253,109296000,109315570,19571,17343,2228,0.11384190894691125,2021-11-29 20:36:21 UTC
801117,mainnet,253,109296000,109315804,19805,17555,2250,0.11360767482958849,2021-11-29 20:38:30 UTC
801118,mainnet,253,109296000,109316031,20032,17761,2271,0.11336861022364217,2021-11-29 20:40:39 UTC
801120,mainnet,253,109296000,109316244,20245,17955,2290,0.11311434922203013,2021-11-29 20:42:40 UTC
801121,mainnet,253,109296000,109316458,20459,18148,2311,0.11295762256219756,2021-11-29 20:44:49 UTC
801123,mainnet,253,109296000,109316672,20673,18347,2326,0.11251390702849128,2021-11-29 20:46:57 UTC
801124,mainnet,253,109296000,109316906,20907,18558,2349,0.11235471373224279,2021-11-29 20:49:08 UTC
801126,mainnet,253,109296000,109317134,21135,18771,2364,0.11185237757274663,2021-11-29 20:51:14 UTC
801127,mainnet,253,109296000,109317374,21375,19000,2375,0.1111111111111111,2021-11-29 20:53:31 UTC
801129,mainnet,253,109296000,109317505,21506,19119,2387,0.11099228122384451,2021-11-29 20:55:37 UTC
801130,mainnet,253,109296000,109317810,21811,19348,2463,0.11292467103754986,2021-11-29 20:57:46 UTC
801131,mainnet,253,109296000,109318027,22028,19538,2490,0.11303795169783912,2021-11-29 20:59:54 UTC
801132,mainnet,253,109296000,109318260,22261,19738,2523,0.11333722653968824,2021-11-29 21:02:07 UTC
801134,mainnet,253,109296000,109318485,22486,19925,2561,0.1138930890331762,2021-11-29 21:04:25 UTC
801135,mainnet,253,109296000,109318683,22684,20105,2579,0.113692470463763,2021-11-29 21:06:33 UTC
801137,mainnet,253,109296000,109318929,22930,20316,2614,0.1139991277802006,2021-11-29 21:08:44 UTC
801138,mainnet,253,109296000,109319144,23145,20505,2640,0.11406351263771873,2021-11-29 21:10:54 UTC
801140,mainnet,253,109296000,109319355,23356,20698,2658,0.11380373351601301,2021-11-29 21:13:02 UTC
801141,mainnet,253,109296000,109319579,23580,20904,2676,0.11348600508905853,2021-11-29 21:15:09 UTC
801143,mainnet,253,109296000,109319808,23809,21120,2689,0.1129404846906632,2021-11-29 21:17:24 UTC
801144,mainnet,253,109296000,109320024,24025,21313,2712,0.11288241415192508,2021-11-29 21:19:32 UTC
801146,mainnet,253,109296000,109320249,24250,21516,2734,0.11274226804123712,2021-11-29 21:21:41 UTC
801147,mainnet,253,109296000,109320460,24461,21716,2745,0.11221945137157108,2021-11-29 21:23:51 UTC
801148,mainnet,253,109296000,109320706,24707,21953,2754,0.11146638604444084,2021-11-29 21:26:20 UTC
801150,mainnet,253,109296000,109320924,24925,22153,2772,0.11121364092276831,2021-11-29 21:28:39 UTC
801151,mainnet,253,109296000,109321145,25146,22326,2820,0.11214507277499404,2021-11-29 21:30:43 UTC
801152,mainnet,253,109296000,109321360,25361,22523,2838,0.11190410472773156,2021-11-29 21:32:50 UTC
801154,mainnet,253,109296000,109321575,25576,22706,2870,0.11221457616515483,2021-11-29 21:35:03 UTC
801155,mainnet,253,109296000,109321847,25848,22963,2885,0.11161405137728257,2021-11-29 21:37:34 UTC
801157,mainnet,253,109296000,109322137,26138,23224,2914,0.11148519397046446,2021-11-29 21:39:58 UTC
801158,mainnet,253,109296000,109322354,26355,23420,2935,0.11136406753936634,2021-11-29 21:42:19 UTC
801160,mainnet,253,109296000,109322593,26594,23640,2954,0.11107768669624728,2021-11-29 21:44:25 UTC
801161,mainnet,253,109296000,109322832,26833,23851,2982,0.11113181530205345,2021-11-29 21:46:42 UTC
801163,mainnet,253,109296000,109323070,27071,24072,2999,0.11078275645524731,2021-11-29 21:49:02 UTC
801164,mainnet,253,109296000,109323293,27294,24289,3005,0.11009745731662636,2021-11-29 21:51:14 UTC
801166,mainnet,253,109296000,109323513,27514,24498,3016,0.10961692229410482,2021-11-29 21:53:19 UTC
801167,mainnet,253,109296000,109323757,27758,24728,3030,0.10915772029685136,2021-11-29 21:55:27 UTC
801169,mainnet,253,109296000,109323967,27968,24933,3035,0.10851687643020595,2021-11-29 21:57:39 UTC
801170,mainnet,253,109296000,109324203,28204,25153,3051,0.1081761452276273,2021-11-29 21:59:48 UTC
801171,mainnet,253,109296000,109324445,28446,25384,3062,0.10764255079800324,2021-11-29 22:02:08 UTC
801173,mainnet,253,109296000,109324674,28675,25583,3092,0.10782911944202267,2021-11-29 22:04:18 UTC
801174,mainnet,253,109296000,109324945,28946,25809,3137,0.10837421405375527,2021-11-29 22:06:28 UTC
801176,mainnet,253,109296000,109325142,29143,25996,3147,0.1079847647805648,2021-11-29 22:08:35 UTC
801177,mainnet,253,109296000,109325402,29403,26227,3176,0.10801618882426964,2021-11-29 22:10:46 UTC
801179,mainnet,253,109296000,109325636,29637,26460,3177,0.10719708472517461,2021-11-29 22:12:57 UTC
801180,mainnet,253,109296000,109325885,29886,26693,3193,0.10683932275982065,2021-11-29 22:15:23 UTC
801182,mainnet,253,109296000,109326165,30166,26968,3198,0.10601339256116157,2021-11-29 22:17:53 UTC
801183,mainnet,253,109296000,109326400,30401,27173,3228,0.10618071773954804,2021-11-29 22:19:58 UTC
801185,mainnet,253,109296000,109326689,30690,27453,3237,0.10547409579667644,2021-11-29 22:22:38 UTC
801187,mainnet,253,109296000,109327018,31019,27765,3254,0.1049034462748638,2021-11-29 22:25:21 UTC
801188,mainnet,253,109296000,109327283,31284,28023,3261,0.1042385884158036,2021-11-29 22:27:50 UTC
801189,mainnet,253,109296000,109327560,31561,28281,3280,0.10392573112385539,2021-11-29 22:30:04 UTC
801191,mainnet,253,109296000,109327810,31811,28520,3291,0.10345477979315332,2021-11-29 22:32:08 UTC
801192,mainnet,253,109296000,109328060,32061,28761,3300,0.10292879199026855,2021-11-29 22:34:18 UTC
801194,mainnet,253,109296000,109328294,32295,28978,3317,0.10270939773958818,2021-11-29 22:36:26 UTC
801195,mainnet,253,109296000,109328520,32521,29203,3318,0.10202638295255373,2021-11-29 22:38:38 UTC
801197,mainnet,253,109296000,109328756,32757,29414,3343,0.10205452269743871,2021-11-29 22:40:46 UTC
801198,mainnet,253,109296000,109329000,33001,29645,3356,0.10169388806399807,2021-11-29 22:42:52 UTC
801199,mainnet,253,109296000,109329238,33239,29871,3368,0.10132675471584585,2021-11-29 22:45:04 UTC
801201,mainnet,253,109296000,109329502,33503,30119,3384,0.10100588007044145,2021-11-29 22:47:12 UTC
801202,mainnet,253,109296000,109329746,33747,30353,3394,0.1005719026876463,2021-11-29 22:49:27 UTC
801203,mainnet,253,109296000,109329991,33992,30588,3404,0.10014120969639916,2021-11-29 22:51:45 UTC
801204,mainnet,253,109296000,109330261,34262,30842,3420,0.09981904150370673,2021-11-29 22:54:00 UTC
801206,mainnet,253,109296000,109330477,34478,31052,3426,0.09936771274435872,2021-11-29 22:56:11 UTC
801207,mainnet,253,109296000,109330695,34696,31264,3432,0.0989163015909615,2021-11-29 22:58:18 UTC
801209,mainnet,253,109296000,109330932,34933,31472,3461,0.09907537285661122,2021-11-29 23:00:40 UTC
801211,mainnet,253,109296000,109331143,35144,31673,3471,0.09876508081038016,2021-11-29 23:03:12 UTC
801212,mainnet,253,109296000,109331395,35396,31915,3481,0.09834444570007911,2021-11-29 23:05:22 UTC
801214,mainnet,253,109296000,109331764,35765,32195,3570,0.09981825807353557,2021-11-29 23:08:02 UTC
801215,mainnet,253,109296000,109332056,36057,32463,3594,0.09967551376986439,2021-11-29 23:10:50 UTC
801217,mainnet,253,109296000,109332322,36323,32711,3612,0.09944112545769898,2021-11-29 23:13:10 UTC
801218,mainnet,253,109296000,109332574,36575,32945,3630,0.09924812030075188,2021-11-29 23:15:32 UTC
801219,mainnet,253,109296000,109332731,36732,33087,3645,0.09923227703364913,2021-11-29 23:17:39 UTC
801221,mainnet,253,109296000,109333055,37056,33385,3671,0.0990662780656304,2021-11-29 23:19:46 UTC
801222,mainnet,253,109296000,109333267,37268,33580,3688,0.0989588923473221,2021-11-29 23:21:55 UTC
801224,mainnet,253,109296000,109333501,37502,33793,3709,0.09890139192576396,2021-11-29 23:24:06 UTC
801225,mainnet,253,109296000,109333759,37760,34042,3718,0.09846398305084746,2021-11-29 23:26:23 UTC
801227,mainnet,253,109296000,109333997,37998,34272,3726,0.09805779251539555,2021-11-29 23:28:35 UTC
801228,mainnet,253,109296000,109334247,38248,34505,3743,0.09786132608240954,2021-11-29 23:30:40 UTC
801230,mainnet,253,109296000,109334489,38490,34729,3761,0.09771369186801766,2021-11-29 23:32:48 UTC
801231,mainnet,253,109296000,109334736,38737,34953,3784,0.09768438443865038,2021-11-29 23:35:02 UTC
801232,mainnet,253,109296000,109334986,38987,35190,3797,0.09739143817169826,2021-11-29 23:37:14 UTC
801234,mainnet,253,109296000,109335234,39235,35433,3802,0.09690327513699502,2021-11-29 23:39:26 UTC
801235,mainnet,253,109296000,109335460,39461,35648,3813,0.0966270494919034,2021-11-29 23:41:38 UTC
801237,mainnet,253,109296000,109335693,39694,35867,3827,0.09641255605381166,2021-11-29 23:43:45 UTC
801238,mainnet,253,109296000,109335915,39916,36083,3833,0.09602665597755286,2021-11-29 23:45:57 UTC
801240,mainnet,253,109296000,109336163,40164,36307,3857,0.09603127178567872,2021-11-29 23:48:09 UTC
801241,mainnet,253,109296000,109336409,40410,36535,3875,0.09589210591437763,2021-11-29 23:50:21 UTC
801243,mainnet,253,109296000,109336635,40636,36755,3881,0.09550644748498868,2021-11-29 23:52:35 UTC
801244,mainnet,253,109296000,109336869,40870,36983,3887,0.09510643503792512,2021-11-29 23:54:44 UTC
801246,mainnet,253,109296000,109337111,41112,37207,3905,0.09498443276902122,2021-11-29 23:56:56 UTC
801247,mainnet,253,109296000,109337344,41345,37421,3924,0.09490869512637562,2021-11-29 23:59:07 UTC
801249,mainnet,253,109296000,109337608,41609,37679,3930,0.09445071979619794,2021-11-30 00:01:24 UTC
801250,mainnet,253,109296000,109337858,41859,37907,3952,0.09441219331565494,2021-11-30 00:03:42 UTC
801252,mainnet,253,109296000,109338120,42121,38151,3970,0.09425227321288668,2021-11-30 00:05:58 UTC
801253,mainnet,253,109296000,109338364,42365,38386,3979,0.09392186946772099,2021-11-30 00:08:11 UTC
801255,mainnet,253,109296000,109338594,42595,38601,3994,0.09376687404624956,2021-11-30 00:10:23 UTC
801256,mainnet,253,109296000,109338874,42875,38859,4016,0.09366763848396502,2021-11-30 00:12:38 UTC
801258,mainnet,253,109296000,109339079,43080,39047,4033,0.09361652739090065,2021-11-30 00:14:49 UTC
801259,mainnet,253,109296000,109339430,43431,39363,4068,0.09366581474062306,2021-11-30 00:17:02 UTC
801260,mainnet,253,109296000,109339671,43672,39596,4076,0.09333211210844478,2021-11-30 00:19:15 UTC
801262,mainnet,253,109296000,109339954,43955,39857,4098,0.09323171425321351,2021-11-30 00:21:29 UTC
801264,mainnet,253,109296000,109340240,44241,40126,4115,0.09301326823534731,2021-11-30 00:23:52 UTC
801265,mainnet,253,109296000,109340481,44482,40357,4125,0.09273413965199406,2021-11-30 00:26:12 UTC
801266,mainnet,253,109296000,109340718,44719,40571,4148,0.09275699367159373,2021-11-30 00:28:20 UTC
801268,mainnet,253,109296000,109341017,45018,40855,4163,0.09247412146252611,2021-11-30 00:31:06 UTC
801269,mainnet,253,109296000,109341278,45279,41090,4189,0.09251529406568167,2021-11-30 00:33:25 UTC
801271,mainnet,253,109296000,109341576,45577,41353,4224,0.09267832459354498,2021-11-30 00:35:56 UTC
801272,mainnet,253,109296000,109341780,45781,41551,4230,0.0923964089906293,2021-11-30 00:38:18 UTC
801274,mainnet,253,109296000,109342070,46071,41818,4253,0.09231403702980183,2021-11-30 00:40:33 UTC
801275,mainnet,253,109296000,109342312,46313,42047,4266,0.09211236585839828,2021-11-30 00:42:58 UTC
801277,mainnet,253,109296000,109342566,46567,42253,4314,0.09264071123327679,2021-11-30 00:45:05 UTC
801278,mainnet,253,109296000,109342812,46813,42478,4335,0.09260248221647834,2021-11-30 00:47:31 UTC
801280,mainnet,253,109296000,109343038,47039,42670,4369,0.09288037585833032,2021-11-30 00:49:39 UTC
801281,mainnet,253,109296000,109343280,47281,42885,4396,0.09297603688585267,2021-11-30 00:51:55 UTC
801283,mainnet,253,109296000,109343543,47544,43134,4410,0.09275618374558305,2021-11-30 00:54:20 UTC
801284,mainnet,253,109296000,109343792,47793,43366,4427,0.09262862762329212,2021-11-30 00:56:32 UTC
801286,mainnet,253,109296000,109344031,48032,43591,4441,0.09245919387075283,2021-11-30 00:58:44 UTC
801287,mainnet,253,109296000,109344288,48289,43818,4471,0.09258837416388825,2021-11-30 01:01:12 UTC
801289,mainnet,253,109296000,109344533,48534,44054,4480,0.09230642436230271,2021-11-30 01:03:34 UTC
801290,mainnet,253,109296000,109344791,48792,44300,4492,0.09206427283161174,2021-11-30 01:05:52 UTC
801291,mainnet,253,109296000,109345044,49045,44540,4505,0.09185441941074524,2021-11-30 01:08:08 UTC
801293,mainnet,253,109296000,109345272,49273,44748,4525,0.09183528504454773,2021-11-30 01:10:23 UTC
801294,mainnet,253,109296000,109345540,49541,45001,4540,0.09164126682949476,2021-11-30 01:12:50 UTC
801296,mainnet,253,109296000,109345770,49771,45214,4557,0.09155934178537703,2021-11-30 01:15:10 UTC
801297,mainnet,253,109296000,109346043,50044,45462,4582,0.09155942770362081,2021-11-30 01:17:29 UTC
801299,mainnet,253,109296000,109346306,50307,45706,4601,0.09145844514679866,2021-11-30 01:19:57 UTC
801300,mainnet,253,109296000,109346615,50616,45998,4618,0.09123597281492019,2021-11-30 01:22:35 UTC
801302,mainnet,253,109296000,109346874,50875,46235,4640,0.09120393120393121,2021-11-30 01:24:54 UTC
801303,mainnet,253,109296000,109347083,51084,46437,4647,0.09096781771200375,2021-11-30 01:27:12 UTC
801305,mainnet,253,109296000,109347333,51334,46654,4680,0.09116764717341333,2021-11-30 01:29:20 UTC
801306,mainnet,253,109296000,109347598,51599,46896,4703,0.0911451772321169,2021-11-30 01:31:38 UTC
801308,mainnet,253,109296000,109347760,51761,47048,4713,0.09105310948397442,2021-11-30 01:33:51 UTC
801309,mainnet,253,109296000,109348088,52089,47346,4743,0.0910556931405863,2021-11-30 01:35:58 UTC
801311,mainnet,253,109296000,109348313,52314,47553,4761,0.0910081431356807,2021-11-30 01:38:05 UTC
801312,mainnet,253,109296000,109348558,52559,47777,4782,0.09098346619988965,2021-11-30 01:40:18 UTC
801313,mainnet,253,109296000,109348794,52795,47997,4798,0.09087981816459892,2021-11-30 01:42:30 UTC
801314,mainnet,253,109296000,109349067,53068,48249,4819,0.09080801989899752,2021-11-30 01:44:54 UTC
801316,mainnet,253,109296000,109349294,53295,48459,4836,0.0907402195327892,2021-11-30 01:47:15 UTC
801317,mainnet,253,109296000,109349540,53541,48688,4853,0.09064081731756972,2021-11-30 01:49:25 UTC
801319,mainnet,253,109296000,109349780,53781,48902,4879,0.0907197709228166,2021-11-30 01:51:39 UTC
801320,mainnet,253,109296000,109350024,54025,49132,4893,0.09056918093475243,2021-11-30 01:53:52 UTC
801322,mainnet,253,109296000,109350284,54285,49374,4911,0.09046697982868196,2021-11-30 01:56:06 UTC
801323,mainnet,253,109296000,109350550,54551,49633,4918,0.09015416765962127,2021-11-30 01:58:27 UTC
801325,mainnet,253,109296000,109350795,54796,49869,4927,0.08991532228629827,2021-11-30 02:00:45 UTC
801326,mainnet,253,109296000,109351035,55036,50084,4952,0.08997746929282652,2021-11-30 02:03:08 UTC
801328,mainnet,253,109296000,109351284,55285,50321,4964,0.08978927376322692,2021-11-30 02:05:30 UTC
801329,mainnet,253,109296000,109351538,55539,50544,4995,0.0899368011667477,2021-11-30 02:07:45 UTC
801331,mainnet,253,109296000,109351760,55761,50749,5012,0.0898836104087086,2021-11-30 02:09:56 UTC
801332,mainnet,253,109296000,109351991,55992,50972,5020,0.08965566509501358,2021-11-30 02:12:06 UTC
801333,mainnet,253,109296000,109352245,56246,51201,5045,0.08969526721900224,2021-11-30 02:14:19 UTC
801334,mainnet,253,109296000,109352504,56505,51438,5067,0.08967348022298911,2021-11-30 02:16:30 UTC
801336,mainnet,253,109296000,109352742,56743,51667,5076,0.08945596813703893,2021-11-30 02:18:46 UTC
801337,mainnet,253,109296000,109352967,56968,51874,5094,0.08941862098019941,2021-11-30 02:21:02 UTC
801339,mainnet,253,109296000,109353227,57228,52104,5124,0.08953659048018453,2021-11-30 02:23:14 UTC
801340,mainnet,253,109296000,109353487,57488,52356,5132,0.08927080434177567,2021-11-30 02:25:29 UTC
801342,mainnet,253,109296000,109353745,57746,52587,5159,0.08933952135212829,2021-11-30 02:27:41 UTC
801343,mainnet,253,109296000,109353934,57935,52742,5193,0.08963493570380598,2021-11-30 02:29:29 UTC
801345,mainnet,253,109296000,109354169,58170,52959,5211,0.08958225889633832,2021-11-30 02:31:41 UTC
801346,mainnet,253,109296000,109354435,58436,53203,5233,0.08955096173591622,2021-11-30 02:34:05 UTC
801348,mainnet,253,109296000,109354626,58627,53387,5240,0.0893786139492043,2021-11-30 02:36:14 UTC
801349,mainnet,253,109296000,109354927,58928,53659,5269,0.0894142003801249,2021-11-30 02:38:33 UTC
801351,mainnet,253,109296000,109355200,59201,53900,5301,0.08954240637827064,2021-11-30 02:40:49 UTC
801352,mainnet,253,109296000,109355451,59452,54142,5310,0.08931575052142905,2021-11-30 02:43:05 UTC
801354,mainnet,253,109296000,109355744,59745,54415,5330,0.08921248640053561,2021-11-30 02:45:37 UTC
801355,mainnet,253,109296000,109355985,59986,54644,5342,0.08905411262627946,2021-11-30 02:47:59 UTC
801357,mainnet,253,109296000,109356211,60212,54858,5354,0.08891915232843951,2021-11-30 02:50:08 UTC
801358,mainnet,253,109296000,109356492,60493,55101,5392,0.08913427999933876,2021-11-30 02:52:35 UTC
801360,mainnet,253,109296000,109356748,60749,55345,5404,0.08895619680982403,2021-11-30 02:54:50 UTC
801361,mainnet,253,109296000,109356974,60975,55562,5413,0.0887740877408774,2021-11-30 02:57:02 UTC
801363,mainnet,253,109296000,109357244,61245,55813,5432,0.08869295452690015,2021-11-30 02:59:14 UTC
801364,mainnet,253,109296000,109357501,61502,56045,5457,0.08872882182693245,2021-11-30 03:01:30 UTC
801366,mainnet,253,109296000,109357834,61835,56296,5539,0.08957710034769953,2021-11-30 03:03:50 UTC
801367,mainnet,253,109296000,109358035,62036,56478,5558,0.08959313946740602,2021-11-30 03:05:59 UTC
801368,mainnet,253,109296000,109358262,62263,56691,5572,0.08949135120376468,2021-11-30 03:08:15 UTC
801370,mainnet,253,109296000,109358501,62502,56914,5588,0.08940513903555086,2021-11-30 03:10:30 UTC
801371,mainnet,253,109296000,109358706,62707,57105,5602,0.08933611877461846,2021-11-30 03:12:43 UTC
801373,mainnet,253,109296000,109359031,63032,57406,5626,0.08925625079324788,2021-11-30 03:14:58 UTC
801374,mainnet,253,109296000,109359278,63279,57640,5639,0.08911329192939206,2021-11-30 03:17:12 UTC
801376,mainnet,253,109296000,109359525,63526,57865,5661,0.08911311903787425,2021-11-30 03:19:29 UTC
801377,mainnet,253,109296000,109359748,63749,58084,5665,0.08886413904531835,2021-11-30 03:21:42 UTC
801379,mainnet,253,109296000,109359977,63978,58312,5666,0.08856169308199693,2021-11-30 03:23:52 UTC
801380,mainnet,253,109296000,109360220,64221,58543,5678,0.08841344731474128,2021-11-30 03:26:05 UTC
801381,mainnet,253,109296000,109360456,64457,58769,5688,0.0882448764292474,2021-11-30 03:28:20 UTC
801383,mainnet,253,109296000,109360642,64643,58947,5696,0.08811472239840354,2021-11-30 03:30:34 UTC
801384,mainnet,253,109296000,109360985,64986,59264,5722,0.08804973378881606,2021-11-30 03:32:49 UTC
801385,mainnet,253,109296000,109361192,65193,59458,5735,0.0879695672848312,2021-11-30 03:35:01 UTC
801387,mainnet,253,109296000,109361440,65441,59672,5769,0.08815574334133036,2021-11-30 03:37:12 UTC
801388,mainnet,253,109296000,109361647,65648,59863,5785,0.08812149646600048,2021-11-30 03:39:22 UTC
801390,mainnet,253,109296000,109361865,65866,60063,5803,0.08810311845261591,2021-11-30 03:41:37 UTC
801391,mainnet,253,109296000,109362110,66111,60294,5817,0.08798838317375324,2021-11-30 03:43:52 UTC
801393,mainnet,253,109296000,109362357,66358,60525,5833,0.08790198619608788,2021-11-30 03:46:06 UTC
801394,mainnet,253,109296000,109362592,66593,60749,5844,0.08775697145345607,2021-11-30 03:48:20 UTC
801396,mainnet,253,109296000,109362835,66836,60978,5858,0.08764737566580885,2021-11-30 03:50:27 UTC
801397,mainnet,253,109296000,109363062,67063,61198,5865,0.08745507955206298,2021-11-30 03:52:47 UTC
801399,mainnet,253,109296000,109363349,67350,61441,5909,0.08773570898292501,2021-11-30 03:55:00 UTC
801400,mainnet,253,109296000,109363594,67595,61680,5915,0.08750647237221688,2021-11-30 03:57:17 UTC
801402,mainnet,253,109296000,109363848,67849,61921,5928,0.08737048445813497,2021-11-30 03:59:29 UTC
801403,mainnet,253,109296000,109364093,68094,62153,5941,0.08724704085528828,2021-11-30 04:01:44 UTC
801405,mainnet,253,109296000,109364329,68330,62382,5948,0.08704814869018,2021-11-30 04:03:57 UTC
801406,mainnet,253,109296000,109364570,68571,62597,5974,0.08712137784194485,2021-11-30 04:06:12 UTC
801407,mainnet,253,109296000,109364813,68814,62822,5992,0.08707530444386316,2021-11-30 04:08:25 UTC
801409,mainnet,253,109296000,109365023,69024,63023,6001,0.08694077422345851,2021-11-30 04:10:37 UTC
801411,mainnet,253,109296000,109365309,69310,63298,6012,0.08674073005338336,2021-11-30 04:13:22 UTC
801412,mainnet,253,109296000,109365593,69594,63553,6041,0.0868034600683967,2021-11-30 04:15:40 UTC
801414,mainnet,253,109296000,109365850,69851,63801,6050,0.08661293324361856,2021-11-30 04:18:00 UTC
801415,mainnet,253,109296000,109366124,70125,64051,6074,0.08661675579322638,2021-11-30 04:20:18 UTC
801417,mainnet,253,109296000,109366484,70485,64386,6099,0.08652904873377314,2021-11-30 04:23:14 UTC
801418,mainnet,253,109296000,109366743,70744,64620,6124,0.086565645143051,2021-11-30 04:25:21 UTC
801420,mainnet,253,109296000,109366968,70969,64839,6130,0.08637574152094576,2021-11-30 04:27:29 UTC
801421,mainnet,253,109296000,109367235,71236,65094,6142,0.08622045033410074,2021-11-30 04:29:49 UTC
801423,mainnet,253,109296000,109367536,71537,65381,6156,0.08605337098284804,2021-11-30 04:32:23 UTC
801424,mainnet,253,109296000,109367767,71768,65591,6177,0.0860690001114703,2021-11-30 04:34:39 UTC
801426,mainnet,253,109296000,109368030,72031,65826,6205,0.08614346600769113,2021-11-30 04:37:02 UTC
801427,mainnet,253,109296000,109368280,72281,66067,6214,0.08597003361879332,2021-11-30 04:39:23 UTC
801429,mainnet,253,109296000,109368555,72556,66322,6234,0.08591984122608744,2021-11-30 04:41:38 UTC
801430,mainnet,253,109296000,109368815,72816,66574,6242,0.08572291803999121,2021-11-30 04:43:58 UTC
801432,mainnet,253,109296000,109369087,73088,66833,6255,0.08558176444833625,2021-11-30 04:46:34 UTC
801433,mainnet,253,109296000,109369357,73358,67079,6279,0.08559393658496688,2021-11-30 04:48:54 UTC
801435,mainnet,253,109296000,109369636,73637,67340,6297,0.08551407580428318,2021-11-30 04:51:14 UTC
801436,mainnet,253,109296000,109369910,73911,67606,6305,0.08530529961710706,2021-11-30 04:53:41 UTC
801438,mainnet,253,109296000,109370200,74201,67890,6311,0.0850527620921551,2021-11-30 04:56:14 UTC
801439,mainnet,253,109296000,109370475,74476,68152,6324,0.08491326064772545,2021-11-30 04:58:36 UTC
801441,mainnet,253,109296000,109370660,74661,68323,6338,0.08489037114423863,2021-11-30 05:00:49 UTC
801443,mainnet,253,109296000,109371023,75024,68655,6369,0.08489283429302623,2021-11-30 05:03:37 UTC
801444,mainnet,253,109296000,109371248,75249,68857,6392,0.0849446504272482,2021-11-30 05:05:57 UTC
801446,mainnet,253,109296000,109371492,75493,69086,6407,0.08486879578239043,2021-11-30 05:08:16 UTC
801447,mainnet,253,109296000,109371734,75735,69311,6424,0.08482207697893972,2021-11-30 05:10:28 UTC
801449,mainnet,253,109296000,109371997,75998,69550,6448,0.08484433800889497,2021-11-30 05:13:07 UTC
801450,mainnet,253,109296000,109372241,76242,69779,6463,0.08476954959208835,2021-11-30 05:15:19 UTC
801452,mainnet,253,109296000,109372521,76522,70020,6502,0.08496902851467551,2021-11-30 05:17:41 UTC
801453,mainnet,253,109296000,109372755,76756,70213,6543,0.08524415029443952,2021-11-30 05:19:51 UTC
801455,mainnet,253,109296000,109373011,77012,70460,6552,0.08507765023632681,2021-11-30 05:22:09 UTC
801456,mainnet,253,109296000,109373252,77253,70695,6558,0.08488990718807037,2021-11-30 05:24:24 UTC
801457,mainnet,253,109296000,109373485,77486,70906,6580,0.08491856593449139,2021-11-30 05:26:35 UTC
801459,mainnet,253,109296000,109373713,77714,71112,6602,0.08495251820778753,2021-11-30 05:28:45 UTC
801460,mainnet,253,109296000,109373934,77935,71323,6612,0.08483993071149035,2021-11-30 05:30:53 UTC
801462,mainnet,253,109296000,109374208,78209,71582,6627,0.08473449347261824,2021-11-30 05:33:09 UTC
801463,mainnet,253,109296000,109374456,78457,71821,6636,0.08458136303962681,2021-11-30 05:35:25 UTC
801464,mainnet,253,109296000,109374690,78691,72036,6655,0.08457129786125478,2021-11-30 05:37:33 UTC
801466,mainnet,253,109296000,109374926,78927,72263,6664,0.08443245023882828,2021-11-30 05:39:41 UTC
801467,mainnet,253,109296000,109375176,79177,72496,6681,0.0843805650630865,2021-11-30 05:41:58 UTC
801468,mainnet,253,109296000,109375429,79430,72743,6687,0.08418733476016618,2021-11-30 05:44:21 UTC
801470,mainnet,253,109296000,109375662,79663,72963,6700,0.08410428931875526,2021-11-30 05:46:33 UTC
801471,mainnet,253,109296000,109375928,79929,73218,6711,0.08396201628945689,2021-11-30 05:49:04 UTC
801473,mainnet,253,109296000,109376190,80191,73458,6733,0.08396204062800065,2021-11-30 05:51:23 UTC
801474,mainnet,253,109296000,109376482,80483,73718,6765,0.08405501782985227,2021-11-30 05:53:56 UTC
801476,mainnet,253,109296000,109376725,80726,73947,6779,0.08397542303594877,2021-11-30 05:56:05 UTC
801477,mainnet,253,109296000,109376958,80959,74162,6797,0.08395607653256587,2021-11-30 05:58:16 UTC
801479,mainnet,253,109296000,109377220,81221,74401,6820,0.08396843180950739,2021-11-30 06:00:39 UTC
801480,mainnet,253,109296000,109377508,81509,74652,6857,0.08412567937283,2021-11-30 06:03:08 UTC
801481,mainnet,253,109296000,109377739,81740,74879,6861,0.08393687301198924,2021-11-30 06:05:19 UTC
801483,mainnet,253,109296000,109378012,82013,75145,6868,0.08374282126004413,2021-11-30 06:07:49 UTC
801484,mainnet,253,109296000,109378283,82284,75400,6884,0.08366146516941325,2021-11-30 06:10:14 UTC
801486,mainnet,253,109296000,109378540,82541,75644,6897,0.08355847397051162,2021-11-30 06:12:27 UTC
801487,mainnet,253,109296000,109378780,82781,75875,6906,0.08342494050567159,2021-11-30 06:14:41 UTC
801489,mainnet,253,109296000,109379068,83069,76138,6931,0.08343666108897423,2021-11-30 06:17:24 UTC
801490,mainnet,253,109296000,109379355,83356,76412,6944,0.08330534094726234,2021-11-30 06:20:01 UTC
801492,mainnet,253,109296000,109379599,83600,76636,6964,0.08330143540669857,2021-11-30 06:22:12 UTC
801493,mainnet,253,109296000,109379825,83826,76854,6972,0.08317228544842889,2021-11-30 06:24:26 UTC
801495,mainnet,253,109296000,109380106,84107,77109,6998,0.08320353834995899,2021-11-30 06:26:52 UTC
801496,mainnet,253,109296000,109380351,84352,77332,7020,0.08322268588770865,2021-11-30 06:29:09 UTC
801498,mainnet,253,109296000,109380578,84579,77549,7030,0.08311755873207298,2021-11-30 06:31:21 UTC
801499,mainnet,253,109296000,109380855,84856,77800,7056,0.08315263505232394,2021-11-30 06:33:43 UTC
801501,mainnet,253,109296000,109381102,85103,78037,7066,0.0830288003948157,2021-11-30 06:35:55 UTC
801502,mainnet,253,109296000,109381357,85358,78274,7084,0.0829916352304412,2021-11-30 06:38:09 UTC
801503,mainnet,253,109296000,109381634,85635,78538,7097,0.0828749927015823,2021-11-30 06:40:31 UTC
801505,mainnet,253,109296000,109381860,85861,78756,7105,0.08275002620514553,2021-11-30 06:42:41 UTC
801506,mainnet,253,109296000,109382141,86142,79012,7130,0.08277030948898331,2021-11-30 06:44:54 UTC
801508,mainnet,253,109296000,109382383,86384,79235,7149,0.08275838118170031,2021-11-30 06:47:09 UTC
801509,mainnet,253,109296000,109382639,86640,79480,7160,0.08264081255771007,2021-11-30 06:49:26 UTC
801511,mainnet,253,109296000,109382896,86897,79724,7173,0.08254600273887476,2021-11-30 06:51:41 UTC
801512,mainnet,253,109296000,109383157,87158,79963,7195,0.08255122880286377,2021-11-30 06:53:55 UTC
801514,mainnet,253,109296000,109383457,87458,80249,7209,0.08242813693429989,2021-11-30 06:56:29 UTC
801515,mainnet,253,109296000,109383696,87697,80453,7244,0.08260259758030492,2021-11-30 06:58:40 UTC
801517,mainnet,253,109296000,109383962,87963,80713,7250,0.08242101792799245,2021-11-30 07:01:00 UTC
801518,mainnet,253,109296000,109384215,88216,80960,7256,0.08225265258003084,2021-11-30 07:03:17 UTC
801520,mainnet,253,109296000,109384466,88467,81201,7266,0.08213232052629794,2021-11-30 07:05:28 UTC
801522,mainnet,253,109296000,109384737,88738,81451,7287,0.08211814555207465,2021-11-30 07:08:01 UTC
801523,mainnet,253,109296000,109384983,88984,81668,7316,0.0822170277802751,2021-11-30 07:10:13 UTC
801525,mainnet,253,109296000,109385279,89280,81944,7336,0.082168458781362,2021-11-30 07:12:49 UTC
801526,mainnet,253,109296000,109385510,89511,82173,7338,0.08197875121493448,2021-11-30 07:15:01 UTC
801528,mainnet,253,109296000,109385748,89749,82398,7351,0.081906205083065,2021-11-30 07:17:11 UTC
801529,mainnet,253,109296000,109386008,90009,82631,7378,0.08196958081969581,2021-11-30 07:19:25 UTC
801530,mainnet,253,109296000,109386287,90288,82892,7396,0.08191564770512139,2021-11-30 07:21:40 UTC
801532,mainnet,253,109296000,109386556,90557,83143,7414,0.08187108671886216,2021-11-30 07:23:53 UTC
801533,mainnet,253,109296000,109386783,90784,83360,7424,0.08177652449770885,2021-11-30 07:26:05 UTC
801535,mainnet,253,109296000,109387044,91045,83605,7440,0.08171783184139711,2021-11-30 07:28:16 UTC
801536,mainnet,253,109296000,109387290,91291,83843,7448,0.08158526032138984,2021-11-30 07:30:27 UTC
801538,mainnet,253,109296000,109387523,91524,84067,7457,0.08147589703247236,2021-11-30 07:32:43 UTC
801539,mainnet,253,109296000,109387776,91777,84306,7471,0.08140383756278806,2021-11-30 07:34:55 UTC
801541,mainnet,253,109296000,109388040,92041,84554,7487,0.08134418357036538,2021-11-30 07:37:36 UTC
801542,mainnet,253,109296000,109388361,92362,84846,7516,0.0813754574392066,2021-11-30 07:39:49 UTC
801544,mainnet,253,109296000,109388646,92647,85106,7541,0.08139497231426814,2021-11-30 07:42:37 UTC
801545,mainnet,253,109296000,109388898,92899,85345,7554,0.08131411532955145,2021-11-30 07:45:09 UTC
801547,mainnet,253,109296000,109389215,93216,85628,7588,0.08140233436319945,2021-11-30 07:47:25 UTC
801548,mainnet,253,109296000,109389481,93482,85878,7604,0.08134186260456558,2021-11-30 07:49:40 UTC
801550,mainnet,253,109296000,109389754,93755,86143,7612,0.08119033651538585,2021-11-30 07:51:56 UTC
801551,mainnet,253,109296000,109389986,93987,86361,7626,0.08113888090906189,2021-11-30 07:54:04 UTC
801553,mainnet,253,109296000,109390272,94273,86628,7645,0.08109426877260721,2021-11-30 07:56:36 UTC
801554,mainnet,253,109296000,109390531,94532,86866,7666,0.08109423264079889,2021-11-30 07:58:49 UTC
801556,mainnet,253,109296000,109390824,94825,87138,7687,0.08106511995781703,2021-11-30 08:01:30 UTC
801557,mainnet,253,109296000,109391069,95070,87370,7700,0.08099295256127065,2021-11-30 08:03:58 UTC
801559,mainnet,253,109296000,109391329,95330,87618,7712,0.08089793349417812,2021-11-30 08:06:28 UTC
801560,mainnet,253,109296000,109391607,95608,87877,7731,0.08086143418960756,2021-11-30 08:08:50 UTC
801562,mainnet,253,109296000,109391860,95861,88108,7753,0.0808775205766683,2021-11-30 08:11:04 UTC
801563,mainnet,253,109296000,109392144,96145,88383,7762,0.08073222736491757,2021-11-30 08:13:28 UTC
801565,mainnet,253,109296000,109392426,96427,88658,7769,0.08056872037914692,2021-11-30 08:15:51 UTC
801566,mainnet,253,109296000,109392681,96682,88907,7775,0.08041827847996524,2021-11-30 08:18:03 UTC
801568,mainnet,253,109296000,109392958,96959,89163,7796,0.08040511968976578,2021-11-30 08:20:24 UTC
801570,mainnet,253,109296000,109393212,97213,89407,7806,0.08029790254389844,2021-11-30 08:22:47 UTC
801571,mainnet,253,109296000,109393479,97480,89651,7829,0.08031391054575297,2021-11-30 08:25:02 UTC
801572,mainnet,253,109296000,109393744,97745,89906,7839,0.08019847562535168,2021-11-30 08:27:16 UTC
801574,mainnet,253,109296000,109393991,97992,90132,7860,0.08021062943913788,2021-11-30 08:29:26 UTC
801575,mainnet,253,109296000,109394240,98241,90362,7879,0.08020073085575269,2021-11-30 08:31:38 UTC
801577,mainnet,253,109296000,109394502,98503,90611,7892,0.08011938722678497,2021-11-30 08:33:52 UTC
801578,mainnet,253,109296000,109394752,98753,90859,7894,0.07993681204621632,2021-11-30 08:36:07 UTC
801579,mainnet,253,109296000,109395027,99028,91121,7907,0.07984610413216464,2021-11-30 08:38:25 UTC
801581,mainnet,253,109296000,109395270,99271,91356,7915,0.07973124074503128,2021-11-30 08:40:35 UTC
801582,mainnet,253,109296000,109395507,99508,91579,7929,0.07968203561522692,2021-11-30 08:42:47 UTC
801584,mainnet,253,109296000,109395764,99765,91820,7945,0.07963714729614595,2021-11-30 08:45:00 UTC
801585,mainnet,253,109296000,109395984,99985,92008,7977,0.07978196729509426,2021-11-30 08:47:17 UTC
801586,mainnet,253,109296000,109396225,100226,92226,8000,0.07981960768662821,2021-11-30 08:49:31 UTC
801588,mainnet,253,109296000,109396475,100476,92461,8015,0.07977029340339982,2021-11-30 08:51:49 UTC
801589,mainnet,253,109296000,109396729,100730,92700,8030,0.07971805817532017,2021-11-30 08:54:01 UTC
801590,mainnet,253,109296000,109396953,100954,92921,8033,0.07957089367434673,2021-11-30 08:56:11 UTC
801592,mainnet,253,109296000,109397203,101204,93153,8051,0.07955219161297973,2021-11-30 08:58:22 UTC
801593,mainnet,253,109296000,109397460,101461,93397,8064,0.07947881451986477,2021-11-30 09:00:40 UTC
801594,mainnet,253,109296000,109397690,101691,93614,8077,0.07942689126864717,2021-11-30 09:02:52 UTC
801596,mainnet,253,109296000,109397939,101940,93854,8086,0.0793211693152835,2021-11-30 09:05:06 UTC
801597,mainnet,253,109296000,109398216,102217,94109,8108,0.07932144359548803,2021-11-30 09:07:20 UTC
801599,mainnet,253,109296000,109398456,102457,94337,8120,0.07925275969431078,2021-11-30 09:09:34 UTC
801600,mainnet,253,109296000,109398691,102692,94555,8137,0.07923694153390722,2021-11-30 09:11:52 UTC
801602,mainnet,253,109296000,109398924,102925,94788,8137,0.07905756618897256,2021-11-30 09:14:02 UTC
801603,mainnet,253,109296000,109399175,103176,95039,8137,0.07886523997828952,2021-11-30 09:16:12 UTC
801605,mainnet,253,109296000,109399431,103432,95275,8157,0.07886340784283394,2021-11-30 09:18:25 UTC
801606,mainnet,253,109296000,109399688,103689,95520,8169,0.07878367039898157,2021-11-30 09:21:03 UTC
801608,mainnet,253,109296000,109400072,104073,95873,8200,0.07879084873117907,2021-11-30 09:23:56 UTC
801609,mainnet,253,109296000,109400377,104378,96153,8225,0.07880013029565618,2021-11-30 09:26:16 UTC
801611,mainnet,253,109296000,109400613,104614,96366,8248,0.07884221997055843,2021-11-30 09:28:59 UTC
801613,mainnet,253,109296000,109400921,104922,96642,8280,0.07891576599759821,2021-11-30 09:31:22 UTC
801614,mainnet,253,109296000,109401260,105261,96952,8309,0.07893711821092332,2021-11-30 09:34:12 UTC
801616,mainnet,253,109296000,109401526,105527,97204,8323,0.07887081031394809,2021-11-30 09:36:24 UTC
801617,mainnet,253,109296000,109401780,105781,97453,8328,0.07872869418893752,2021-11-30 09:38:55 UTC
801619,mainnet,253,109296000,109402055,106056,97710,8346,0.07869427472278796,2021-11-30 09:41:05 UTC
801620,mainnet,253,109296000,109402312,106313,97959,8354,0.07857928945660456,2021-11-30 09:43:22 UTC
801622,mainnet,253,109296000,109402659,106660,98268,8392,0.07867991749484343,2021-11-30 09:46:24 UTC
801623,mainnet,253,109296000,109402939,106940,98537,8403,0.07857677202169441,2021-11-30 09:48:40 UTC
801625,mainnet,253,109296000,109403157,107158,98745,8413,0.07851023721980627,2021-11-30 09:50:49 UTC
801626,mainnet,253,109296000,109403377,107378,98964,8414,0.07835869544971968,2021-11-30 09:52:57 UTC
801627,mainnet,253,109296000,109403625,107626,99194,8432,0.07834538122758442,2021-11-30 09:55:15 UTC
801629,mainnet,253,109296000,109403892,107893,99446,8447,0.07829052857924054,2021-11-30 09:57:36 UTC
801630,mainnet,253,109296000,109404121,108122,99663,8459,0.07823569671297238,2021-11-30 09:59:48 UTC
801632,mainnet,253,109296000,109404416,108417,99920,8497,0.0783733178376085,2021-11-30 10:02:11 UTC
801633,mainnet,253,109296000,109404673,108674,100168,8506,0.0782707915416751,2021-11-30 10:04:30 UTC
801635,mainnet,253,109296000,109404923,108924,100404,8520,0.07821967610443979,2021-11-30 10:06:43 UTC
801636,mainnet,253,109296000,109405157,109158,100622,8536,0.07819857454332252,2021-11-30 10:08:54 UTC
801638,mainnet,253,109296000,109405421,109422,100865,8557,0.07820182413043081,2021-11-30 10:11:32 UTC
801639,mainnet,253,109296000,109405709,109710,101135,8575,0.07816060523197521,2021-11-30 10:13:46 UTC
801641,mainnet,253,109296000,109406017,110018,101409,8609,0.07825083168208838,2021-11-30 10:16:06 UTC
801642,mainnet,253,109296000,109406288,110289,101657,8632,0.07826709826002594,2021-11-30 10:18:21 UTC
801644,mainnet,253,109296000,109406558,110559,101909,8650,0.07823876844038025,2021-11-30 10:20:39 UTC
801645,mainnet,253,109296000,109406889,110890,102193,8697,0.07842907385697538,2021-11-30 10:23:14 UTC
801646,mainnet,253,109296000,109407152,111153,102436,8717,0.07842343436524431,2021-11-30 10:25:26 UTC
801648,mainnet,253,109296000,109407371,111372,102651,8721,0.07830513953237797,2021-11-30 10:27:38 UTC
801649,mainnet,253,109296000,109407650,111651,102900,8751,0.07837816051804283,2021-11-30 10:29:48 UTC
801650,mainnet,253,109296000,109407881,111882,103118,8764,0.07833252891439195,2021-11-30 10:32:04 UTC
801651,mainnet,253,109296000,109408114,112115,103350,8765,0.07817865584444543,2021-11-30 10:34:17 UTC
801653,mainnet,253,109296000,109408360,112361,103586,8775,0.07809649255524603,2021-11-30 10:36:34 UTC
801654,mainnet,253,109296000,109408603,112604,103821,8783,0.07799900536393023,2021-11-30 10:38:48 UTC
801656,mainnet,253,109296000,109408859,112860,104068,8792,0.07790182527024632,2021-11-30 10:41:03 UTC
801657,mainnet,253,109296000,109409160,113161,104351,8810,0.07785367750373362,2021-11-30 10:43:44 UTC
801659,mainnet,253,109296000,109409454,113455,104643,8812,0.07766956061874752,2021-11-30 10:46:17 UTC
801660,mainnet,253,109296000,109409693,113694,104869,8825,0.0776206308160501,2021-11-30 10:48:27 UTC
801662,mainnet,253,109296000,109409956,113957,105122,8835,0.07752924348657828,2021-11-30 10:51:13 UTC
801663,mainnet,253,109296000,109410220,114221,105374,8847,0.07745510895544602,2021-11-30 10:53:30 UTC
801665,mainnet,253,109296000,109410467,114468,105606,8862,0.07741901666841387,2021-11-30 10:55:55 UTC
801666,mainnet,253,109296000,109410717,114718,105833,8885,0.07745079237783085,2021-11-30 10:58:07 UTC
801668,mainnet,253,109296000,109410967,114968,106068,8900,0.07741284531347853,2021-11-30 11:00:32 UTC
801669,mainnet,253,109296000,109411188,115189,106285,8904,0.07729904765211956,2021-11-30 11:02:46 UTC
801671,mainnet,253,109296000,109411440,115441,106526,8915,0.0772255957588725,2021-11-30 11:04:59 UTC
801672,mainnet,253,109296000,109411702,115703,106781,8922,0.07711122442806151,2021-11-30 11:07:12 UTC
801674,mainnet,253,109296000,109411950,115951,107015,8936,0.07706703693801692,2021-11-30 11:09:25 UTC
801675,mainnet,253,109296000,109412188,116189,107253,8936,0.07690917384606116,2021-11-30 11:11:39 UTC
801677,mainnet,253,109296000,109412438,116439,107489,8950,0.07686428086809402,2021-11-30 11:14:01 UTC
801678,mainnet,253,109296000,109412728,116729,107754,8975,0.07688749154023422,2021-11-30 11:16:22 UTC
801680,mainnet,253,109296000,109413000,117001,108001,9000,0.07692241946650029,2021-11-30 11:18:52 UTC
801681,mainnet,253,109296000,109413252,117253,108241,9012,0.07685944069661331,2021-11-30 11:21:11 UTC
801683,mainnet,253,109296000,109413477,117478,108454,9024,0.07681438226731814,2021-11-30 11:23:20 UTC
801684,mainnet,253,109296000,109413706,117707,108663,9044,0.07683485264257861,2021-11-30 11:25:33 UTC
801686,mainnet,253,109296000,109413992,117993,108925,9068,0.07685201664505521,2021-11-30 11:27:47 UTC
801687,mainnet,253,109296000,109414227,118228,109125,9103,0.0769952972223162,2021-11-30 11:30:03 UTC
801689,mainnet,253,109296000,109414468,118469,109350,9119,0.0769737230836759,2021-11-30 11:32:17 UTC
801690,mainnet,253,109296000,109414689,118690,109571,9119,0.0768303985171455,2021-11-30 11:34:27 UTC
801691,mainnet,253,109296000,109414936,118937,109796,9141,0.07685581442276163,2021-11-30 11:36:45 UTC
801693,mainnet,253,109296000,109415172,119173,110014,9159,0.07685465667558927,2021-11-30 11:38:57 UTC
801694,mainnet,253,109296000,109415380,119381,110220,9161,0.07673750429297795,2021-11-30 11:41:10 UTC
801696,mainnet,253,109296000,109415619,119620,110424,9196,0.07687677645878616,2021-11-30 11:43:23 UTC
801697,mainnet,253,109296000,109415856,119857,110642,9215,0.07688328591571623,2021-11-30 11:45:34 UTC
801698,mainnet,253,109296000,109416086,120087,110856,9231,0.07686926977940993,2021-11-30 11:47:47 UTC
801699,mainnet,253,109296000,109416309,120310,111067,9243,0.07682653146039398,2021-11-30 11:49:56 UTC
801700,mainnet,253,109296000,109416540,120541,111283,9258,0.07680374312474594,2021-11-30 11:52:11 UTC
801702,mainnet,253,109296000,109416814,120815,111532,9283,0.07683648553573645,2021-11-30 11:54:25 UTC
801703,mainnet,253,109296000,109417007,121008,111706,9302,0.07687095068094671,2021-11-30 11:56:35 UTC
801704,mainnet,253,109296000,109417222,121223,111884,9339,0.07703983567474819,2021-11-30 11:58:50 UTC
801706,mainnet,253,109296000,109417456,121457,112085,9372,0.07716311122454861,2021-11-30 12:01:08 UTC
801707,mainnet,253,109296000,109417663,121664,112252,9412,0.07736059968437664,2021-11-30 12:03:19 UTC
801709,mainnet,253,109296000,109417874,121875,112443,9432,0.07739076923076924,2021-11-30 12:05:34 UTC
801710,mainnet,253,109296000,109418102,122103,112643,9460,0.07747557390072315,2021-11-30 12:07:45 UTC
801711,mainnet,253,109296000,109418310,122311,112826,9485,0.07754821724947061,2021-11-30 12:09:56 UTC
801713,mainnet,253,109296000,109418548,122549,113024,9525,0.077724012435842,2021-11-30 12:12:13 UTC
801714,mainnet,253,109296000,109418764,122765,113229,9536,0.0776768622978862,2021-11-30 12:14:30 UTC
801716,mainnet,253,109296000,109418991,122992,113438,9554,0.07767984909587615,2021-11-30 12:16:54 UTC
801717,mainnet,253,109296000,109419276,123277,113705,9572,0.0776462762721351,2021-11-30 12:19:16 UTC
801719,mainnet,253,109296000,109419486,123487,113905,9582,0.07759521245151312,2021-11-30 12:21:25 UTC
801720,mainnet,253,109296000,109419731,123732,114128,9604,0.0776193708983933,2021-11-30 12:23:45 UTC
801722,mainnet,253,109296000,109419998,123999,114364,9635,0.0777022395341898,2021-11-30 12:26:09 UTC
801723,mainnet,253,109296000,109420219,124220,114581,9639,0.0775962002898084,2021-11-30 12:28:19 UTC
801725,mainnet,253,109296000,109420453,124454,114810,9644,0.07749047840969354,2021-11-30 12:30:55 UTC
801727,mainnet,253,109296000,109420704,124705,115042,9663,0.07748686901086564,2021-11-30 12:33:12 UTC
801728,mainnet,253,109296000,109420908,124909,115216,9693,0.07760049315901976,2021-11-30 12:35:23 UTC
801729,mainnet,253,109296000,109421127,125128,115415,9713,0.07762451249920081,2021-11-30 12:37:41 UTC
801732,mainnet,253,109296000,109421735,125736,115973,9763,0.07764681555004135,2021-11-30 12:43:36 UTC
801733,mainnet,253,109296000,109421970,125971,116180,9791,0.07772423811829707,2021-11-30 12:45:58 UTC
801735,mainnet,253,109296000,109422183,126184,116369,9815,0.07778323717745514,2021-11-30 12:47:57 UTC
801736,mainnet,253,109296000,109422375,126376,116541,9835,0.07782332088371209,2021-11-30 12:50:22 UTC
801738,mainnet,253,109296000,109422610,126611,116753,9858,0.07786053344496134,2021-11-30 12:52:54 UTC
801739,mainnet,253,109296000,109422848,126849,116968,9881,0.07789576583181577,2021-11-30 12:55:04 UTC
801741,mainnet,253,109296000,109423091,127092,117165,9927,0.07810877159852705,2021-11-30 12:57:24 UTC
801742,mainnet,253,109296000,109423335,127336,117384,9952,0.07815543129986807,2021-11-30 12:59:33 UTC
801744,mainnet,253,109296000,109423545,127546,117582,9964,0.07812083483605915,2021-11-30 13:01:46 UTC
801745,mainnet,253,109296000,109423804,127805,117820,9985,0.07812683384844099,2021-11-30 13:04:12 UTC
801747,mainnet,253,109296000,109424025,128026,118024,10002,0.078124755908956,2021-11-30 13:06:27 UTC
801749,mainnet,253,109296000,109424252,128253,118220,10033,0.0782281895940056,2021-11-30 13:09:02 UTC
801750,mainnet,253,109296000,109424493,128494,118430,10064,0.07832272323999565,2021-11-30 13:11:28 UTC
801752,mainnet,253,109296000,109424687,128688,118610,10078,0.07831344025860996,2021-11-30 13:13:34 UTC
801753,mainnet,253,109296000,109424917,128918,118815,10103,0.07836764454924836,2021-11-30 13:15:45 UTC
801755,mainnet,253,109296000,109425164,129165,119045,10120,0.07834939805674912,2021-11-30 13:18:03 UTC
801756,mainnet,253,109296000,109425553,129554,119419,10135,0.0782299272890069,2021-11-30 13:21:40 UTC
801758,mainnet,253,109296000,109425762,129763,119610,10153,0.0782426423556792,2021-11-30 13:23:56 UTC
801759,mainnet,253,109296000,109425945,129946,119767,10179,0.07833253813122373,2021-11-30 13:26:16 UTC
801761,mainnet,253,109296000,109426251,130252,120040,10212,0.07840186714983263,2021-11-30 13:28:30 UTC
801762,mainnet,253,109296000,109426487,130488,120262,10226,0.07836735945067745,2021-11-30 13:30:44 UTC
801763,mainnet,253,109296000,109426616,130617,120383,10234,0.07835121002625998,2021-11-30 13:32:59 UTC
801765,mainnet,253,109296000,109426970,130971,120687,10284,0.07852119934947431,2021-11-30 13:35:26 UTC
801766,mainnet,253,109296000,109427200,131201,120886,10315,0.0786198275927775,2021-11-30 13:37:34 UTC
801768,mainnet,253,109296000,109427414,131415,121088,10327,0.07858311456074268,2021-11-30 13:39:42 UTC
801769,mainnet,253,109296000,109427601,131602,121259,10343,0.07859303050105622,2021-11-30 13:41:52 UTC
801771,mainnet,253,109296000,109427856,131857,121500,10357,0.07854721402731747,2021-11-30 13:44:01 UTC
801773,mainnet,253,109296000,109428087,132088,121710,10378,0.07856883289927927,2021-11-30 13:46:18 UTC
801774,mainnet,253,109296000,109428282,132283,121868,10415,0.07873271697799415,2021-11-30 13:48:19 UTC
801776,mainnet,253,109296000,109428523,132524,122092,10432,0.07871781715010111,2021-11-30 13:50:40 UTC
801777,mainnet,253,109296000,109428731,132732,122288,10444,0.07868486875809903,2021-11-30 13:52:46 UTC
801779,mainnet,253,109296000,109428965,132966,122495,10471,0.07874945474783027,2021-11-30 13:54:54 UTC
801780,mainnet,253,109296000,109429166,133167,122676,10491,0.07878077902182973,2021-11-30 13:57:00 UTC
801782,mainnet,253,109296000,109429432,133433,122934,10499,0.07868368394625018,2021-11-30 13:59:31 UTC
801783,mainnet,253,109296000,109429663,133664,123150,10514,0.07865992338999282,2021-11-30 14:01:49 UTC
801785,mainnet,253,109296000,109429891,133892,123359,10533,0.07866788157619574,2021-11-30 14:03:58 UTC
801786,mainnet,253,109296000,109430081,134082,123520,10562,0.07877269133813636,2021-11-30 14:06:17 UTC
801788,mainnet,253,109296000,109430320,134321,123731,10590,0.07884098540064473,2021-11-30 14:08:30 UTC
801789,mainnet,253,109296000,109430506,134507,123898,10609,0.07887321849420477,2021-11-30 14:10:42 UTC
801791,mainnet,253,109296000,109430761,134762,124135,10627,0.07885754144343361,2021-11-30 14:12:52 UTC
801792,mainnet,253,109296000,109430987,134988,124347,10641,0.07882922926482354,2021-11-30 14:15:08 UTC
801794,mainnet,253,109296000,109431226,135227,124556,10671,0.07891175578841504,2021-11-30 14:17:33 UTC
801795,mainnet,253,109296000,109431446,135447,124765,10682,0.07886479582419692,2021-11-30 14:19:43 UTC
801797,mainnet,253,109296000,109431682,135683,124988,10695,0.07882343403374041,2021-11-30 14:21:59 UTC
801798,mainnet,253,109296000,109431904,135905,125186,10719,0.0788712703726868,2021-11-30 14:24:05 UTC
801800,mainnet,253,109296000,109432124,136125,125383,10742,0.0789127640036731,2021-11-30 14:26:18 UTC
801801,mainnet,253,109296000,109432335,136336,125576,10760,0.07892266165942964,2021-11-30 14:28:32 UTC
801803,mainnet,253,109296000,109432581,136582,125782,10800,0.07907337716536586,2021-11-30 14:30:45 UTC
801804,mainnet,253,109296000,109432789,136790,125969,10821,0.07910665984355582,2021-11-30 14:32:55 UTC
801806,mainnet,253,109296000,109433007,137008,126152,10856,0.07923624897816185,2021-11-30 14:35:15 UTC
801807,mainnet,253,109296000,109433237,137238,126343,10895,0.07938763316282663,2021-11-30 14:37:29 UTC
801809,mainnet,253,109296000,109433458,137459,126540,10919,0.07943459504288551,2021-11-30 14:39:56 UTC
801810,mainnet,253,109296000,109433677,137678,126746,10932,0.07940266418745189,2021-11-30 14:42:03 UTC
801812,mainnet,253,109296000,109433867,137868,126925,10943,0.07937302347172658,2021-11-30 14:44:07 UTC
801813,mainnet,253,109296000,109434077,138078,127097,10981,0.0795275134344356,2021-11-30 14:46:33 UTC
801815,mainnet,253,109296000,109434322,138323,127315,11008,0.0795818482826428,2021-11-30 14:48:50 UTC
801816,mainnet,253,109296000,109434549,138550,127530,11020,0.0795380728978708,2021-11-30 14:51:01 UTC
801818,mainnet,253,109296000,109434775,138776,127746,11030,0.07948060183317,2021-11-30 14:53:16 UTC
801819,mainnet,253,109296000,109434994,138995,127948,11047,0.07947767905320335,2021-11-30 14:55:26 UTC
801821,mainnet,253,109296000,109435206,139207,128148,11059,0.0794428441098508,2021-11-30 14:57:40 UTC
801822,mainnet,253,109296000,109435420,139421,128344,11077,0.07945001111740699,2021-11-30 14:59:54 UTC
801823,mainnet,253,109296000,109435659,139660,128543,11117,0.07960045825576399,2021-11-30 15:01:59 UTC
801824,mainnet,253,109296000,109435804,139805,128674,11131,0.0796180394120382,2021-11-30 15:04:13 UTC
801826,mainnet,253,109296000,109436076,140077,128922,11155,0.07963477230380434,2021-11-30 15:06:19 UTC
801827,mainnet,253,109296000,109436285,140286,129100,11186,0.07973710847839413,2021-11-30 15:08:24 UTC
801829,mainnet,253,109296000,109436464,140465,129267,11198,0.07972092692129712,2021-11-30 15:10:26 UTC
801830,mainnet,253,109296000,109436661,140662,129440,11222,0.07977989791130512,2021-11-30 15:12:33 UTC
801832,mainnet,253,109296000,109436846,140847,129596,11251,0.07988100563022286,2021-11-30 15:14:38 UTC
801833,mainnet,253,109296000,109437049,141050,129757,11293,0.08006380716058135,2021-11-30 15:16:41 UTC
801835,mainnet,253,109296000,109437247,141248,129935,11313,0.08009316946080652,2021-11-30 15:18:51 UTC
801836,mainnet,253,109296000,109437375,141376,130036,11340,0.0802116342236306,2021-11-30 15:20:54 UTC
801837,mainnet,253,109296000,109437669,141670,130288,11382,0.08034163902025834,2021-11-30 15:22:57 UTC
801838,mainnet,253,109296000,109437865,141866,130460,11406,0.08039981390889994,2021-11-30 15:25:05 UTC
801840,mainnet,253,109296000,109438079,142080,130662,11418,0.08036317567567568,2021-11-30 15:27:19 UTC
801841,mainnet,253,109296000,109438300,142301,130859,11442,0.08040702454655976,2021-11-30 15:29:35 UTC
801843,mainnet,253,109296000,109438507,142508,131055,11453,0.0803674179695175,2021-11-30 15:31:51 UTC
801844,mainnet,253,109296000,109438734,142735,131263,11472,0.08037271867446667,2021-11-30 15:34:20 UTC
801846,mainnet,253,109296000,109439005,143006,131502,11504,0.08044417716739158,2021-11-30 15:36:51 UTC
801847,mainnet,253,109296000,109439237,143238,131697,11541,0.08057219452938466,2021-11-30 15:39:04 UTC
801849,mainnet,253,109296000,109439437,143438,131874,11564,0.08062019827381865,2021-11-30 15:41:08 UTC
801850,mainnet,253,109296000,109439644,143645,132056,11589,0.08067806049636256,2021-11-30 15:43:17 UTC
801851,mainnet,253,109296000,109439878,143879,132270,11609,0.0806858540857248,2021-11-30 15:45:38 UTC
801852,mainnet,253,109296000,109440084,144085,132457,11628,0.08070236318839574,2021-11-30 15:47:55 UTC
801854,mainnet,253,109296000,109440313,144314,132646,11668,0.08085147664121291,2021-11-30 15:50:02 UTC
801855,mainnet,253,109296000,109440525,144526,132806,11720,0.08109267536637006,2021-11-30 15:52:15 UTC
801857,mainnet,253,109296000,109440740,144741,133010,11731,0.08104821716030704,2021-11-30 15:54:32 UTC
801858,mainnet,253,109296000,109440924,144925,133176,11749,0.08106951871657754,2021-11-30 15:56:38 UTC
801859,mainnet,253,109296000,109441125,145126,133350,11776,0.08114328238909638,2021-11-30 15:58:43 UTC
801861,mainnet,253,109296000,109441312,145313,133521,11792,0.08114896808957217,2021-11-30 16:00:51 UTC
801862,mainnet,253,109296000,109441506,145507,133678,11829,0.08129505796971967,2021-11-30 16:02:59 UTC
801863,mainnet,253,109296000,109441710,145711,133844,11867,0.08144203251641949,2021-11-30 16:05:11 UTC
801865,mainnet,253,109296000,109441902,145903,134009,11894,0.08151991391540955,2021-11-30 16:07:20 UTC
801866,mainnet,253,109296000,109442081,146082,134153,11929,0.08165961583220382,2021-11-30 16:09:26 UTC
801867,mainnet,253,109296000,109442329,146330,134356,11974,0.0818287432515547,2021-11-30 16:12:08 UTC
801869,mainnet,253,109296000,109442522,146523,134514,12009,0.08195982883233349,2021-11-30 16:14:24 UTC
801870,mainnet,253,109296000,109442705,146706,134674,12032,0.08201436887380202,2021-11-30 16:16:32 UTC
801872,mainnet,253,109296000,109442887,146888,134832,12056,0.08207613964381025,2021-11-30 16:18:39 UTC
801873,mainnet,253,109296000,109443058,147059,134992,12067,0.08205550153339816,2021-11-30 16:20:46 UTC
801875,mainnet,253,109296000,109443256,147257,135162,12095,0.08213531445024684,2021-11-30 16:22:53 UTC
801876,mainnet,253,109296000,109443451,147452,135320,12132,0.08227762254835472,2021-11-30 16:25:02 UTC
801878,mainnet,253,109296000,109443693,147694,135535,12159,0.0823256191856135,2021-11-30 16:27:32 UTC
801879,mainnet,253,109296000,109443888,147889,135708,12181,0.08236582842537309,2021-11-30 16:29:40 UTC
801881,mainnet,253,109296000,109444095,148096,135879,12217,0.08249378781331028,2021-11-30 16:31:47 UTC
801882,mainnet,253,109296000,109444291,148292,136048,12244,0.08256682761039032,2021-11-30 16:33:54 UTC
801884,mainnet,253,109296000,109444502,148503,136207,12296,0.0827996740806583,2021-11-30 16:36:04 UTC
801885,mainnet,253,109296000,109444711,148712,136369,12343,0.0829993544569369,2021-11-30 16:38:18 UTC
801887,mainnet,253,109296000,109444886,148887,136534,12353,0.08296896303908333,2021-11-30 16:40:23 UTC
801888,mainnet,253,109296000,109445123,149124,136732,12392,0.08309862932861244,2021-11-30 16:42:57 UTC
801890,mainnet,253,109296000,109445336,149337,136908,12429,0.08322786717290424,2021-11-30 16:45:20 UTC
801891,mainnet,253,109296000,109445521,149522,137074,12448,0.08325196292184428,2021-11-30 16:47:26 UTC
801893,mainnet,253,109296000,109445724,149725,137258,12467,0.08326598764401402,2021-11-30 16:50:12 UTC
801894,mainnet,253,109296000,109445990,149991,137476,12515,0.08343833963371136,2021-11-30 16:52:32 UTC
801896,mainnet,253,109296000,109446230,150231,137679,12552,0.08355133095033648,2021-11-30 16:55:18 UTC
801898,mainnet,253,109296000,109446456,150457,137875,12582,0.08362522182417567,2021-11-30 16:57:33 UTC
801899,mainnet,253,109296000,109446652,150653,138044,12609,0.0836956449589454,2021-11-30 16:59:40 UTC
801900,mainnet,253,109296000,109446871,150872,138234,12638,0.08376637149371653,2021-11-30 17:01:55 UTC
801901,mainnet,253,109296000,109447099,151100,138438,12662,0.08379880873593647,2021-11-30 17:04:06 UTC
801902,mainnet,253,109296000,109447293,151294,138607,12687,0.08385659708911126,2021-11-30 17:06:20 UTC
801904,mainnet,253,109296000,109447504,151505,138785,12720,0.08395762516088578,2021-11-30 17:08:29 UTC
801905,mainnet,253,109296000,109447713,151714,138966,12748,0.08402652359043991,2021-11-30 17:10:40 UTC
801907,mainnet,253,109296000,109447914,151915,139150,12765,0.08402725208175625,2021-11-30 17:12:45 UTC
801908,mainnet,253,109296000,109448075,152076,139292,12784,0.08406323154212368,2021-11-30 17:14:57 UTC
801910,mainnet,253,109296000,109448380,152381,139550,12831,0.084203411186434,2021-11-30 17:16:58 UTC
801911,mainnet,253,109296000,109448540,152541,139687,12854,0.08426586950393665,2021-11-30 17:19:06 UTC
801912,mainnet,253,109296000,109448816,152817,139943,12874,0.08424455394360575,2021-11-30 17:21:18 UTC
801913,mainnet,253,109296000,109449034,153035,140148,12887,0.08420949456006796,2021-11-30 17:23:28 UTC
801915,mainnet,253,109296000,109449271,153272,140358,12914,0.08425544130695757,2021-11-30 17:25:41 UTC
801916,mainnet,253,109296000,109449511,153512,140583,12929,0.08422142894366565,2021-11-30 17:28:08 UTC
801918,mainnet,253,109296000,109449720,153721,140781,12940,0.08417847919282336,2021-11-30 17:30:17 UTC
801919,mainnet,253,109296000,109449933,153934,140981,12953,0.08414645237569347,2021-11-30 17:32:24 UTC
801921,mainnet,253,109296000,109450156,154157,141179,12978,0.08418690036780685,2021-11-30 17:34:45 UTC
801922,mainnet,253,109296000,109450400,154401,141408,12993,0.08415100938465424,2021-11-30 17:37:09 UTC
801924,mainnet,253,109296000,109450628,154629,141609,13020,0.08420154046136236,2021-11-30 17:39:35 UTC
801925,mainnet,253,109296000,109450868,154869,141828,13041,0.08420665207368809,2021-11-30 17:41:49 UTC
801927,mainnet,253,109296000,109451090,155091,142035,13056,0.0841828345938836,2021-11-30 17:44:03 UTC
801929,mainnet,253,109296000,109451409,155410,142326,13084,0.08419020655041504,2021-11-30 17:47:00 UTC
801930,mainnet,253,109296000,109451663,155664,142545,13119,0.0842776749922911,2021-11-30 17:49:32 UTC
801931,mainnet,253,109296000,109451894,155895,142758,13137,0.08426825748099682,2021-11-30 17:51:50 UTC
801933,mainnet,253,109296000,109452111,156112,142966,13146,0.08420877318848007,2021-11-30 17:54:01 UTC
801934,mainnet,253,109296000,109452359,156360,143198,13162,0.08417753901253518,2021-11-30 17:56:16 UTC
801936,mainnet,253,109296000,109452626,156627,143454,13173,0.08410427320959987,2021-11-30 17:58:50 UTC
801937,mainnet,253,109296000,109452873,156874,143686,13188,0.08406746815915958,2021-11-30 18:01:10 UTC
801939,mainnet,253,109296000,109453108,157109,143912,13197,0.08399900705879358,2021-11-30 18:03:28 UTC
801940,mainnet,253,109296000,109453350,157351,144143,13208,0.08393972710691384,2021-11-30 18:05:43 UTC
801942,mainnet,253,109296000,109453563,157564,144336,13228,0.08395318727628139,2021-11-30 18:07:51 UTC
801943,mainnet,253,109296000,109453860,157861,144611,13250,0.08393460069301474,2021-11-30 18:10:28 UTC
801944,mainnet,253,109296000,109454113,158114,144863,13251,0.08380662053961066,2021-11-30 18:12:46 UTC
801945,mainnet,253,109296000,109454365,158366,145110,13256,0.08370483563391132,2021-11-30 18:15:03 UTC
801947,mainnet,253,109296000,109454619,158620,145338,13282,0.0837347118900517,2021-11-30 18:17:22 UTC
801948,mainnet,253,109296000,109454883,158884,145588,13296,0.08368369376400393,2021-11-30 18:19:46 UTC
801950,mainnet,253,109296000,109455130,159131,145811,13320,0.08370462072129252,2021-11-30 18:21:57 UTC
801951,mainnet,253,109296000,109455388,159389,146058,13331,0.08363814315918916,2021-11-30 18:24:23 UTC
801952,mainnet,253,109296000,109455657,159658,146315,13343,0.0835723859750216,2021-11-30 18:26:52 UTC
801954,mainnet,253,109296000,109455911,159912,146556,13356,0.0835209365150833,2021-11-30 18:29:13 UTC
801956,mainnet,253,109296000,109456187,160188,146818,13370,0.0834644292955777,2021-11-30 18:31:52 UTC
801957,mainnet,253,109296000,109456429,160430,147033,13397,0.08350682540671944,2021-11-30 18:33:59 UTC
801959,mainnet,253,109296000,109456715,160716,147299,13417,0.08348266507379477,2021-11-30 18:36:32 UTC
801960,mainnet,253,109296000,109456956,160957,147513,13444,0.08352541361978665,2021-11-30 18:38:54 UTC
801962,mainnet,253,109296000,109457197,161198,147753,13445,0.08340674201913176,2021-11-30 18:41:03 UTC
801963,mainnet,253,109296000,109457429,161430,147969,13461,0.08338598773462182,2021-11-30 18:43:22 UTC
801965,mainnet,253,109296000,109457695,161696,148215,13481,0.08337250148426677,2021-11-30 18:45:41 UTC
801966,mainnet,253,109296000,109457908,161909,148395,13514,0.08346663866739959,2021-11-30 18:47:53 UTC
801968,mainnet,253,109296000,109458164,162165,148638,13527,0.08341504023679586,2021-11-30 18:50:14 UTC
801969,mainnet,253,109296000,109458398,162399,148848,13551,0.08344263203591155,2021-11-30 18:52:45 UTC
801971,mainnet,253,109296000,109458707,162708,149136,13572,0.08341323106423777,2021-11-30 18:55:25 UTC
801972,mainnet,253,109296000,109458944,162945,149350,13595,0.08343306023504864,2021-11-30 18:57:44 UTC
801974,mainnet,253,109296000,109459213,163214,149572,13642,0.08358351611994069,2021-11-30 19:00:00 UTC
801976,mainnet,253,109296000,109459447,163448,149749,13699,0.0838125887132299,2021-11-30 19:02:27 UTC
801977,mainnet,253,109296000,109459667,163668,149935,13733,0.08390766673998583,2021-11-30 19:04:51 UTC
801979,mainnet,253,109296000,109459902,163903,150147,13756,0.08392768893796941,2021-11-30 19:07:10 UTC
801980,mainnet,253,109296000,109460142,164143,150362,13781,0.08395728115119135,2021-11-30 19:09:31 UTC
801982,mainnet,253,109296000,109460352,164353,150559,13794,0.08392910381921839,2021-11-30 19:11:43 UTC
801983,mainnet,253,109296000,109460603,164604,150783,13821,0.08396515273018881,2021-11-30 19:13:58 UTC
801984,mainnet,253,109296000,109460833,164834,150999,13835,0.08393292645934698,2021-11-30 19:16:04 UTC
801986,mainnet,253,109296000,109461077,165078,151219,13859,0.08395425192939096,2021-11-30 19:18:15 UTC
801987,mainnet,253,109296000,109461277,165278,151396,13882,0.0839918198429313,2021-11-30 19:20:23 UTC
801988,mainnet,253,109296000,109461541,165542,151643,13899,0.08396056589868432,2021-11-30 19:22:43 UTC
801989,mainnet,253,109296000,109461750,165751,151844,13907,0.08390296287805202,2021-11-30 19:24:56 UTC
801991,mainnet,253,109296000,109461990,165991,152042,13949,0.08403467657885066,2021-11-30 19:27:03 UTC
801992,mainnet,253,109296000,109462212,166213,152249,13964,0.08401268252182441,2021-11-30 19:29:13 UTC
801994,mainnet,253,109296000,109462438,166439,152461,13978,0.08398272039606101,2021-11-30 19:31:33 UTC
801995,mainnet,253,109296000,109462678,166679,152674,14005,0.08402378224011423,2021-11-30 19:33:55 UTC
801997,mainnet,253,109296000,109462928,166929,152912,14017,0.08396983148524223,2021-11-30 19:36:21 UTC
801999,mainnet,253,109296000,109463171,167172,153140,14032,0.08393750149546575,2021-11-30 19:38:49 UTC
802000,mainnet,253,109296000,109463423,167424,153376,14048,0.08390672782874618,2021-11-30 19:41:16 UTC
802001,mainnet,253,109296000,109463702,167703,153643,14060,0.08383869101924235,2021-11-30 19:43:45 UTC
802002,mainnet,253,109296000,109463900,167901,153823,14078,0.08384702890393744,2021-11-30 19:46:00 UTC
802004,mainnet,253,109296000,109464159,168160,154050,14110,0.0839081826831589,2021-11-30 19:48:22 UTC
802005,mainnet,253,109296000,109464453,168454,154301,14153,0.08401700167404752,2021-11-30 19:51:13 UTC
802007,mainnet,253,109296000,109464715,168716,154541,14175,0.08401692785509376,2021-11-30 19:53:50 UTC
802008,mainnet,253,109296000,109464989,168990,154804,14186,0.08394579560920765,2021-11-30 19:56:23 UTC
802009,mainnet,253,109296000,109465197,169198,154993,14205,0.0839548930838426,2021-11-30 19:58:42 UTC
802011,mainnet,253,109296000,109465477,169478,155230,14248,0.08406990877872055,2021-11-30 20:01:22 UTC
802012,mainnet,253,109296000,109465715,169716,155447,14269,0.08407575007659855,2021-11-30 20:03:51 UTC
802014,mainnet,253,109296000,109465969,169970,155686,14284,0.08403835971053715,2021-11-30 20:06:21 UTC
802016,mainnet,253,109296000,109466255,170256,155936,14320,0.08410863640635279,2021-11-30 20:09:01 UTC
802017,mainnet,253,109296000,109466490,170491,156152,14339,0.08410414625991988,2021-11-30 20:11:39 UTC
802019,mainnet,253,109296000,109466743,170744,156374,14370,0.0841610832591482,2021-11-30 20:14:02 UTC
802020,mainnet,253,109296000,109466981,170982,156592,14390,0.08416090582634429,2021-11-30 20:16:27 UTC
802022,mainnet,253,109296000,109467240,171241,156809,14432,0.08427888180984694,2021-11-30 20:19:02 UTC
802023,mainnet,253,109296000,109467486,171487,157024,14463,0.08433875454116055,2021-11-30 20:21:26 UTC
802025,mainnet,253,109296000,109467748,171749,157268,14481,0.08431490139680581,2021-11-30 20:23:52 UTC
802026,mainnet,253,109296000,109468005,172006,157510,14496,0.08427612990244526,2021-11-30 20:26:20 UTC
802028,mainnet,253,109296000,109468233,172234,157726,14508,0.08423423946491401,2021-11-30 20:28:31 UTC
802029,mainnet,253,109296000,109468481,172482,157965,14517,0.08416530420565624,2021-11-30 20:30:50 UTC
802031,mainnet,253,109296000,109468739,172740,158207,14533,0.08413222183628574,2021-11-30 20:33:11 UTC
802032,mainnet,253,109296000,109468964,172965,158406,14559,0.08417309860376376,2021-11-30 20:35:26 UTC
802033,mainnet,253,109296000,109469203,173204,158634,14570,0.0841204591117988,2021-11-30 20:37:37 UTC
802035,mainnet,253,109296000,109469412,173413,158842,14571,0.08402484242819165,2021-11-30 20:39:50 UTC
802036,mainnet,253,109296000,109469672,173673,159074,14599,0.08406027419345552,2021-11-30 20:42:03 UTC
802038,mainnet,253,109296000,109469901,173902,159283,14619,0.08406458810134443,2021-11-30 20:44:11 UTC
802039,mainnet,253,109296000,109470119,174120,159484,14636,0.08405697220307834,2021-11-30 20:46:18 UTC
802041,mainnet,253,109296000,109470326,174327,159681,14646,0.08401452442822971,2021-11-30 20:48:23 UTC
802042,mainnet,253,109296000,109470546,174547,159886,14661,0.08399456879808877,2021-11-30 20:50:25 UTC
802043,mainnet,253,109296000,109470777,174778,160106,14672,0.08394649212143404,2021-11-30 20:52:38 UTC
802045,mainnet,253,109296000,109470991,174992,160309,14683,0.08390669287738868,2021-11-30 20:54:40 UTC
802046,mainnet,253,109296000,109471353,175354,160631,14723,0.08396158627690273,2021-11-30 20:58:11 UTC
802047,mainnet,253,109296000,109471590,175591,160843,14748,0.08399063733334852,2021-11-30 21:00:26 UTC
802049,mainnet,253,109296000,109471808,175809,161041,14768,0.08400025027160157,2021-11-30 21:02:40 UTC
802050,mainnet,253,109296000,109472028,176029,161247,14782,0.08397479960688296,2021-11-30 21:04:54 UTC
802052,mainnet,253,109296000,109472260,176261,161460,14801,0.08397206415486126,2021-11-30 21:07:00 UTC
802053,mainnet,253,109296000,109472499,176500,161684,14816,0.08394334277620397,2021-11-30 21:09:12 UTC
802055,mainnet,253,109296000,109472680,176681,161847,14834,0.08395922594959276,2021-11-30 21:11:25 UTC
802056,mainnet,253,109296000,109472983,176984,162116,14868,0.08400759390679384,2021-11-30 21:13:42 UTC
802058,mainnet,253,109296000,109473203,177204,162324,14880,0.08397101645561049,2021-11-30 21:15:49 UTC
802059,mainnet,253,109296000,109473421,177422,162527,14895,0.08395238470990068,2021-11-30 21:18:02 UTC
802061,mainnet,253,109296000,109473649,177650,162751,14899,0.08386715451730932,2021-11-30 21:20:15 UTC
802062,mainnet,253,109296000,109473925,177926,163015,14911,0.08380450299562739,2021-11-30 21:22:39 UTC
802064,mainnet,253,109296000,109474175,178176,163260,14916,0.08371497844827586,2021-11-30 21:25:01 UTC
802065,mainnet,253,109296000,109474426,178427,163479,14948,0.08377655848049903,2021-11-30 21:27:22 UTC
802067,mainnet,253,109296000,109474664,178665,163705,14960,0.08373212436683178,2021-11-30 21:29:31 UTC
802068,mainnet,253,109296000,109474892,178893,163919,14974,0.08370366643747938,2021-11-30 21:31:42 UTC
802070,mainnet,253,109296000,109475132,179133,164151,14982,0.08363618093818559,2021-11-30 21:33:56 UTC
802072,mainnet,253,109296000,109475414,179415,164420,14995,0.0835771813950896,2021-11-30 21:36:29 UTC
802073,mainnet,253,109296000,109475658,179659,164632,15027,0.0836417880540357,2021-11-30 21:38:47 UTC
802075,mainnet,253,109296000,109475886,179887,164848,15039,0.08360248378148505,2021-11-30 21:41:11 UTC
802076,mainnet,253,109296000,109476130,180131,165067,15064,0.08362802626977034,2021-11-30 21:43:30 UTC
802078,mainnet,253,109296000,109476377,180378,165306,15072,0.08355786182350397,2021-11-30 21:45:50 UTC
802079,mainnet,253,109296000,109476633,180634,165552,15082,0.08349480164310152,2021-11-30 21:48:12 UTC
802081,mainnet,253,109296000,109476874,180875,165767,15108,0.08352729785763649,2021-11-30 21:50:28 UTC
802082,mainnet,253,109296000,109477172,181173,166048,15125,0.08348374205869528,2021-11-30 21:53:20 UTC
802084,mainnet,253,109296000,109477422,181423,166292,15131,0.08340177375525705,2021-11-30 21:55:32 UTC
802085,mainnet,253,109296000,109477673,181674,166531,15143,0.08335259861069828,2021-11-30 21:57:54 UTC
802087,mainnet,253,109296000,109477904,181905,166754,15151,0.08329072867705671,2021-11-30 22:00:21 UTC
802088,mainnet,253,109296000,109478105,182106,166933,15173,0.08331960506518182,2021-11-30 22:02:47 UTC
802090,mainnet,253,109296000,109478303,182304,167108,15196,0.08335527470598561,2021-11-30 22:05:00 UTC
802091,mainnet,253,109296000,109478468,182469,167245,15224,0.08343335032252054,2021-11-30 22:07:03 UTC
802093,mainnet,253,109296000,109478643,182644,167395,15249,0.08349028711591949,2021-11-30 22:09:10 UTC
802094,mainnet,253,109296000,109478820,182821,167555,15266,0.08350244227960683,2021-11-30 22:11:26 UTC
802095,mainnet,253,109296000,109479022,183023,167728,15295,0.08356873179873568,2021-11-30 22:13:50 UTC
802097,mainnet,253,109296000,109479245,183246,167929,15317,0.08358709057769337,2021-11-30 22:16:22 UTC
802098,mainnet,253,109296000,109479432,183433,168104,15329,0.08356729705123941,2021-11-30 22:18:26 UTC
802099,mainnet,253,109296000,109479660,183661,168317,15344,0.0835452273482122,2021-11-30 22:20:35 UTC
802101,mainnet,253,109296000,109479885,183886,168536,15350,0.083475631641343,2021-11-30 22:22:40 UTC
802102,mainnet,253,109296000,109480135,184136,168777,15359,0.08341117434939392,2021-11-30 22:24:57 UTC
802104,mainnet,253,109296000,109480405,184406,169034,15372,0.0833595436157175,2021-11-30 22:27:18 UTC
802106,mainnet,253,109296000,109480703,184704,169325,15379,0.08326295045045046,2021-11-30 22:29:56 UTC
802107,mainnet,253,109296000,109480994,184995,169614,15381,0.08314278764290926,2021-11-30 22:32:24 UTC
802109,mainnet,253,109296000,109481250,185251,169861,15390,0.08307647462091973,2021-11-30 22:34:51 UTC
802110,mainnet,253,109296000,109481538,185539,170122,15417,0.08309304243312726,2021-11-30 22:37:20 UTC
802111,mainnet,253,109296000,109481811,185812,170384,15428,0.08303015951607001,2021-11-30 22:39:56 UTC
802113,mainnet,253,109296000,109482096,186097,170660,15437,0.08295136407357454,2021-11-30 22:42:24 UTC
802114,mainnet,253,109296000,109482331,186332,170882,15450,0.0829165146083335,2021-11-30 22:44:34 UTC
802116,mainnet,253,109296000,109482559,186560,171082,15478,0.08296526586620927,2021-11-30 22:46:50 UTC
802117,mainnet,253,109296000,109482790,186791,171296,15495,0.08295367549828418,2021-11-30 22:49:10 UTC
802119,mainnet,253,109296000,109483064,187065,171556,15509,0.08290701093202897,2021-11-30 22:51:38 UTC
802121,mainnet,253,109296000,109483335,187336,171799,15537,0.08293654182858606,2021-11-30 22:54:28 UTC
802122,mainnet,253,109296000,109483583,187584,172039,15545,0.08286954111224838,2021-11-30 22:56:31 UTC
802124,mainnet,253,109296000,109483838,187839,172269,15570,0.08289013463657707,2021-11-30 22:58:42 UTC
802125,mainnet,253,109296000,109484072,188073,172503,15570,0.0827870029190793,2021-11-30 23:00:59 UTC
802127,mainnet,253,109296000,109484310,188311,172728,15583,0.08275140591893199,2021-11-30 23:03:13 UTC
802128,mainnet,253,109296000,109484536,188537,172940,15597,0.08272646748383607,2021-11-30 23:05:17 UTC
802130,mainnet,253,109296000,109484760,188761,173143,15618,0.08273954895343848,2021-11-30 23:07:28 UTC
802131,mainnet,253,109296000,109484996,188997,173352,15645,0.08277909173161478,2021-11-30 23:09:31 UTC
802133,mainnet,253,109296000,109485234,189235,173583,15652,0.08271197188680741,2021-11-30 23:11:47 UTC
802134,mainnet,253,109296000,109485463,189464,173793,15671,0.08271228307224592,2021-11-30 23:14:12 UTC
802136,mainnet,253,109296000,109485731,189732,174048,15684,0.08266396812345835,2021-11-30 23:16:44 UTC
802137,mainnet,253,109296000,109485987,189988,174271,15717,0.08272627744910205,2021-11-30 23:18:49 UTC
802139,mainnet,253,109296000,109486232,190233,174493,15740,0.08274063911098495,2021-11-30 23:21:02 UTC
802140,mainnet,253,109296000,109486465,190466,174710,15756,0.08272342570327512,2021-11-30 23:23:17 UTC
802142,mainnet,253,109296000,109486731,190732,174960,15772,0.0826919447182434,2021-11-30 23:25:34 UTC
802143,mainnet,253,109296000,109486954,190955,175159,15796,0.08272105993558691,2021-11-30 23:27:41 UTC
802145,mainnet,253,109296000,109487204,191205,175402,15803,0.08264951230354854,2021-11-30 23:29:56 UTC
802146,mainnet,253,109296000,109487481,191482,175674,15808,0.08255606271085533,2021-11-30 23:32:30 UTC
802148,mainnet,253,109296000,109487723,191724,175906,15818,0.0825040161899397,2021-11-30 23:35:00 UTC
802149,mainnet,253,109296000,109487993,191994,176136,15858,0.08259633113534798,2021-11-30 23:37:17 UTC
802151,mainnet,253,109296000,109488244,192245,176360,15885,0.08262893703347292,2021-11-30 23:40:06 UTC
802152,mainnet,253,109296000,109488508,192509,176597,15912,0.08265587582918202,2021-11-30 23:42:16 UTC
802154,mainnet,253,109296000,109488698,192699,176774,15925,0.0826418403831883,2021-11-30 23:44:26 UTC
802155,mainnet,253,109296000,109488949,192950,176991,15959,0.0827105467737756,2021-11-30 23:46:35 UTC
802156,mainnet,253,109296000,109489180,193181,177208,15973,0.0826841148974278,2021-11-30 23:48:46 UTC
802158,mainnet,253,109296000,109489411,193412,177431,15981,0.08262672429838894,2021-11-30 23:50:51 UTC
802159,mainnet,253,109296000,109489670,193671,177680,15991,0.08256785992740266,2021-11-30 23:53:08 UTC
802161,mainnet,253,109296000,109490142,194143,178114,16029,0.08256285315463344,2021-11-30 23:57:38 UTC
802162,mainnet,253,109296000,109490364,194365,178330,16035,0.08249942119208706,2021-11-30 23:59:51 UTC
802163,mainnet,253,109296000,109490654,194655,178589,16066,0.08253576841077805,2021-12-01 00:02:41 UTC
802165,mainnet,253,109296000,109490908,194909,178827,16082,0.08251029967831142,2021-12-01 00:05:17 UTC
802166,mainnet,253,109296000,109491142,195143,179042,16101,0.08250872437135844,2021-12-01 00:07:41 UTC
802168,mainnet,253,109296000,109491382,195383,179240,16143,0.08262233664136594,2021-12-01 00:10:03 UTC
802169,mainnet,253,109296000,109491618,195619,179447,16172,0.08267090620031796,2021-12-01 00:12:37 UTC
802171,mainnet,253,109296000,109491874,195875,179674,16201,0.08271091257179324,2021-12-01 00:14:54 UTC
802172,mainnet,253,109296000,109492121,196122,179900,16222,0.08271382098897626,2021-12-01 00:17:16 UTC
802174,mainnet,253,109296000,109492375,196376,180121,16255,0.08277488084083595,2021-12-01 00:19:40 UTC
802176,mainnet,253,109296000,109492618,196619,180330,16289,0.08284550323213931,2021-12-01 00:21:58 UTC
802177,mainnet,253,109296000,109492860,196861,180557,16304,0.08281985766606895,2021-12-01 00:24:32 UTC
802179,mainnet,253,109296000,109493118,197119,180809,16310,0.08274189702666918,2021-12-01 00:27:07 UTC
802180,mainnet,253,109296000,109493371,197372,181048,16324,0.08270676691729323,2021-12-01 00:29:30 UTC
802182,mainnet,253,109296000,109493586,197587,181237,16350,0.08274835895074069,2021-12-01 00:31:39 UTC
802183,mainnet,253,109296000,109493804,197805,181439,16366,0.0827380500998458,2021-12-01 00:33:52 UTC
802184,mainnet,253,109296000,109494019,198020,181638,16382,0.08272901727098272,2021-12-01 00:36:05 UTC
802185,mainnet,253,109296000,109494243,198244,181843,16401,0.08273138152983192,2021-12-01 00:38:16 UTC
802186,mainnet,253,109296000,109494461,198462,182042,16420,0.08273624169866271,2021-12-01 00:40:28 UTC
802188,mainnet,253,109296000,109494702,198703,182269,16434,0.08270635068418696,2021-12-01 00:42:39 UTC
802189,mainnet,253,109296000,109494948,198949,182502,16447,0.08266942784331663,2021-12-01 00:45:03 UTC
802191,mainnet,253,109296000,109495186,199187,182725,16462,0.08264595581036915,2021-12-01 00:47:15 UTC
802192,mainnet,253,109296000,109495426,199427,182949,16478,0.08262672556875449,2021-12-01 00:49:31 UTC
802194,mainnet,253,109296000,109495679,199680,183177,16503,0.08264723557692308,2021-12-01 00:51:47 UTC
802195,mainnet,253,109296000,109495929,199930,183414,16516,0.08260891311959186,2021-12-01 00:53:59 UTC
802197,mainnet,253,109296000,109496168,200169,183633,16536,0.08261019438574405,2021-12-01 00:56:12 UTC
802198,mainnet,253,109296000,109496400,200401,183859,16542,0.0825444982809467,2021-12-01 00:58:26 UTC
802199,mainnet,253,109296000,109496674,200675,184123,16552,0.08248162451725427,2021-12-01 01:00:50 UTC
802201,mainnet,253,109296000,109496911,200912,184349,16563,0.08243907780520825,2021-12-01 01:03:28 UTC
802202,mainnet,253,109296000,109497168,201169,184577,16592,0.08247791657760391,2021-12-01 01:05:43 UTC
802204,mainnet,253,109296000,109497480,201481,184855,16626,0.08251894719601352,2021-12-01 01:08:34 UTC
802205,mainnet,253,109296000,109497767,201768,185132,16636,0.08245113199318028,2021-12-01 01:11:14 UTC
802207,mainnet,253,109296000,109498070,202071,185430,16641,0.08235224252861618,2021-12-01 01:13:47 UTC
802208,mainnet,253,109296000,109498302,202303,185647,16656,0.08233194762311978,2021-12-01 01:16:05 UTC
802210,mainnet,253,109296000,109498543,202544,185862,16682,0.08236235089659531,2021-12-01 01:18:19 UTC
802212,mainnet,253,109296000,109498788,202789,186098,16691,0.08230722573709619,2021-12-01 01:20:57 UTC
802213,mainnet,253,109296000,109499101,203102,186393,16709,0.08226900769071697,2021-12-01 01:23:14 UTC
802215,mainnet,253,109296000,109499393,203394,186675,16719,0.08220006489866957,2021-12-01 01:26:05 UTC
802216,mainnet,253,109296000,109499621,203622,186891,16731,0.08216695641924743,2021-12-01 01:28:20 UTC
802218,mainnet,253,109296000,109499876,203877,187135,16742,0.08211813985883645,2021-12-01 01:30:34 UTC
802219,mainnet,253,109296000,109500115,204116,187354,16762,0.08211997099688413,2021-12-01 01:32:45 UTC
802220,mainnet,253,109296000,109500381,204382,187613,16769,0.08204734272098325,2021-12-01 01:35:03 UTC
802222,mainnet,253,109296000,109500625,204626,187855,16771,0.08195928181169548,2021-12-01 01:37:18 UTC
802223,mainnet,253,109296000,109500848,204849,188062,16787,0.08194816669839736,2021-12-01 01:39:26 UTC
802225,mainnet,253,109296000,109501102,205103,188310,16793,0.08187593550557525,2021-12-01 01:41:34 UTC
802226,mainnet,253,109296000,109501345,205346,188536,16810,0.08186183319860138,2021-12-01 01:43:39 UTC
802228,mainnet,253,109296000,109501580,205581,188757,16824,0.08183635647263122,2021-12-01 01:45:49 UTC
802229,mainnet,253,109296000,109501822,205823,188974,16849,0.08186159952969299,2021-12-01 01:47:55 UTC
802230,mainnet,253,109296000,109502092,206093,189232,16861,0.0818125797576822,2021-12-01 01:50:18 UTC
802232,mainnet,253,109296000,109502352,206353,189478,16875,0.08177734270885327,2021-12-01 01:52:44 UTC
802234,mainnet,253,109296000,109502625,206626,189740,16886,0.08172253249833032,2021-12-01 01:55:09 UTC
802235,mainnet,253,109296000,109502878,206879,189972,16907,0.08172409959444893,2021-12-01 01:57:22 UTC
802236,mainnet,253,109296000,109503134,207135,190220,16915,0.08166171820310425,2021-12-01 01:59:33 UTC
802237,mainnet,253,109296000,109503412,207413,190489,16924,0.08159565697424945,2021-12-01 02:01:54 UTC
802239,mainnet,253,109296000,109503679,207680,190749,16931,0.08152446070878275,2021-12-01 02:04:18 UTC
802240,mainnet,253,109296000,109503927,207928,190991,16937,0.08145608095109846,2021-12-01 02:06:46 UTC
802242,mainnet,253,109296000,109504201,208202,191254,16948,0.08140171564154043,2021-12-01 02:09:02 UTC
802243,mainnet,253,109296000,109504423,208424,191471,16953,0.08133900126664875,2021-12-01 02:11:06 UTC
802245,mainnet,253,109296000,109504685,208686,191723,16963,0.08128480108871702,2021-12-01 02:13:23 UTC
802246,mainnet,253,109296000,109504924,208925,191957,16968,0.08121574727773125,2021-12-01 02:15:28 UTC
802248,mainnet,253,109296000,109505168,209169,192200,16969,0.08112578823821885,2021-12-01 02:17:47 UTC
802249,mainnet,253,109296000,109505412,209413,192440,16973,0.08105036459054596,2021-12-01 02:19:52 UTC
802251,mainnet,253,109296000,109505658,209659,192681,16978,0.08097911370368074,2021-12-01 02:22:05 UTC
802252,mainnet,253,109296000,109505910,209911,192928,16983,0.08090571718490218,2021-12-01 02:24:09 UTC
802254,mainnet,253,109296000,109506157,210158,193165,16993,0.08085821144091589,2021-12-01 02:26:24 UTC
802255,mainnet,253,109296000,109506393,210394,193394,17000,0.08080078329229921,2021-12-01 02:28:30 UTC
802256,mainnet,253,109296000,109506607,210608,193597,17011,0.08077091088657601,2021-12-01 02:30:48 UTC
802257,mainnet,253,109296000,109506867,210868,193846,17022,0.08072348578257488,2021-12-01 02:32:57 UTC
802259,mainnet,253,109296000,109507126,211127,194093,17034,0.08068129609192572,2021-12-01 02:35:09 UTC
802260,mainnet,253,109296000,109507349,211350,194304,17046,0.08065294535131298,2021-12-01 02:37:18 UTC
802262,mainnet,253,109296000,109507574,211575,194519,17056,0.08061443932411674,2021-12-01 02:39:28 UTC
802263,mainnet,253,109296000,109507819,211820,194763,17057,0.08052591823246152,2021-12-01 02:41:37 UTC
802264,mainnet,253,109296000,109508093,212094,195025,17069,0.08047846709477872,2021-12-01 02:43:50 UTC
802266,mainnet,253,109296000,109508358,212359,195280,17079,0.08042512914451472,2021-12-01 02:46:08 UTC
802267,mainnet,253,109296000,109508626,212627,195535,17092,0.08038489937778363,2021-12-01 02:48:24 UTC
802269,mainnet,253,109296000,109508873,212874,195755,17119,0.08041846350423255,2021-12-01 02:50:58 UTC
802270,mainnet,253,109296000,109509172,213173,196040,17133,0.08037134158641104,2021-12-01 02:53:26 UTC
802272,mainnet,253,109296000,109509424,213425,196283,17142,0.08031861309593534,2021-12-01 02:55:41 UTC
802273,mainnet,253,109296000,109509667,213668,196521,17147,0.0802506692625943,2021-12-01 02:57:55 UTC
802275,mainnet,253,109296000,109509921,213922,196764,17158,0.08020680434924879,2021-12-01 03:00:29 UTC
802276,mainnet,253,109296000,109510240,214241,197056,17185,0.08021340453041201,2021-12-01 03:03:04 UTC
802278,mainnet,253,109296000,109510481,214482,197287,17195,0.08016989770703369,2021-12-01 03:05:27 UTC
802279,mainnet,253,109296000,109510760,214761,197544,17217,0.08016818696131979,2021-12-01 03:07:54 UTC
802281,mainnet,253,109296000,109511020,215021,197783,17238,0.08016891373400738,2021-12-01 03:10:28 UTC
802283,mainnet,253,109296000,109511301,215302,198058,17244,0.08009214963168015,2021-12-01 03:13:02 UTC
802284,mainnet,253,109296000,109511548,215549,198301,17248,0.0800189284107094,2021-12-01 03:15:18 UTC
802286,mainnet,253,109296000,109511700,215701,198448,17253,0.07998572097486799,2021-12-01 03:17:45 UTC
802287,mainnet,253,109296000,109512081,216082,198806,17276,0.07995112966373877,2021-12-01 03:20:00 UTC
802288,mainnet,253,109296000,109512315,216316,199026,17290,0.07992936259916049,2021-12-01 03:22:12 UTC
802289,mainnet,253,109296000,109512568,216569,199251,17318,0.07996527665547701,2021-12-01 03:24:17 UTC
802290,mainnet,253,109296000,109512811,216812,199486,17326,0.0799125509658137,2021-12-01 03:26:32 UTC
802292,mainnet,253,109296000,109513049,217050,199708,17342,0.07989864086615987,2021-12-01 03:28:40 UTC
802293,mainnet,253,109296000,109513302,217303,199956,17347,0.07982862638803882,2021-12-01 03:30:53 UTC
802295,mainnet,253,109296000,109513537,217538,200175,17363,0.07981594020355065,2021-12-01 03:32:59 UTC
802296,mainnet,253,109296000,109513814,217815,200442,17373,0.07976034708353419,2021-12-01 03:35:22 UTC
802298,mainnet,253,109296000,109514040,218041,200658,17383,0.07972353823363496,2021-12-01 03:37:25 UTC
802299,mainnet,253,109296000,109514269,218270,200878,17392,0.07968112887707884,2021-12-01 03:39:35 UTC
802301,mainnet,253,109296000,109514494,218495,201081,17414,0.07969976429666582,2021-12-01 03:41:44 UTC
802302,mainnet,253,109296000,109514741,218742,201312,17430,0.07968291411800203,2021-12-01 03:43:58 UTC
802303,mainnet,253,109296000,109514975,218976,201540,17436,0.07962516440157826,2021-12-01 03:46:07 UTC
802304,mainnet,253,109296000,109515213,219214,201772,17442,0.07956608610763911,2021-12-01 03:48:22 UTC
802305,mainnet,253,109296000,109515455,219456,202011,17445,0.07949201662292213,2021-12-01 03:50:29 UTC
802306,mainnet,253,109296000,109515700,219701,202235,17466,0.07949895539847338,2021-12-01 03:52:43 UTC
802308,mainnet,253,109296000,109515924,219925,202457,17468,0.07942707741275434,2021-12-01 03:54:47 UTC
802309,mainnet,253,109296000,109516186,220187,202712,17475,0.07936435847711264,2021-12-01 03:57:04 UTC
802311,mainnet,253,109296000,109516429,220430,202940,17490,0.07934491675361793,2021-12-01 03:59:12 UTC
802312,mainnet,253,109296000,109516661,220662,203168,17494,0.0792796222276604,2021-12-01 04:01:30 UTC
802313,mainnet,253,109296000,109516905,220906,203395,17511,0.07926901034829294,2021-12-01 04:03:37 UTC
802315,mainnet,253,109296000,109517128,221129,203616,17513,0.07919811512736909,2021-12-01 04:05:50 UTC
802316,mainnet,253,109296000,109517404,221405,203857,17548,0.07925746934351076,2021-12-01 04:08:08 UTC
802318,mainnet,253,109296000,109517678,221679,204122,17557,0.07920010465583117,2021-12-01 04:10:36 UTC
802319,mainnet,253,109296000,109517936,221937,204358,17579,0.07920716239293132,2021-12-01 04:12:53 UTC
802321,mainnet,253,109296000,109518214,222215,204611,17604,0.07922057466867673,2021-12-01 04:15:12 UTC
802322,mainnet,253,109296000,109518456,222457,204837,17620,0.07920631852447889,2021-12-01 04:17:29 UTC
802324,mainnet,253,109296000,109518749,222750,205120,17630,0.07914702581369248,2021-12-01 04:20:04 UTC
802325,mainnet,253,109296000,109519036,223037,205389,17648,0.07912588494285701,2021-12-01 04:22:44 UTC
802327,mainnet,253,109296000,109519311,223312,205636,17676,0.07915382961954574,2021-12-01 04:25:15 UTC
802328,mainnet,253,109296000,109519547,223548,205859,17689,0.07912841984719166,2021-12-01 04:27:25 UTC
802330,mainnet,253,109296000,109519803,223804,206108,17696,0.07906918553734518,2021-12-01 04:29:44 UTC
802332,mainnet,253,109296000,109520061,224062,206359,17703,0.07900938133195276,2021-12-01 04:32:02 UTC
802333,mainnet,253,109296000,109520322,224323,206618,17705,0.0789263695653143,2021-12-01 04:34:16 UTC
802335,mainnet,253,109296000,109520600,224601,206879,17722,0.07890436819070262,2021-12-01 04:36:38 UTC
802336,mainnet,253,109296000,109520856,224857,207132,17725,0.07882787727311136,2021-12-01 04:38:51 UTC
802338,mainnet,253,109296000,109521081,225082,207353,17729,0.07876684941487991,2021-12-01 04:40:54 UTC
802339,mainnet,253,109296000,109521344,225345,207607,17738,0.078714859437751,2021-12-01 04:43:10 UTC
802341,mainnet,253,109296000,109521628,225629,207876,17753,0.07868226158871422,2021-12-01 04:45:54 UTC
802342,mainnet,253,109296000,109521961,225962,208190,17772,0.07865039254387905,2021-12-01 04:48:40 UTC
802344,mainnet,253,109296000,109522210,226211,208420,17791,0.07864781111440204,2021-12-01 04:50:44 UTC
802345,mainnet,253,109296000,109522458,226459,208667,17792,0.07856609805748502,2021-12-01 04:52:52 UTC
802347,mainnet,253,109296000,109522689,226690,208886,17804,0.07853897392915435,2021-12-01 04:54:57 UTC
802348,mainnet,253,109296000,109522996,226997,209175,17822,0.07851205082005489,2021-12-01 04:57:37 UTC
802350,mainnet,253,109296000,109523232,227233,209400,17833,0.07847891811488648,2021-12-01 04:59:47 UTC
802351,mainnet,253,109296000,109523507,227508,209672,17836,0.07839724317386641,2021-12-01 05:02:19 UTC
802353,mainnet,253,109296000,109523805,227806,209933,17873,0.07845710824122279,2021-12-01 05:04:34 UTC
802354,mainnet,253,109296000,109523972,227973,210090,17883,0.07844349988814465,2021-12-01 05:06:14 UTC
802356,mainnet,253,109296000,109524245,228246,210346,17900,0.07842415639266405,2021-12-01 05:08:41 UTC
802357,mainnet,253,109296000,109524491,228492,210584,17908,0.07837473522048911,2021-12-01 05:10:55 UTC
802359,mainnet,253,109296000,109524742,228743,210828,17915,0.07831933654800366,2021-12-01 05:13:18 UTC
802360,mainnet,253,109296000,109524986,228987,211064,17923,0.07827081886744662,2021-12-01 05:15:29 UTC
802362,mainnet,253,109296000,109525225,229226,211292,17934,0.0782371982235872,2021-12-01 05:17:43 UTC
802363,mainnet,253,109296000,109525465,229466,211518,17948,0.07821638064026915,2021-12-01 05:19:56 UTC
802365,mainnet,253,109296000,109525711,229712,211737,17975,0.07825015671797729,2021-12-01 05:22:23 UTC
802366,mainnet,253,109296000,109526011,230012,212021,17991,0.07821765820913691,2021-12-01 05:24:59 UTC
802368,mainnet,253,109296000,109526265,230266,212259,18007,0.0782008633493438,2021-12-01 05:27:21 UTC
802370,mainnet,253,109296000,109526496,230497,212480,18017,0.0781658763454622,2021-12-01 05:29:45 UTC
802371,mainnet,253,109296000,109526805,230806,212764,18042,0.07816954498583226,2021-12-01 05:32:18 UTC
802373,mainnet,253,109296000,109527087,231088,213032,18056,0.07813473655057813,2021-12-01 05:34:41 UTC
802374,mainnet,253,109296000,109527336,231337,213275,18062,0.07807657227335013,2021-12-01 05:37:00 UTC
802376,mainnet,253,109296000,109527597,231598,213528,18070,0.07802312627915613,2021-12-01 05:39:22 UTC
802377,mainnet,253,109296000,109527856,231857,213775,18082,0.07798772519268342,2021-12-01 05:41:53 UTC
802379,mainnet,253,109296000,109528136,232137,214047,18090,0.07792812003256698,2021-12-01 05:44:20 UTC
802380,mainnet,253,109296000,109528400,232401,214300,18101,0.07788692819738297,2021-12-01 05:46:46 UTC
802382,mainnet,253,109296000,109528684,232685,214579,18106,0.07781335281603885,2021-12-01 05:49:04 UTC
802383,mainnet,253,109296000,109528966,232967,214846,18121,0.07778354874295501,2021-12-01 05:51:24 UTC
802385,mainnet,253,109296000,109529203,233204,215079,18125,0.07772165142964958,2021-12-01 05:53:35 UTC
802386,mainnet,253,109296000,109529449,233450,215315,18135,0.07768258727778968,2021-12-01 05:55:50 UTC
802388,mainnet,253,109296000,109529682,233683,215528,18155,0.07769071776723167,2021-12-01 05:58:06 UTC
802389,mainnet,253,109296000,109529938,233939,215769,18170,0.0776698199103185,2021-12-01 06:00:26 UTC
802391,mainnet,253,109296000,109530217,234218,216023,18195,0.07768403794755313,2021-12-01 06:02:54 UTC
802392,mainnet,253,109296000,109530501,234502,216286,18216,0.0776795080638971,2021-12-01 06:05:24 UTC
802394,mainnet,253,109296000,109530769,234770,216544,18226,0.07763342846189888,2021-12-01 06:07:56 UTC
802396,mainnet,253,109296000,109531018,235019,216774,18245,0.07763202124083585,2021-12-01 06:10:29 UTC
802397,mainnet,253,109296000,109531292,235293,217022,18271,0.07765211884756452,2021-12-01 06:12:42 UTC
802399,mainnet,253,109296000,109531563,235564,217284,18280,0.07760099166256304,2021-12-01 06:15:17 UTC
802400,mainnet,253,109296000,109531848,235849,217556,18293,0.07756233861496127,2021-12-01 06:17:52 UTC
802401,mainnet,253,109296000,109532140,236141,217827,18314,0.0775553588745707,2021-12-01 06:20:28 UTC
802402,mainnet,253,109296000,109532455,236456,218119,18337,0.07754931149981392,2021-12-01 06:23:13 UTC
802404,mainnet,253,109296000,109532725,236726,218375,18351,0.07752000202766067,2021-12-01 06:25:38 UTC
802405,mainnet,253,109296000,109532896,236897,218531,18366,0.07752736421313905,2021-12-01 06:27:49 UTC
802407,mainnet,253,109296000,109533228,237229,218835,18394,0.07753689473040817,2021-12-01 06:30:03 UTC
802408,mainnet,253,109296000,109533497,237498,219091,18407,0.0775038105584047,2021-12-01 06:32:22 UTC
802410,mainnet,253,109296000,109533728,237729,219310,18419,0.07747897816421219,2021-12-01 06:34:30 UTC
802411,mainnet,253,109296000,109533985,237986,219558,18428,0.07743312631835486,2021-12-01 06:36:42 UTC
802413,mainnet,253,109296000,109534220,238221,219768,18453,0.07746168473812133,2021-12-01 06:38:50 UTC
802414,mainnet,253,109296000,109534462,238463,219998,18465,0.0774333963759577,2021-12-01 06:41:06 UTC
802416,mainnet,253,109296000,109534733,238734,220261,18473,0.07737900759841497,2021-12-01 06:43:26 UTC
802417,mainnet,253,109296000,109534993,238994,220509,18485,0.07734503795074353,2021-12-01 06:45:42 UTC
802418,mainnet,253,109296000,109535243,239244,220749,18495,0.07730601394392336,2021-12-01 06:47:57 UTC
802420,mainnet,253,109296000,109535496,239497,220979,18518,0.07732038397140674,2021-12-01 06:50:10 UTC
802421,mainnet,253,109296000,109535757,239758,221234,18524,0.0772612384154022,2021-12-01 06:52:26 UTC
802423,mainnet,253,109296000,109535989,239990,221462,18528,0.07720321680070003,2021-12-01 06:54:40 UTC
802424,mainnet,253,109296000,109536250,240251,221713,18538,0.07716096915309406,2021-12-01 06:56:53 UTC
802426,mainnet,253,109296000,109536476,240477,221926,18551,0.07714251258956158,2021-12-01 06:59:01 UTC
802427,mainnet,253,109296000,109536727,240728,222162,18566,0.07712438935229803,2021-12-01 07:01:15 UTC
802428,mainnet,253,109296000,109536968,240969,222393,18576,0.07708875415509879,2021-12-01 07:03:31 UTC
802430,mainnet,253,109296000,109537211,241212,222624,18588,0.07706084274414209,2021-12-01 07:05:43 UTC
802431,mainnet,253,109296000,109537457,241458,222861,18597,0.07701960589419278,2021-12-01 07:07:56 UTC
802432,mainnet,253,109296000,109537688,241689,223081,18608,0.07699150561258476,2021-12-01 07:10:11 UTC
802434,mainnet,253,109296000,109537935,241936,223318,18618,0.07695423583096356,2021-12-01 07:12:20 UTC
802435,mainnet,253,109296000,109538181,242182,223544,18638,0.07695865093194375,2021-12-01 07:14:35 UTC
802437,mainnet,253,109296000,109538427,242428,223789,18639,0.07688468328740905,2021-12-01 07:16:48 UTC
802438,mainnet,253,109296000,109538699,242700,224042,18658,0.07687680263700042,2021-12-01 07:19:25 UTC
802440,mainnet,253,109296000,109538924,242925,224256,18669,0.07685087990120408,2021-12-01 07:21:30 UTC
802441,mainnet,253,109296000,109539183,243184,224496,18688,0.07684716099743404,2021-12-01 07:23:50 UTC
802443,mainnet,253,109296000,109539481,243482,224786,18696,0.07678596364412975,2021-12-01 07:26:24 UTC
802444,mainnet,253,109296000,109539751,243752,225041,18711,0.07676244707735731,2021-12-01 07:28:58 UTC
802445,mainnet,253,109296000,109540072,244073,225344,18729,0.0767352390473342,2021-12-01 07:31:48 UTC
802447,mainnet,253,109296000,109540323,244324,225583,18741,0.07670552217547191,2021-12-01 07:34:10 UTC
802448,mainnet,253,109296000,109540589,244590,225831,18759,0.07669569483625659,2021-12-01 07:36:33 UTC
802450,mainnet,253,109296000,109540857,244858,226082,18776,0.07668117847895516,2021-12-01 07:38:56 UTC
802451,mainnet,253,109296000,109541108,245109,226316,18793,0.0766720112276579,2021-12-01 07:41:18 UTC
802453,mainnet,253,109296000,109541346,245347,226550,18797,0.07661393862570155,2021-12-01 07:43:59 UTC
802454,mainnet,253,109296000,109541670,245671,226850,18821,0.07661058895840372,2021-12-01 07:46:20 UTC
802456,mainnet,253,109296000,109541912,245913,227081,18832,0.07657992867396193,2021-12-01 07:48:32 UTC
802457,mainnet,253,109296000,109542169,246170,227332,18838,0.0765243530893285,2021-12-01 07:50:45 UTC
802458,mainnet,253,109296000,109542433,246434,227596,18838,0.076442374023065,2021-12-01 07:53:00 UTC
802460,mainnet,253,109296000,109542676,246677,227826,18851,0.07641977160416252,2021-12-01 07:55:10 UTC
802461,mainnet,253,109296000,109542921,246922,228053,18869,0.07641684418561327,2021-12-01 07:57:26 UTC
802463,mainnet,253,109296000,109543168,247169,228287,18882,0.07639307518337655,2021-12-01 07:59:39 UTC
802464,mainnet,253,109296000,109543437,247438,228547,18891,0.07634639788553092,2021-12-01 08:01:58 UTC
802466,mainnet,253,109296000,109543662,247663,228762,18901,0.07631741519726402,2021-12-01 08:04:07 UTC
802467,mainnet,253,109296000,109543867,247868,228952,18916,0.0763148127229009,2021-12-01 08:06:16 UTC
802468,mainnet,253,109296000,109544082,248083,229135,18948,0.07637766392699218,2021-12-01 08:08:32 UTC
802469,mainnet,253,109296000,109544311,248312,229343,18969,0.07639179741615387,2021-12-01 08:10:42 UTC
802470,mainnet,253,109296000,109544530,248531,229545,18986,0.07639288458984995,2021-12-01 08:12:54 UTC
802472,mainnet,253,109296000,109544765,248766,229743,19023,0.07646945322109934,2021-12-01 08:15:02 UTC
802473,mainnet,253,109296000,109544928,248929,229877,19052,0.07653587970867196,2021-12-01 08:17:11 UTC
802474,mainnet,253,109296000,109545235,249236,230152,19084,0.07656999791362404,2021-12-01 08:19:22 UTC
802475,mainnet,253,109296000,109545468,249469,230363,19106,0.07658667008726536,2021-12-01 08:21:35 UTC
802476,mainnet,253,109296000,109545698,249699,230584,19115,0.07655216881124874,2021-12-01 08:23:47 UTC
802478,mainnet,253,109296000,109545959,249960,230824,19136,0.07655624899983997,2021-12-01 08:26:01 UTC
802479,mainnet,253,109296000,109546167,250168,231027,19141,0.07651258354385852,2021-12-01 08:28:09 UTC
802480,mainnet,253,109296000,109546403,250404,231259,19145,0.07645644638264565,2021-12-01 08:30:24 UTC
802482,mainnet,253,109296000,109546622,250623,231457,19166,0.07647342821688352,2021-12-01 08:32:37 UTC
802483,mainnet,253,109296000,109546862,250863,231677,19186,0.07647999107082351,2021-12-01 08:34:52 UTC
802484,mainnet,253,109296000,109547093,251094,231874,19220,0.07654503890973102,2021-12-01 08:37:00 UTC
802485,mainnet,253,109296000,109547293,251294,232068,19226,0.07650799461984767,2021-12-01 08:39:11 UTC
802487,mainnet,253,109296000,109547545,251546,232303,19243,0.07649893061308866,2021-12-01 08:41:19 UTC
802488,mainnet,253,109296000,109547793,251794,232537,19257,0.07647918536581491,2021-12-01 08:43:37 UTC
802490,mainnet,253,109296000,109548017,252018,232742,19276,0.07648660016348038,2021-12-01 08:45:46 UTC
802491,mainnet,253,109296000,109548218,252219,232916,19303,0.07653269579214889,2021-12-01 08:47:57 UTC
802493,mainnet,253,109296000,109548461,252462,233120,19342,0.07661351015202288,2021-12-01 08:50:17 UTC
802494,mainnet,253,109296000,109548722,252723,233365,19358,0.07659769787474824,2021-12-01 08:52:50 UTC
802496,mainnet,253,109296000,109548985,252986,233620,19366,0.07654969049670733,2021-12-01 08:55:07 UTC
802497,mainnet,253,109296000,109549233,253234,233851,19383,0.07654185456929165,2021-12-01 08:57:19 UTC
802499,mainnet,253,109296000,109549454,253455,234046,19409,0.07657769623799096,2021-12-01 08:59:32 UTC
802500,mainnet,253,109296000,109549735,253736,234304,19432,0.07658353564334584,2021-12-01 09:02:03 UTC
802502,mainnet,253,109296000,109549985,253986,234527,19459,0.07661445906467286,2021-12-01 09:04:16 UTC
802503,mainnet,253,109296000,109550225,254226,234750,19476,0.07660900143966393,2021-12-01 09:06:32 UTC
802504,mainnet,253,109296000,109550468,254469,234965,19504,0.07664587827986906,2021-12-01 09:08:53 UTC
802506,mainnet,253,109296000,109550686,254687,235173,19514,0.07661953692179027,2021-12-01 09:11:00 UTC
802507,mainnet,253,109296000,109550904,254905,235365,19540,0.07665600910142994,2021-12-01 09:13:09 UTC
802509,mainnet,253,109296000,109551132,255133,235587,19546,0.07661102248631106,2021-12-01 09:15:24 UTC
802510,mainnet,253,109296000,109551398,255399,235833,19566,0.07660954036625045,2021-12-01 09:17:44 UTC
802512,mainnet,253,109296000,109551659,255660,236080,19580,0.0765860909019792,2021-12-01 09:19:58 UTC
802513,mainnet,253,109296000,109551892,255893,236301,19592,0.07656325104633577,2021-12-01 09:22:12 UTC
802515,mainnet,253,109296000,109552140,256141,236541,19600,0.07652035402376035,2021-12-01 09:24:32 UTC
802516,mainnet,253,109296000,109552419,256420,236799,19621,0.07651899227829342,2021-12-01 09:27:11 UTC
802518,mainnet,253,109296000,109552700,256701,237058,19643,0.07652093291416863,2021-12-01 09:29:36 UTC
802519,mainnet,253,109296000,109552946,256947,237295,19652,0.07648269876667173,2021-12-01 09:31:55 UTC
802521,mainnet,253,109296000,109553192,257193,237528,19665,0.07646009028239494,2021-12-01 09:34:12 UTC
802522,mainnet,253,109296000,109553472,257473,237802,19671,0.07640024390907008,2021-12-01 09:36:41 UTC
802524,mainnet,253,109296000,109553719,257720,238028,19692,0.07640850535464845,2021-12-01 09:39:05 UTC
802525,mainnet,253,109296000,109554000,258001,238292,19709,0.07639117677838458,2021-12-01 09:41:34 UTC
802527,mainnet,253,109296000,109554251,258252,238523,19729,0.07639437448693524,2021-12-01 09:43:55 UTC
802528,mainnet,253,109296000,109554471,258472,238736,19736,0.07635643319198984,2021-12-01 09:46:08 UTC
802530,mainnet,253,109296000,109554698,258699,238946,19753,0.07635514632835844,2021-12-01 09:48:19 UTC
802531,mainnet,253,109296000,109554945,258946,239193,19753,0.07628231368702355,2021-12-01 09:50:37 UTC
802533,mainnet,253,109296000,109555199,259200,239430,19770,0.07627314814814815,2021-12-01 09:52:51 UTC
802534,mainnet,253,109296000,109555431,259432,239652,19780,0.07624348576891055,2021-12-01 09:55:07 UTC
802536,mainnet,253,109296000,109555663,259664,239871,19793,0.07622542978618523,2021-12-01 09:57:22 UTC
802537,mainnet,253,109296000,109555888,259889,240071,19818,0.07625563221221368,2021-12-01 09:59:36 UTC
802539,mainnet,253,109296000,109556136,260137,240308,19829,0.07622521978803477,2021-12-01 10:01:56 UTC
802540,mainnet,253,109296000,109556380,260381,240537,19844,0.07621139791305817,2021-12-01 10:04:13 UTC
802541,mainnet,253,109296000,109556616,260617,240763,19854,0.0761807556682795,2021-12-01 10:06:30 UTC
802543,mainnet,253,109296000,109556830,260831,240961,19870,0.07617959521682623,2021-12-01 10:08:42 UTC
802544,mainnet,253,109296000,109557117,261118,241219,19899,0.07620692560451596,2021-12-01 10:11:04 UTC
802546,mainnet,253,109296000,109557372,261373,241450,19923,0.07622439961281387,2021-12-01 10:13:31 UTC
802547,mainnet,253,109296000,109557691,261692,241764,19928,0.0761505892423154,2021-12-01 10:16:28 UTC
802549,mainnet,253,109296000,109557956,261957,242022,19935,0.0761002759994961,2021-12-01 10:18:48 UTC
802551,mainnet,253,109296000,109558220,262221,242280,19941,0.076046540894894,2021-12-01 10:21:20 UTC
802552,mainnet,253,109296000,109558460,262461,242515,19946,0.0759960527468843,2021-12-01 10:23:39 UTC
802553,mainnet,253,109296000,109558751,262752,242787,19965,0.0759841980270369,2021-12-01 10:26:37 UTC
802554,mainnet,253,109296000,109559036,263037,243054,19983,0.07597030075616738,2021-12-01 10:29:09 UTC
802556,mainnet,253,109296000,109559337,263338,243342,19996,0.07593283157007344,2021-12-01 10:31:50 UTC
802557,mainnet,253,109296000,109559604,263605,243603,20002,0.07587868211907968,2021-12-01 10:34:11 UTC
802559,mainnet,253,109296000,109559905,263906,243890,20016,0.07584518730153919,2021-12-01 10:37:02 UTC
802560,mainnet,253,109296000,109560186,264187,244153,20034,0.07583264884343287,2021-12-01 10:39:36 UTC
802561,mainnet,253,109296000,109560431,264432,244383,20049,0.0758191141768016,2021-12-01 10:41:51 UTC
802563,mainnet,253,109296000,109560675,264676,244601,20075,0.07584745122338254,2021-12-01 10:43:57 UTC
802564,mainnet,253,109296000,109560900,264901,244817,20084,0.07581700333332075,2021-12-01 10:46:20 UTC
802566,mainnet,253,109296000,109561129,265130,245028,20102,0.07581940934635839,2021-12-01 10:48:45 UTC
802567,mainnet,253,109296000,109561380,265381,245260,20121,0.07581929377008904,2021-12-01 10:51:04 UTC
802568,mainnet,253,109296000,109561638,265639,245502,20137,0.07580588693678263,2021-12-01 10:53:35 UTC
802569,mainnet,253,109296000,109561874,265875,245719,20156,0.07581006111894688,2021-12-01 10:55:55 UTC
802571,mainnet,253,109296000,109562132,266133,245952,20181,0.07583050579973172,2021-12-01 10:58:13 UTC
802572,mainnet,253,109296000,109562405,266406,246185,20221,0.07590294512886346,2021-12-01 11:00:49 UTC
802573,mainnet,253,109296000,109562663,266664,246431,20233,0.07587450874508746,2021-12-01 11:03:10 UTC
802575,mainnet,253,109296000,109562910,266911,246658,20253,0.0758792256594895,2021-12-01 11:05:29 UTC
802576,mainnet,253,109296000,109563124,267125,246864,20261,0.07584838558727187,2021-12-01 11:07:38 UTC
802577,mainnet,253,109296000,109563366,267367,247080,20287,0.07587697808630085,2021-12-01 11:09:55 UTC
802578,mainnet,253,109296000,109563615,267616,247306,20310,0.07589232332894894,2021-12-01 11:12:08 UTC
802580,mainnet,253,109296000,109563844,267845,247523,20322,0.07587223954152589,2021-12-01 11:14:23 UTC
802581,mainnet,253,109296000,109564081,268082,247756,20326,0.07582008489939646,2021-12-01 11:16:41 UTC
802583,mainnet,253,109296000,109564308,268309,247964,20345,0.07582675199117435,2021-12-01 11:18:52 UTC
802584,mainnet,253,109296000,109564552,268553,248201,20352,0.07578392347134458,2021-12-01 11:21:08 UTC
802586,mainnet,253,109296000,109564811,268812,248455,20357,0.07572950612323855,2021-12-01 11:23:22 UTC
802587,mainnet,253,109296000,109565077,269078,248716,20362,0.07567322486416578,2021-12-01 11:25:46 UTC
802589,mainnet,253,109296000,109565337,269338,248948,20390,0.07570413383926516,2021-12-01 11:28:11 UTC
802590,mainnet,253,109296000,109565569,269570,249163,20407,0.07570204399599362,2021-12-01 11:30:20 UTC
802592,mainnet,253,109296000,109565840,269841,249422,20419,0.07567048743519332,2021-12-01 11:32:49 UTC
802593,mainnet,253,109296000,109566082,270083,249650,20433,0.07565452101761311,2021-12-01 11:35:04 UTC
802595,mainnet,253,109296000,109566303,270304,249844,20460,0.07569255356931455,2021-12-01 11:37:20 UTC
802596,mainnet,253,109296000,109566557,270558,250073,20485,0.07571389498739642,2021-12-01 11:39:42 UTC
802598,mainnet,253,109296000,109566791,270792,250303,20489,0.07566323968211763,2021-12-01 11:41:54 UTC
802599,mainnet,253,109296000,109567058,271059,250544,20515,0.07568462954559708,2021-12-01 11:44:13 UTC
802601,mainnet,253,109296000,109567311,271312,250785,20527,0.0756582827151029,2021-12-01 11:46:35 UTC
802602,mainnet,253,109296000,109567540,271541,251006,20535,0.07562393892634998,2021-12-01 11:48:49 UTC
802604,mainnet,253,109296000,109567788,271789,251244,20545,0.07559172740618642,2021-12-01 11:51:12 UTC
802605,mainnet,253,109296000,109567988,271989,251439,20550,0.07555452610215854,2021-12-01 11:53:35 UTC
802607,mainnet,253,109296000,109568261,272262,251694,20568,0.0755448795645371,2021-12-01 11:55:58 UTC
802609,mainnet,253,109296000,109568530,272531,251951,20580,0.0755143451570647,2021-12-01 11:58:28 UTC
802610,mainnet,253,109296000,109568784,272785,252193,20592,0.07548802170207305,2021-12-01 12:00:54 UTC
802611,mainnet,253,109296000,109569008,273009,252408,20601,0.07545905080052306,2021-12-01 12:03:12 UTC
802612,mainnet,253,109296000,109569278,273279,252648,20631,0.0754942750815101,2021-12-01 12:05:47 UTC
802614,mainnet,253,109296000,109569539,273540,252871,20669,0.0755611610733348,2021-12-01 12:08:23 UTC
802615,mainnet,253,109296000,109569782,273783,253095,20688,0.07556349371582603,2021-12-01 12:10:47 UTC
802617,mainnet,253,109296000,109569982,273983,253279,20704,0.0755667322425114,2021-12-01 12:12:56 UTC
802618,mainnet,253,109296000,109570221,274222,253490,20732,0.07560297860857261,2021-12-01 12:15:29 UTC
802619,mainnet,253,109296000,109570380,274381,253620,20761,0.07566486017617838,2021-12-01 12:17:43 UTC
802621,mainnet,253,109296000,109570620,274621,253845,20776,0.07565335498741903,2021-12-01 12:20:15 UTC
802622,mainnet,253,109296000,109570975,274976,254147,20829,0.0757484289537996,2021-12-01 12:22:34 UTC
802624,mainnet,253,109296000,109571209,275210,254356,20854,0.07577486283201919,2021-12-01 12:24:56 UTC
802625,mainnet,253,109296000,109571432,275433,254571,20862,0.07574255808127567,2021-12-01 12:27:11 UTC
802627,mainnet,253,109296000,109571659,275660,254783,20877,0.0757346005949358,2021-12-01 12:29:25 UTC
802628,mainnet,253,109296000,109571871,275872,254976,20896,0.07574527317016587,2021-12-01 12:31:39 UTC
802630,mainnet,253,109296000,109572086,276087,255179,20908,0.07572975185358238,2021-12-01 12:33:50 UTC
802631,mainnet,253,109296000,109572292,276293,255351,20942,0.07579634663201745,2021-12-01 12:36:07 UTC
802633,mainnet,253,109296000,109572549,276550,255585,20965,0.07580907611643464,2021-12-01 12:38:28 UTC
802634,mainnet,253,109296000,109572778,276779,255779,21000,0.0758728082694135,2021-12-01 12:40:44 UTC
802635,mainnet,253,109296000,109573048,277049,256012,21037,0.07593241628737155,2021-12-01 12:43:14 UTC
802637,mainnet,253,109296000,109573307,277308,256227,21081,0.07602016530356139,2021-12-01 12:45:44 UTC
802638,mainnet,253,109296000,109573524,277525,256411,21114,0.07607963246554364,2021-12-01 12:47:56 UTC
802640,mainnet,253,109296000,109573759,277760,256628,21132,0.07608006912442396,2021-12-01 12:50:10 UTC
802641,mainnet,253,109296000,109574006,278007,256872,21135,0.07602326560122587,2021-12-01 12:52:31 UTC
802643,mainnet,253,109296000,109574199,278200,257051,21149,0.07602084831056793,2021-12-01 12:54:59 UTC
802644,mainnet,253,109296000,109574524,278525,257355,21170,0.07600753971815816,2021-12-01 12:57:23 UTC
802646,mainnet,253,109296000,109574759,278760,257571,21189,0.07601162290142058,2021-12-01 12:59:43 UTC
802647,mainnet,253,109296000,109575058,279059,257846,21213,0.07601618295772579,2021-12-01 13:02:41 UTC
802648,mainnet,253,109296000,109575357,279358,258129,21229,0.07599209616334596,2021-12-01 13:05:30 UTC
802650,mainnet,253,109296000,109575607,279608,258357,21251,0.07600283253698034,2021-12-01 13:08:07 UTC
802652,mainnet,253,109296000,109575893,279894,258624,21270,0.07599305451349439,2021-12-01 13:10:41 UTC
802653,mainnet,253,109296000,109576132,280133,258847,21286,0.07598533553704848,2021-12-01 13:13:01 UTC
802654,mainnet,253,109296000,109576404,280405,259094,21311,0.07600078457944759,2021-12-01 13:15:41 UTC
802656,mainnet,253,109296000,109576697,280698,259377,21321,0.07595707842592395,2021-12-01 13:18:41 UTC
802657,mainnet,253,109296000,109576936,280937,259592,21345,0.0759778882810025,2021-12-01 13:21:03 UTC
802659,mainnet,253,109296000,109577239,281240,259876,21364,0.07596358981652682,2021-12-01 13:23:40 UTC
802660,mainnet,253,109296000,109577544,281545,260163,21382,0.07594523078015948,2021-12-01 13:26:35 UTC
802662,mainnet,253,109296000,109577771,281772,260375,21397,0.07593728262566898,2021-12-01 13:29:01 UTC
802663,mainnet,253,109296000,109578001,282002,260590,21412,0.07592853951390416,2021-12-01 13:31:38 UTC
802665,mainnet,253,109296000,109578247,282248,260800,21448,0.0759899095830617,2021-12-01 13:34:01 UTC
802666,mainnet,253,109296000,109578543,282544,261072,21472,0.07599524321875531,2021-12-01 13:36:43 UTC
802668,mainnet,253,109296000,109578772,282773,261277,21496,0.0760185732018262,2021-12-01 13:39:09 UTC
802670,mainnet,253,109296000,109579017,283018,261493,21525,0.0760552332360486,2021-12-01 13:41:41 UTC
802671,mainnet,253,109296000,109579208,283209,261674,21535,0.07603925016507244,2021-12-01 13:43:53 UTC
802672,mainnet,253,109296000,109579443,283444,261888,21556,0.07605029564922877,2021-12-01 13:46:12 UTC
802674,mainnet,253,109296000,109579668,283669,262098,21571,0.07604285276149315,2021-12-01 13:48:33 UTC
802675,mainnet,253,109296000,109579893,283894,262288,21606,0.07610587050096163,2021-12-01 13:50:49 UTC
802677,mainnet,253,109296000,109580117,284118,262499,21619,0.07609162390274464,2021-12-01 13:53:03 UTC
802678,mainnet,253,109296000,109580345,284346,262708,21638,0.07609743059512003,2021-12-01 13:55:17 UTC
802680,mainnet,253,109296000,109580566,284567,262921,21646,0.07606644480913106,2021-12-01 13:57:35 UTC
802681,mainnet,253,109296000,109580802,284803,263137,21666,0.07607363686478022,2021-12-01 13:59:53 UTC
802683,mainnet,253,109296000,109581052,285053,263371,21682,0.07606304792442108,2021-12-01 14:02:34 UTC
802684,mainnet,253,109296000,109581308,285309,263613,21696,0.07604386822708012,2021-12-01 14:05:04 UTC
802686,mainnet,253,109296000,109581520,285521,263796,21725,0.07608897419104024,2021-12-01 14:07:14 UTC
802687,mainnet,253,109296000,109581760,285761,263999,21762,0.07615454873128244,2021-12-01 14:09:41 UTC
802688,mainnet,253,109296000,109582017,286018,264240,21778,0.07614206098916851,2021-12-01 14:12:14 UTC
802690,mainnet,253,109296000,109582267,286268,264479,21789,0.07611399108527674,2021-12-01 14:14:49 UTC
802692,mainnet,253,109296000,109582519,286520,264712,21808,0.07611336032388664,2021-12-01 14:17:20 UTC
802693,mainnet,253,109296000,109582756,286757,264936,21821,0.07609578842016063,2021-12-01 14:19:35 UTC
802695,mainnet,253,109296000,109582980,286981,265145,21836,0.07608866092180319,2021-12-01 14:22:00 UTC
802696,mainnet,253,109296000,109583217,287218,265354,21864,0.07612336274188944,2021-12-01 14:24:24 UTC
802698,mainnet,253,109296000,109583406,287407,265514,21893,0.07617420591704448,2021-12-01 14:26:47 UTC
802699,mainnet,253,109296000,109583599,287600,265685,21915,0.07619958275382475,2021-12-01 14:29:05 UTC
802700,mainnet,253,109296000,109583805,287806,265864,21942,0.07623885534005545,2021-12-01 14:31:31 UTC
802701,mainnet,253,109296000,109584065,288066,266099,21967,0.07625683003200655,2021-12-01 14:34:02 UTC
802703,mainnet,253,109296000,109584292,288293,266296,21997,0.07630084670803662,2021-12-01 14:36:21 UTC
802704,mainnet,253,109296000,109584532,288533,266494,22039,0.07638294406532355,2021-12-01 14:38:49 UTC
802706,mainnet,253,109296000,109584748,288749,266686,22063,0.07640892262830347,2021-12-01 14:41:03 UTC
802707,mainnet,253,109296000,109584990,288991,266895,22096,0.07645912848497012,2021-12-01 14:43:26 UTC
802709,mainnet,253,109296000,109585199,289200,267094,22106,0.07643845089903181,2021-12-01 14:45:49 UTC
802710,mainnet,253,109296000,109585389,289390,267262,22128,0.07646428694840872,2021-12-01 14:48:14 UTC
802712,mainnet,253,109296000,109585631,289632,267465,22167,0.07653505137553862,2021-12-01 14:50:21 UTC
802713,mainnet,253,109296000,109585857,289858,267673,22185,0.07653747697148258,2021-12-01 14:52:45 UTC
802715,mainnet,253,109296000,109586102,290103,267898,22205,0.07654177998848685,2021-12-01 14:54:58 UTC
802716,mainnet,253,109296000,109586309,290310,268085,22225,0.07655609520857015,2021-12-01 14:57:20 UTC
802718,mainnet,253,109296000,109586590,290591,268329,22262,0.07660939258270215,2021-12-01 15:00:07 UTC
802720,mainnet,253,109296000,109586827,290828,268543,22285,0.0766260470106042,2021-12-01 15:02:39 UTC
802721,mainnet,253,109296000,109587075,291076,268777,22299,0.07660885816762632,2021-12-01 15:05:16 UTC
802723,mainnet,253,109296000,109587262,291263,268951,22312,0.07660430607389199,2021-12-01 15:07:35 UTC
802724,mainnet,253,109296000,109587567,291568,269228,22340,0.0766202052351424,2021-12-01 15:09:54 UTC
802726,mainnet,253,109296000,109587781,291782,269413,22369,0.07666339938721374,2021-12-01 15:12:09 UTC
802727,mainnet,253,109296000,109587986,291987,269605,22382,0.07665409761393487,2021-12-01 15:14:19 UTC
802729,mainnet,253,109296000,109588190,292191,269788,22403,0.07667245055460298,2021-12-01 15:16:41 UTC
802730,mainnet,253,109296000,109588454,292455,270018,22437,0.07671949530697031,2021-12-01 15:19:13 UTC
802732,mainnet,253,109296000,109588673,292674,270225,22449,0.07670308944422805,2021-12-01 15:21:36 UTC
802733,mainnet,253,109296000,109588909,292910,270450,22460,0.07667884333071592,2021-12-01 15:24:11 UTC
802735,mainnet,253,109296000,109589220,293221,270739,22482,0.07667254391738655,2021-12-01 15:26:39 UTC
802736,mainnet,253,109296000,109589418,293419,270910,22509,0.07671282364127749,2021-12-01 15:28:50 UTC
802738,mainnet,253,109296000,109589601,293602,271076,22526,0.07672291060687597,2021-12-01 15:31:01 UTC
802739,mainnet,253,109296000,109589845,293846,271298,22548,0.07673407158851915,2021-12-01 15:33:16 UTC
802741,mainnet,253,109296000,109590071,294072,271490,22582,0.07679071791942109,2021-12-01 15:35:30 UTC
802742,mainnet,253,109296000,109590253,294254,271658,22596,0.07679079978521958,2021-12-01 15:37:44 UTC
802744,mainnet,253,109296000,109590485,294486,271857,22629,0.07684236262504839,2021-12-01 15:39:54 UTC
802745,mainnet,253,109296000,109590722,294723,272078,22645,0.07683485849424714,2021-12-01 15:42:20 UTC
802746,mainnet,253,109296000,109590838,294839,272180,22659,0.07685211250886077,2021-12-01 15:44:34 UTC
802748,mainnet,253,109296000,109591271,295272,272563,22709,0.07690874854371563,2021-12-01 15:47:34 UTC
802750,mainnet,253,109296000,109591476,295477,272741,22736,0.07694676743029068,2021-12-01 15:49:44 UTC
802751,mainnet,253,109296000,109591692,295693,272945,22748,0.07693114142032446,2021-12-01 15:52:07 UTC
802753,mainnet,253,109296000,109591910,295911,273138,22773,0.07695895049525026,2021-12-01 15:54:18 UTC
802754,mainnet,253,109296000,109592116,296117,273326,22791,0.07696619917127352,2021-12-01 15:56:51 UTC
802756,mainnet,253,109296000,109592402,296403,273602,22801,0.07692567214231975,2021-12-01 15:59:24 UTC
802757,mainnet,253,109296000,109592724,296725,273904,22821,0.07690959642766872,2021-12-01 16:02:27 UTC
802758,mainnet,253,109296000,109592969,296970,274139,22831,0.07687981951038826,2021-12-01 16:04:53 UTC
802760,mainnet,253,109296000,109593184,297185,274339,22846,0.07687467402459747,2021-12-01 16:07:04 UTC
802761,mainnet,253,109296000,109593346,297347,274483,22864,0.07689332665202608,2021-12-01 16:09:33 UTC
802763,mainnet,253,109296000,109593716,297717,274804,22913,0.07696235015131819,2021-12-01 16:12:21 UTC
802765,mainnet,253,109296000,109593925,297926,275003,22923,0.07694192517605043,2021-12-01 16:14:37 UTC
802766,mainnet,253,109296000,109594132,298133,275183,22950,0.07697906638983272,2021-12-01 16:16:49 UTC
802768,mainnet,253,109296000,109594339,298340,275356,22984,0.077039619226386,2021-12-01 16:19:07 UTC
802769,mainnet,253,109296000,109594588,298589,275556,23033,0.07713947935121522,2021-12-01 16:21:46 UTC
802771,mainnet,253,109296000,109594804,298805,275758,23047,0.07713057010424859,2021-12-01 16:23:52 UTC
802772,mainnet,253,109296000,109595022,299023,275954,23069,0.07714791169910007,2021-12-01 16:26:08 UTC
802774,mainnet,253,109296000,109595236,299237,276141,23096,0.0771829686836855,2021-12-01 16:28:38 UTC
802775,mainnet,253,109296000,109595490,299491,276372,23119,0.07719430633975645,2021-12-01 16:30:51 UTC
802777,mainnet,253,109296000,109595731,299732,276571,23161,0.0772723633112247,2021-12-01 16:33:50 UTC
802778,mainnet,253,109296000,109596040,300041,276860,23181,0.07725944120970134,2021-12-01 16:36:20 UTC
802780,mainnet,253,109296000,109596247,300248,277058,23190,0.07723615144813621,2021-12-01 16:38:25 UTC
802781,mainnet,253,109296000,109596477,300478,277264,23214,0.07725690399962726,2021-12-01 16:40:47 UTC
802783,mainnet,253,109296000,109596690,300691,277469,23222,0.07722878303640615,2021-12-01 16:43:12 UTC
802784,mainnet,253,109296000,109596932,300933,277670,23263,0.07730292124825128,2021-12-01 16:45:34 UTC
802785,mainnet,253,109296000,109597223,301224,277925,23299,0.07734775449499376,2021-12-01 16:48:12 UTC
802787,mainnet,253,109296000,109597490,301491,278167,23324,0.07736217664872251,2021-12-01 16:51:10 UTC
802788,mainnet,253,109296000,109597745,301746,278407,23339,0.07734650997859127,2021-12-01 16:53:24 UTC
802790,mainnet,253,109296000,109598033,302034,278677,23357,0.07733235331121661,2021-12-01 16:56:15 UTC
802791,mainnet,253,109296000,109598288,302289,278904,23385,0.0773597451445471,2021-12-01 16:58:56 UTC
802793,mainnet,253,109296000,109598517,302518,279106,23412,0.0773904362715607,2021-12-01 17:01:29 UTC
802794,mainnet,253,109296000,109598784,302785,279323,23462,0.07748732599038922,2021-12-01 17:04:03 UTC
802796,mainnet,253,109296000,109599012,303013,279521,23492,0.07752802685033315,2021-12-01 17:06:23 UTC
802798,mainnet,253,109296000,109599227,303228,279724,23504,0.07751263075969238,2021-12-01 17:08:46 UTC
802799,mainnet,253,109296000,109599468,303469,279960,23509,0.0774675502275356,2021-12-01 17:10:59 UTC
802800,mainnet,253,109296000,109599705,303706,280188,23518,0.07743673157593199,2021-12-01 17:13:23 UTC
802802,mainnet,253,109296000,109599915,303916,280381,23535,0.0774391608207531,2021-12-01 17:15:30 UTC
802803,mainnet,253,109296000,109600115,304116,280571,23545,0.07742111562693182,2021-12-01 17:17:44 UTC
802804,mainnet,253,109296000,109600323,304324,280753,23571,0.07745363494170686,2021-12-01 17:19:53 UTC
802806,mainnet,253,109296000,109600556,304557,280957,23600,0.07748959964801334,2021-12-01 17:22:09 UTC
802807,mainnet,253,109296000,109600780,304781,281139,23642,0.0775704522263527,2021-12-01 17:24:21 UTC
802809,mainnet,253,109296000,109601025,305026,281341,23685,0.07764911843580548,2021-12-01 17:26:37 UTC
802810,mainnet,253,109296000,109601249,305250,281558,23692,0.07761506961506962,2021-12-01 17:28:49 UTC
802812,mainnet,253,109296000,109601468,305469,281754,23715,0.07763471907132966,2021-12-01 17:31:07 UTC
802813,mainnet,253,109296000,109601697,305698,281976,23722,0.07759946090586134,2021-12-01 17:33:26 UTC
802815,mainnet,253,109296000,109601914,305915,282177,23738,0.07759671804259353,2021-12-01 17:35:34 UTC
802816,mainnet,253,109296000,109602121,306122,282380,23742,0.07755731375072683,2021-12-01 17:37:50 UTC
802818,mainnet,253,109296000,109602335,306336,282567,23769,0.0775912723284237,2021-12-01 17:39:59 UTC
802819,mainnet,253,109296000,109602574,306575,282785,23790,0.07759928239419392,2021-12-01 17:42:17 UTC
802821,mainnet,253,109296000,109602815,306816,283023,23793,0.07754810700876096,2021-12-01 17:44:30 UTC
802822,mainnet,253,109296000,109603053,307054,283245,23809,0.07754010695187166,2021-12-01 17:46:50 UTC
802824,mainnet,253,109296000,109603278,307279,283443,23836,0.07757119751105673,2021-12-01 17:48:55 UTC
802825,mainnet,253,109296000,109603497,307498,283653,23845,0.07754521980630769,2021-12-01 17:51:07 UTC
802826,mainnet,253,109296000,109603712,307713,283849,23864,0.07755278457523732,2021-12-01 17:53:15 UTC
802827,mainnet,253,109296000,109603915,307916,284032,23884,0.07756660907520233,2021-12-01 17:55:26 UTC
802829,mainnet,253,109296000,109604098,308099,284193,23906,0.07759194284953862,2021-12-01 17:57:41 UTC
802830,mainnet,253,109296000,109604367,308368,284435,23933,0.07761181445545581,2021-12-01 17:59:55 UTC
802831,mainnet,253,109296000,109604598,308599,284629,23970,0.07767361527419078,2021-12-01 18:02:15 UTC
802833,mainnet,253,109296000,109604810,308811,284828,23983,0.07766238896930484,2021-12-01 18:04:24 UTC
802834,mainnet,253,109296000,109605040,309041,285041,24000,0.07765959856459176,2021-12-01 18:06:38 UTC
802836,mainnet,253,109296000,109605249,309250,285222,24028,0.07769765561843169,2021-12-01 18:08:43 UTC
802837,mainnet,253,109296000,109605377,309378,285344,24034,0.07768490325750377,2021-12-01 18:11:02 UTC
802839,mainnet,253,109296000,109605694,309695,285638,24057,0.07767965256139105,2021-12-01 18:13:34 UTC
802840,mainnet,253,109296000,109605980,309981,285881,24100,0.07774670060423058,2021-12-01 18:16:01 UTC
802842,mainnet,253,109296000,109606170,310171,286054,24117,0.07775388414777655,2021-12-01 18:18:17 UTC
802843,mainnet,253,109296000,109606428,310429,286283,24146,0.07778268138608184,2021-12-01 18:20:33 UTC
802845,mainnet,253,109296000,109606690,310691,286518,24173,0.07780399174742751,2021-12-01 18:23:13 UTC
802846,mainnet,253,109296000,109606981,310982,286790,24192,0.07779228379777607,2021-12-01 18:25:52 UTC
802848,mainnet,253,109296000,109607283,311284,287048,24236,0.07785816167872425,2021-12-01 18:28:44 UTC
802850,mainnet,253,109296000,109607547,311548,287299,24249,0.07783391323327385,2021-12-01 18:31:19 UTC
802851,mainnet,253,109296000,109607794,311795,287531,24264,0.07782036273833769,2021-12-01 18:33:42 UTC
802853,mainnet,253,109296000,109608021,312022,287747,24275,0.07779900135246874,2021-12-01 18:35:54 UTC
802854,mainnet,253,109296000,109608285,312286,287989,24297,0.07780367996003663,2021-12-01 18:38:21 UTC
802856,mainnet,253,109296000,109608544,312545,288229,24316,0.07779999680046074,2021-12-01 18:40:48 UTC
802857,mainnet,253,109296000,109608776,312777,288426,24351,0.07785419004594328,2021-12-01 18:43:01 UTC
802859,mainnet,253,109296000,109608968,312969,288607,24362,0.07784157536369417,2021-12-01 18:45:13 UTC
802860,mainnet,253,109296000,109609234,313235,288844,24391,0.07786805433620125,2021-12-01 18:47:34 UTC
802861,mainnet,253,109296000,109609459,313460,289049,24411,0.07787596503541122,2021-12-01 18:49:44 UTC
802863,mainnet,253,109296000,109609679,313680,289262,24418,0.077843662331038,2021-12-01 18:51:58 UTC
802864,mainnet,253,109296000,109609920,313921,289486,24435,0.07783805479722605,2021-12-01 18:54:27 UTC
802866,mainnet,253,109296000,109610171,314172,289699,24473,0.07789682084972563,2021-12-01 18:56:50 UTC
802867,mainnet,253,109296000,109610388,314389,289905,24484,0.0778780428068412,2021-12-01 18:58:57 UTC
802869,mainnet,253,109296000,109610633,314634,290130,24504,0.07788096645626347,2021-12-01 19:01:11 UTC
802870,mainnet,253,109296000,109610948,314949,290409,24540,0.07791737709914939,2021-12-01 19:04:27 UTC
802872,mainnet,253,109296000,109611184,315185,290629,24556,0.07790979900693244,2021-12-01 19:06:55 UTC
802873,mainnet,253,109296000,109611435,315436,290854,24582,0.07793022990400589,2021-12-01 19:09:24 UTC
802874,mainnet,253,109296000,109611604,315605,291010,24595,0.07792969059425547,2021-12-01 19:11:05 UTC
802876,mainnet,253,109296000,109611843,315844,291218,24626,0.07796887070832437,2021-12-01 19:13:35 UTC
802878,mainnet,253,109296000,109612120,316121,291468,24653,0.07798596107186805,2021-12-01 19:16:09 UTC
802879,mainnet,253,109296000,109612391,316392,291716,24676,0.07799185820121875,2021-12-01 19:18:52 UTC
802881,mainnet,253,109296000,109612613,316614,291928,24686,0.07796875690904383,2021-12-01 19:21:21 UTC
802882,mainnet,253,109296000,109612892,316893,292175,24718,0.07800109185119268,2021-12-01 19:23:57 UTC
802884,mainnet,253,109296000,109613108,317109,292381,24728,0.07797949600925864,2021-12-01 19:26:11 UTC
802885,mainnet,253,109296000,109613381,317382,292621,24761,0.07801639664505233,2021-12-01 19:29:08 UTC
802886,mainnet,253,109296000,109613605,317606,292821,24785,0.0780369388487623,2021-12-01 19:31:30 UTC
802888,mainnet,253,109296000,109613858,317859,293043,24816,0.07807235283569129,2021-12-01 19:33:56 UTC
802889,mainnet,253,109296000,109614091,318092,293244,24848,0.07811576525030495,2021-12-01 19:37:01 UTC
802891,mainnet,253,109296000,109614371,318372,293476,24896,0.07819783146759138,2021-12-01 19:39:37 UTC
802893,mainnet,253,109296000,109614597,318598,293685,24913,0.0781957199982423,2021-12-01 19:42:04 UTC
802894,mainnet,253,109296000,109614853,318854,293917,24937,0.07820820814542079,2021-12-01 19:44:27 UTC
802896,mainnet,253,109296000,109615082,319083,294125,24958,0.07821789315005813,2021-12-01 19:46:57 UTC
802897,mainnet,253,109296000,109615294,319295,294304,24991,0.07826931207817223,2021-12-01 19:49:11 UTC
802899,mainnet,253,109296000,109615524,319525,294507,25018,0.07829747281120412,2021-12-01 19:51:37 UTC
802900,mainnet,253,109296000,109615741,319742,294678,25064,0.07838820048664236,2021-12-01 19:54:04 UTC
802902,mainnet,253,109296000,109615981,319982,294895,25087,0.07840128507228532,2021-12-01 19:56:41 UTC
802903,mainnet,253,109296000,109616214,320215,295106,25109,0.07841294130506066,2021-12-01 19:59:09 UTC
802905,mainnet,253,109296000,109616432,320433,295318,25115,0.0783783193366476,2021-12-01 20:01:35 UTC
802906,mainnet,253,109296000,109616642,320643,295499,25144,0.07841742997664068,2021-12-01 20:03:52 UTC
802907,mainnet,253,109296000,109616886,320887,295705,25182,0.07847622371738337,2021-12-01 20:06:09 UTC
802909,mainnet,253,109296000,109617105,321106,295887,25219,0.07853792828536371,2021-12-01 20:08:25 UTC
802910,mainnet,253,109296000,109617288,321289,296050,25239,0.07855544385273072,2021-12-01 20:10:35 UTC
802912,mainnet,253,109296000,109617419,321420,296170,25250,0.07855765042623358,2021-12-01 20:13:03 UTC
802913,mainnet,253,109296000,109617750,321751,296465,25286,0.07858872233497331,2021-12-01 20:15:26 UTC
802915,mainnet,253,109296000,109618016,322017,296702,25315,0.07861386200107448,2021-12-01 20:18:09 UTC
802916,mainnet,253,109296000,109618320,322321,296944,25377,0.07873207144430552,2021-12-01 20:20:47 UTC
802918,mainnet,253,109296000,109618536,322537,297144,25393,0.07872895202720928,2021-12-01 20:23:03 UTC
802919,mainnet,253,109296000,109618759,322760,297327,25433,0.0787984880406494,2021-12-01 20:25:27 UTC
802920,mainnet,253,109296000,109618949,322950,297477,25473,0.07887598699489085,2021-12-01 20:28:08 UTC
802922,mainnet,253,109296000,109619213,323214,297681,25533,0.07899719690359948,2021-12-01 20:31:00 UTC
802923,mainnet,253,109296000,109619482,323483,297897,25586,0.0790953465869922,2021-12-01 20:33:20 UTC
802925,mainnet,253,109296000,109619721,323722,298121,25601,0.0790832875121246,2021-12-01 20:35:38 UTC
802926,mainnet,253,109296000,109619980,323981,298348,25633,0.07911883721576266,2021-12-01 20:38:10 UTC
802928,mainnet,253,109296000,109620210,324211,298562,25649,0.07911205973887375,2021-12-01 20:40:38 UTC
802929,mainnet,253,109296000,109620385,324386,298720,25666,0.07912178700683753,2021-12-01 20:42:49 UTC
802931,mainnet,253,109296000,109620626,324627,298904,25723,0.07923863387826643,2021-12-01 20:45:02 UTC
802932,mainnet,253,109296000,109620884,324885,299125,25760,0.07928959477969127,2021-12-01 20:47:39 UTC
802934,mainnet,253,109296000,109621093,325094,299299,25795,0.0793462813832307,2021-12-01 20:49:53 UTC
802935,mainnet,253,109296000,109621308,325309,299490,25819,0.07936761663526062,2021-12-01 20:52:08 UTC
802937,mainnet,253,109296000,109621493,325494,299657,25837,0.079377807271409,2021-12-01 20:54:13 UTC
802938,mainnet,253,109296000,109621710,325711,299854,25857,0.07938632714277381,2021-12-01 20:56:32 UTC
802940,mainnet,253,109296000,109621829,325830,299958,25872,0.07940336985544609,2021-12-01 20:58:44 UTC
802941,mainnet,253,109296000,109622170,326171,300249,25922,0.07947365032452303,2021-12-01 21:01:19 UTC
802943,mainnet,253,109296000,109622365,326366,300419,25947,0.07950276683232935,2021-12-01 21:03:34 UTC
802944,mainnet,253,109296000,109622585,326586,300612,25974,0.07953188440410795,2021-12-01 21:05:46 UTC
802946,mainnet,253,109296000,109622785,326786,300779,26007,0.07958419271327413,2021-12-01 21:07:55 UTC
802947,mainnet,253,109296000,109623016,327017,300986,26031,0.0796013662898259,2021-12-01 21:10:13 UTC
802949,mainnet,253,109296000,109623227,327228,301177,26051,0.07961115796936692,2021-12-01 21:12:38 UTC
802950,mainnet,253,109296000,109623457,327458,301380,26078,0.07963769399434431,2021-12-01 21:15:12 UTC
802952,mainnet,253,109296000,109623671,327672,301571,26101,0.0796558753875827,2021-12-01 21:17:42 UTC
802953,mainnet,253,109296000,109623932,327933,301800,26133,0.07969005864002708,2021-12-01 21:20:25 UTC
802955,mainnet,253,109296000,109624188,328189,302018,26171,0.07974368427948529,2021-12-01 21:22:43 UTC
802956,mainnet,253,109296000,109624409,328410,302222,26188,0.07974178618190676,2021-12-01 21:25:00 UTC
802958,mainnet,253,109296000,109624613,328614,302418,26196,0.07971662801950008,2021-12-01 21:27:32 UTC
802960,mainnet,253,109296000,109624912,328913,302673,26240,0.07977793519866956,2021-12-01 21:30:10 UTC
802961,mainnet,253,109296000,109625155,329156,302906,26250,0.07974941972803169,2021-12-01 21:32:30 UTC
802963,mainnet,253,109296000,109625357,329358,303095,26263,0.07973997898942792,2021-12-01 21:34:49 UTC
802964,mainnet,253,109296000,109625593,329594,303301,26293,0.0797739036511587,2021-12-01 21:37:03 UTC
802966,mainnet,253,109296000,109625869,329870,303560,26310,0.079758692818383,2021-12-01 21:39:44 UTC
802967,mainnet,253,109296000,109626142,330143,303808,26335,0.07976846396864389,2021-12-01 21:42:29 UTC
802969,mainnet,253,109296000,109626371,330372,304029,26343,0.07973738694562493,2021-12-01 21:44:53 UTC
802971,mainnet,253,109363796,109626644,262849,242419,20430,0.07772523387952779,2021-12-01 21:47:38 UTC
802972,mainnet,253,109296000,109626893,330894,304520,26374,0.07970528326291804,2021-12-01 21:50:05 UTC
802974,mainnet,253,109296000,109627211,331212,304806,26406,0.07972537226912069,2021-12-01 21:53:01 UTC
802975,mainnet,253,109296000,109627408,331409,304981,26428,0.07974436421461095,2021-12-01 21:55:19 UTC
802977,mainnet,253,109296000,109627644,331645,305172,26473,0.07982330504002774,2021-12-01 21:57:48 UTC
802978,mainnet,253,109296000,109627905,331906,305384,26522,0.0799081667701096,2021-12-01 22:00:25 UTC
802980,mainnet,253,109296000,109628133,332134,305582,26552,0.0799436372066696,2021-12-01 22:02:56 UTC
802981,mainnet,253,109296000,109628376,332377,305796,26581,0.07997244093303689,2021-12-01 22:05:16 UTC
802983,mainnet,253,109296000,109628595,332596,305979,26617,0.08002802198463001,2021-12-01 22:07:36 UTC
802984,mainnet,253,109296000,109628862,332863,306217,26646,0.0800509518931212,2021-12-01 22:10:08 UTC
802986,mainnet,253,109296000,109629112,333113,306443,26670,0.08006292159117176,2021-12-01 22:12:45 UTC
802987,mainnet,253,109296000,109629335,333336,306646,26690,0.08006935944512444,2021-12-01 22:15:08 UTC
802989,mainnet,253,109296000,109629574,333575,306862,26713,0.08008094131754478,2021-12-01 22:17:37 UTC
802990,mainnet,253,109296000,109629804,333805,307063,26742,0.08011264061353185,2021-12-01 22:19:52 UTC
802991,mainnet,253,109296000,109630039,334040,307287,26753,0.08008921087294935,2021-12-01 22:22:10 UTC
802992,mainnet,253,109296000,109630270,334271,307498,26773,0.08009369643193696,2021-12-01 22:24:32 UTC
802994,mainnet,253,109296000,109630513,334514,307729,26785,0.08007138714672629,2021-12-01 22:26:49 UTC
802995,mainnet,253,109296000,109630755,334756,307953,26803,0.08006727287935093,2021-12-01 22:29:11 UTC
802997,mainnet,253,109296000,109631010,335011,308189,26822,0.08006304270606039,2021-12-01 22:31:26 UTC
802998,mainnet,253,109296000,109631250,335251,308416,26835,0.08004450396866825,2021-12-01 22:33:37 UTC
803000,mainnet,253,109296000,109631471,335472,308621,26851,0.08003946678113226,2021-12-01 22:35:54 UTC
803001,mainnet,253,109296000,109631720,335721,308852,26869,0.08003371847456668,2021-12-01 22:38:06 UTC
803003,mainnet,253,109296000,109631960,335961,309076,26885,0.08002416947205182,2021-12-01 22:40:25 UTC
803004,mainnet,253,109296000,109632207,336208,309296,26912,0.08004568600390234,2021-12-01 22:42:52 UTC
803006,mainnet,253,109296000,109632464,336465,309531,26934,0.080049930899202,2021-12-01 22:45:26 UTC
803007,mainnet,253,109296000,109632740,336741,309777,26964,0.08007340953433054,2021-12-01 22:48:04 UTC
803009,mainnet,253,109296000,109632996,336997,310003,26994,0.08010160327836746,2021-12-01 22:50:33 UTC
803010,mainnet,253,109296000,109633270,337271,310255,27016,0.08010175793353119,2021-12-01 22:52:59 UTC
803012,mainnet,253,109296000,109633525,337526,310498,27028,0.0800767940840113,2021-12-01 22:55:24 UTC
803013,mainnet,253,109296000,109633718,337719,310664,27055,0.08011097983826791,2021-12-01 22:57:34 UTC
803015,mainnet,253,109296000,109633976,337977,310891,27086,0.08014154809350932,2021-12-01 22:59:48 UTC
803016,mainnet,253,109296000,109634267,338268,311167,27101,0.08011694869157,2021-12-01 23:03:00 UTC
803018,mainnet,253,109296000,109634608,338609,311491,27118,0.08008647141688496,2021-12-01 23:06:20 UTC
803019,mainnet,253,109296000,109634974,338975,311819,27156,0.08011210266243823,2021-12-01 23:09:51 UTC
803021,mainnet,253,109296000,109635333,339334,312148,27186,0.08011575615764999,2021-12-01 23:13:11 UTC
803022,mainnet,253,109296000,109635652,339653,312431,27222,0.08014650245986345,2021-12-01 23:16:23 UTC
803024,mainnet,253,109296000,109635945,339946,312704,27242,0.08013625693492496,2021-12-01 23:19:42 UTC
803025,mainnet,253,109296000,109636240,340241,312981,27260,0.08011967987397169,2021-12-01 23:23:16 UTC
803027,mainnet,253,109296000,109636688,340689,313385,27304,0.08014347396012199,2021-12-01 23:26:32 UTC
803028,mainnet,253,109296000,109637059,341060,313726,27334,0.08014425614261421,2021-12-01 23:30:06 UTC
803030,mainnet,253,109296000,109637397,341398,314039,27359,0.08013813789184471,2021-12-01 23:33:23 UTC
803031,mainnet,253,109296000,109637757,341758,314380,27378,0.08010931711913108,2021-12-01 23:36:41 UTC
803032,mainnet,253,109296000,109638101,342102,314705,27397,0.08008430234257619,2021-12-01 23:40:25 UTC
803033,mainnet,253,109296000,109638464,342465,315044,27421,0.08006949615289154,2021-12-01 23:43:45 UTC
803035,mainnet,253,109296000,109638773,342774,315318,27456,0.08009942411034676,2021-12-01 23:47:10 UTC
803036,mainnet,253,109296000,109639132,343133,315651,27482,0.08009139313327485,2021-12-01 23:50:28 UTC
803037,mainnet,253,109296000,109639471,343472,315960,27512,0.08009968789304514,2021-12-01 23:53:48 UTC
803038,mainnet,253,109296000,109639853,343854,316307,27547,0.08011248960314551,2021-12-01 23:57:20 UTC
803040,mainnet,253,109296000,109640199,344200,316626,27574,0.08011040092969204,2021-12-02 00:00:33 UTC
803041,mainnet,253,109296000,109640538,344539,316950,27589,0.08007511486362937,2021-12-02 00:04:01 UTC
803043,mainnet,253,109296000,109640879,344880,317237,27643,0.08015251681744374,2021-12-02 00:07:20 UTC
803044,mainnet,253,109296000,109641138,345139,317473,27666,0.0801590083995144,2021-12-02 00:10:31 UTC
803045,mainnet,253,109296000,109641503,345504,317788,27716,0.08021904232657219,2021-12-02 00:14:06 UTC
803047,mainnet,253,109296000,109641832,345833,318091,27742,0.08021790864376736,2021-12-02 00:17:21 UTC
803048,mainnet,253,109296000,109642220,346221,318453,27768,0.08020310726385747,2021-12-02 00:21:04 UTC
803049,mainnet,253,109296000,109642560,346561,318751,27810,0.08024561332636967,2021-12-02 00:24:27 UTC
803051,mainnet,253,109296000,109642923,346924,319089,27835,0.08023371112981517,2021-12-02 00:28:01 UTC
803052,mainnet,253,109296000,109643254,347255,319376,27879,0.0802839411959511,2021-12-02 00:31:16 UTC
803053,mainnet,253,109296000,109643643,347644,319716,27928,0.08033505540150268,2021-12-02 00:34:45 UTC
803055,mainnet,253,109296000,109643900,347901,319957,27944,0.08032170071370878,2021-12-02 00:38:04 UTC
803056,mainnet,253,109296000,109644260,348261,320286,27975,0.08032768527052986,2021-12-02 00:40:40 UTC
803058,mainnet,253,109296000,109644551,348552,320568,27984,0.08028644219513875,2021-12-02 00:43:57 UTC
803059,mainnet,253,109296000,109644893,348894,320878,28016,0.08029946058115073,2021-12-02 00:47:11 UTC
803061,mainnet,253,109296000,109645262,349263,321156,28107,0.08047517200505064,2021-12-02 00:50:29 UTC
803062,mainnet,253,109296000,109645588,349589,321445,28144,0.08050596557672009,2021-12-02 00:53:42 UTC
803064,mainnet,253,109296000,109645935,349936,321757,28179,0.08052615335375611,2021-12-02 00:57:24 UTC
803065,mainnet,253,109296000,109646328,350329,322107,28222,0.08055856066725849,2021-12-02 01:00:50 UTC
803067,mainnet,253,109296000,109646700,350701,322460,28241,0.0805272867770551,2021-12-02 01:04:25 UTC
803068,mainnet,253,109296000,109647077,351078,322797,28281,0.08055474851742347,2021-12-02 01:08:08 UTC
803069,mainnet,253,109296000,109647456,351457,323155,28302,0.0805276321143127,2021-12-02 01:11:37 UTC
803070,mainnet,253,109296000,109647808,351809,323490,28319,0.0804953824376295,2021-12-02 01:15:06 UTC
803071,mainnet,253,109296000,109648200,352201,323838,28363,0.0805307196742769,2021-12-02 01:19:06 UTC
803073,mainnet,253,109296000,109648430,352431,324047,28384,0.08053775065190065,2021-12-02 01:22:26 UTC
803074,mainnet,253,109296000,109648838,352839,324417,28422,0.08055231989661008,2021-12-02 01:25:52 UTC
803076,mainnet,253,109296000,109649150,353151,324690,28461,0.0805915883007552,2021-12-02 01:29:24 UTC
803077,mainnet,253,109296000,109649499,353500,325005,28495,0.0806082036775106,2021-12-02 01:32:58 UTC
803079,mainnet,253,109296000,109649833,353834,325325,28509,0.0805716805055478,2021-12-02 01:36:17 UTC
803080,mainnet,253,109296000,109650139,354140,325606,28534,0.08057265488224996,2021-12-02 01:39:35 UTC
803082,mainnet,253,109296000,109650511,354512,325956,28556,0.0805501647334928,2021-12-02 01:43:01 UTC
803083,mainnet,253,109296000,109650846,354847,326272,28575,0.08052766403548571,2021-12-02 01:46:25 UTC
803085,mainnet,253,109296000,109651183,355184,326576,28608,0.08054416865624578,2021-12-02 01:49:37 UTC
803086,mainnet,253,109296000,109651573,355574,326950,28624,0.08050082401975397,2021-12-02 01:52:57 UTC
803088,mainnet,253,109296000,109651921,355922,327276,28646,0.08048392625350498,2021-12-02 01:56:12 UTC
803089,mainnet,253,109296000,109652272,356273,327591,28682,0.0805056796333149,2021-12-02 01:59:33 UTC
803090,mainnet,253,109296000,109652636,356637,327920,28717,0.08052165086628701,2021-12-02 02:03:06 UTC
803092,mainnet,253,109296000,109652973,356974,328213,28761,0.08056889297259745,2021-12-02 02:06:25 UTC
803093,mainnet,253,109296000,109653318,357319,328545,28774,0.08052748384496766,2021-12-02 02:09:39 UTC
803095,mainnet,253,109296000,109653671,357672,328877,28795,0.08050672124180813,2021-12-02 02:13:00 UTC
803096,mainnet,253,109296000,109654003,358004,329185,28819,0.08049910056870872,2021-12-02 02:16:22 UTC
803098,mainnet,253,109296000,109654393,358394,329542,28852,0.08050357985903782,2021-12-02 02:20:09 UTC
803099,mainnet,253,109296000,109654756,358757,329860,28897,0.08054755726020676,2021-12-02 02:23:33 UTC
803101,mainnet,253,109296000,109655165,359166,330245,28921,0.08052265526246917,2021-12-02 02:27:06 UTC
803102,mainnet,253,109296000,109655496,359497,330554,28943,0.0805097121811865,2021-12-02 02:30:23 UTC
803104,mainnet,253,109296000,109655919,359920,330945,28975,0.08050400088908646,2021-12-02 02:34:06 UTC
803105,mainnet,253,109296000,109656301,360302,331321,28981,0.08043530149707745,2021-12-02 02:37:32 UTC
803106,mainnet,253,109296000,109656627,360628,331635,28993,0.08039586499107113,2021-12-02 02:40:46 UTC
803107,mainnet,253,109296000,109657028,361029,332005,29024,0.08039243384880439,2021-12-02 02:44:38 UTC
803109,mainnet,253,109296000,109657346,361347,332294,29053,0.08040194051700997,2021-12-02 02:47:59 UTC
803110,mainnet,253,109296000,109657716,361717,332648,29069,0.08036393091836988,2021-12-02 02:51:15 UTC
803112,mainnet,253,109296000,109658047,362048,332956,29092,0.08035398621177302,2021-12-02 02:54:27 UTC
803113,mainnet,253,109296000,109658364,362365,333243,29122,0.08036648131028107,2021-12-02 02:57:48 UTC
803115,mainnet,253,109296000,109658785,362786,333636,29150,0.08035039940901799,2021-12-02 03:01:12 UTC
803116,mainnet,253,109296000,109659131,363132,333957,29175,0.08034268530451737,2021-12-02 03:04:32 UTC
803118,mainnet,253,109296000,109659347,363348,334154,29194,0.08034721534176602,2021-12-02 03:07:52 UTC
803119,mainnet,253,109296000,109659780,363781,334502,29279,0.08048523699698445,2021-12-02 03:11:13 UTC
803120,mainnet,253,109296000,109660062,364063,334743,29320,0.0805355117108852,2021-12-02 03:14:28 UTC
803121,mainnet,253,109296000,109660408,364409,335043,29366,0.08058527643389708,2021-12-02 03:17:42 UTC
803123,mainnet,253,109296000,109660720,364721,335318,29403,0.080617787294946,2021-12-02 03:21:04 UTC
803124,mainnet,253,109296000,109660976,364977,335547,29430,0.08063521810963431,2021-12-02 03:24:19 UTC
803125,mainnet,253,109296000,109661308,365309,335853,29456,0.08063310786211125,2021-12-02 03:27:03 UTC
803126,mainnet,253,109296000,109661660,365661,336158,29503,0.0806840215390758,2021-12-02 03:30:33 UTC
803127,mainnet,253,109296000,109661979,365980,336450,29530,0.08068746926061533,2021-12-02 03:33:53 UTC
803129,mainnet,253,109296000,109662308,366309,336730,29579,0.08074876675156767,2021-12-02 03:37:09 UTC
803130,mainnet,253,109296000,109662642,366643,337021,29622,0.08079248751510325,2021-12-02 03:40:26 UTC
803131,mainnet,253,109296000,109662988,366989,337333,29656,0.08080896157650502,2021-12-02 03:43:47 UTC
803132,mainnet,253,109296000,109663327,367328,337640,29688,0.08082150013067341,2021-12-02 03:47:08 UTC
803134,mainnet,253,109296000,109663664,367665,337935,29730,0.08086165395128718,2021-12-02 03:50:38 UTC
803135,mainnet,253,109296000,109663996,367997,338247,29750,0.08084305035095395,2021-12-02 03:54:12 UTC
803137,mainnet,253,109296000,109664340,368341,338553,29788,0.08087071490819649,2021-12-02 03:57:33 UTC
803138,mainnet,253,109296000,109664703,368704,338899,29805,0.08083720274257941,2021-12-02 04:01:03 UTC
803140,mainnet,253,109296000,109665034,369035,339207,29828,0.08082702182719796,2021-12-02 04:04:18 UTC
803141,mainnet,253,109296000,109665393,369394,339525,29869,0.08085946171296772,2021-12-02 04:07:44 UTC
803143,mainnet,253,109296000,109665735,369736,339855,29881,0.08081712356924942,2021-12-02 04:11:05 UTC
803144,mainnet,253,109296000,109666087,370088,340189,29899,0.08078889345236809,2021-12-02 04:14:28 UTC
803146,mainnet,253,109296000,109666385,370386,340470,29916,0.08076979151479807,2021-12-02 04:18:02 UTC
803147,mainnet,253,109296000,109666821,370822,340881,29941,0.08074224290899677,2021-12-02 04:21:51 UTC
803149,mainnet,253,109296000,109667197,371198,341232,29966,0.08072780564550455,2021-12-02 04:25:20 UTC
803150,mainnet,253,109296000,109667546,371547,341566,29981,0.08069234847811986,2021-12-02 04:28:47 UTC
803152,mainnet,253,109296000,109667910,371911,341894,30017,0.08071016990624101,2021-12-02 04:31:59 UTC
803153,mainnet,253,109296000,109668261,372262,342218,30044,0.0807065991156766,2021-12-02 04:35:27 UTC
803154,mainnet,253,109296000,109668612,372613,342562,30051,0.0806493600599013,2021-12-02 04:39:00 UTC
803156,mainnet,253,109296000,109669032,373033,342949,30084,0.08064702050488831,2021-12-02 04:42:39 UTC
803157,mainnet,253,109296000,109669365,373366,343261,30105,0.08063133761510154,2021-12-02 04:46:01 UTC
803159,mainnet,253,109296000,109669741,373742,343609,30133,0.08062513712668097,2021-12-02 04:49:39 UTC
803160,mainnet,253,109296000,109670127,374128,343966,30162,0.08061946713424283,2021-12-02 04:53:02 UTC
803162,mainnet,253,109296000,109670420,374421,344254,30167,0.08056973300108701,2021-12-02 04:56:26 UTC
803163,mainnet,253,109296000,109670912,374913,344707,30206,0.08056802511516005,2021-12-02 05:00:15 UTC
803164,mainnet,253,109296000,109671269,375270,345041,30229,0.08055266874517014,2021-12-02 05:03:46 UTC
803165,mainnet,253,109296000,109671683,375684,345345,30339,0.08075669977960201,2021-12-02 05:07:06 UTC
803167,mainnet,253,109296000,109672028,376029,345669,30360,0.0807384536830936,2021-12-02 05:10:28 UTC
803168,mainnet,253,109296000,109672380,376381,346003,30378,0.08071076914084399,2021-12-02 05:13:46 UTC
803169,mainnet,253,109296000,109672728,376729,346339,30390,0.08066806643502358,2021-12-02 05:17:08 UTC
803171,mainnet,253,109296000,109673101,377102,346700,30402,0.08062009748025734,2021-12-02 05:20:38 UTC
803172,mainnet,253,109296000,109673478,377479,347054,30425,0.08060051022705898,2021-12-02 05:24:15 UTC
803174,mainnet,253,109296000,109673872,377873,347418,30455,0.08059586157253892,2021-12-02 05:27:48 UTC
803175,mainnet,253,109296000,109674235,378236,347748,30488,0.08060575936716759,2021-12-02 05:31:06 UTC
803177,mainnet,253,109296000,109674597,378598,348101,30497,0.08055245933681636,2021-12-02 05:34:24 UTC
803178,mainnet,253,109296000,109674951,378952,348430,30522,0.08054318224999472,2021-12-02 05:37:59 UTC
803180,mainnet,253,109296000,109675331,379332,348788,30544,0.08052049392089251,2021-12-02 05:41:20 UTC
803182,mainnet,253,109296000,109675748,379749,349191,30558,0.08046894132703443,2021-12-02 05:45:11 UTC
803183,mainnet,253,109296000,109676145,380146,349551,30595,0.08048223577257159,2021-12-02 05:48:43 UTC
803184,mainnet,253,109296000,109676514,380515,349907,30608,0.0804383532843646,2021-12-02 05:51:54 UTC
803185,mainnet,253,109296000,109676921,380922,350305,30617,0.08037603498879035,2021-12-02 05:55:31 UTC
803186,mainnet,253,109296000,109677243,381244,350594,30650,0.08039470785113995,2021-12-02 05:58:40 UTC
803188,mainnet,253,109296000,109677621,381622,350954,30668,0.08036224326689761,2021-12-02 06:02:20 UTC
803189,mainnet,253,109296000,109678006,382007,351319,30688,0.08033360645223779,2021-12-02 06:05:30 UTC
803191,mainnet,253,109296000,109678353,382354,351657,30697,0.08028423921287603,2021-12-02 06:08:53 UTC
803192,mainnet,253,109296000,109678707,382708,351995,30713,0.08025178465043846,2021-12-02 06:12:06 UTC
803193,mainnet,253,109296000,109679066,383067,352332,30735,0.0802340060616028,2021-12-02 06:15:24 UTC
803195,mainnet,253,109296000,109679393,383394,352640,30754,0.08021513117054518,2021-12-02 06:18:32 UTC
803196,mainnet,253,109296000,109679726,383727,352951,30776,0.08020285254881726,2021-12-02 06:21:53 UTC
803198,mainnet,253,109296000,109680095,384096,353304,30792,0.08016745813546614,2021-12-02 06:25:17 UTC
803199,mainnet,253,109296000,109680436,384437,353622,30815,0.08015617643463038,2021-12-02 06:28:28 UTC
803200,mainnet,253,109296000,109680776,384777,353949,30828,0.08011913393991844,2021-12-02 06:31:50 UTC
803201,mainnet,253,109296000,109681112,385113,354255,30858,0.08012713151724299,2021-12-02 06:35:01 UTC
803203,mainnet,253,109296000,109681444,385445,354555,30890,0.08014113557057427,2021-12-02 06:38:23 UTC
803204,mainnet,253,109296000,109681746,385747,354843,30904,0.08011468656917617,2021-12-02 06:41:35 UTC
803206,mainnet,253,109296000,109682070,386071,355118,30953,0.08017437207145836,2021-12-02 06:44:55 UTC
803207,mainnet,253,109296000,109682408,386409,355427,30982,0.08017929189019925,2021-12-02 06:48:10 UTC
803208,mainnet,253,109296000,109682756,386757,355766,30991,0.08013041780756393,2021-12-02 06:51:26 UTC
803210,mainnet,253,109296000,109683070,387071,356049,31022,0.0801455030214095,2021-12-02 06:54:42 UTC
803211,mainnet,253,109296000,109683458,387459,356402,31057,0.0801555777514524,2021-12-02 06:58:25 UTC
803212,mainnet,253,109296000,109683793,387794,356713,31081,0.080148223025627,2021-12-02 07:01:49 UTC
803214,mainnet,253,109296000,109684138,388139,357042,31097,0.08011820507601658,2021-12-02 07:05:06 UTC
803215,mainnet,253,109296000,109684491,388492,357361,31131,0.08013292423009998,2021-12-02 07:08:26 UTC
803217,mainnet,253,109296000,109684824,388825,357668,31157,0.08013116440558092,2021-12-02 07:11:50 UTC
803218,mainnet,253,109296000,109685208,389209,358027,31182,0.08011633852249049,2021-12-02 07:15:36 UTC
803220,mainnet,253,109296000,109685555,389556,358339,31217,0.08013482015422686,2021-12-02 07:19:19 UTC
803221,mainnet,253,109296000,109685922,389923,358677,31246,0.08013377000074373,2021-12-02 07:22:35 UTC
803223,mainnet,253,109296000,109686266,390267,359016,31251,0.08007594800482747,2021-12-02 07:26:00 UTC
803224,mainnet,253,109296000,109686605,390606,359320,31286,0.08009605587215762,2021-12-02 07:29:22 UTC
803225,mainnet,253,109296000,109686962,390963,359661,31302,0.08006384235848404,2021-12-02 07:32:46 UTC
803226,mainnet,253,109296000,109687264,391265,359955,31310,0.08002249115049902,2021-12-02 07:36:18 UTC
803228,mainnet,253,109296000,109687682,391683,360333,31350,0.08003921538591156,2021-12-02 07:39:41 UTC
803229,mainnet,253,109296000,109688021,392022,360662,31360,0.07999551045604583,2021-12-02 07:42:55 UTC
803230,mainnet,253,109296000,109688435,392436,361040,31396,0.08000285396854519,2021-12-02 07:46:38 UTC
803231,mainnet,253,109296000,109688776,392777,361336,31441,0.0800479661487307,2021-12-02 07:50:02 UTC
803233,mainnet,253,109296000,109689158,393159,361695,31464,0.08002869068239567,2021-12-02 07:53:45 UTC
803234,mainnet,253,109296000,109689527,393528,362027,31501,0.0800476713219898,2021-12-02 07:57:29 UTC
803236,mainnet,253,109296000,109689880,393881,362354,31527,0.08004194160165126,2021-12-02 08:00:50 UTC
803237,mainnet,253,109296000,109690208,394209,362653,31556,0.08004890806653324,2021-12-02 08:04:19 UTC
803239,mainnet,253,109296000,109690552,394553,362975,31578,0.08003487490907432,2021-12-02 08:07:40 UTC
803240,mainnet,253,109296000,109690904,394905,363293,31612,0.08004963219002038,2021-12-02 08:11:00 UTC
803241,mainnet,253,109296000,109691248,395249,363619,31630,0.0800255029108233,2021-12-02 08:14:24 UTC
803242,mainnet,253,109296000,109691568,395569,363916,31653,0.08001890946965005,2021-12-02 08:17:44 UTC
803244,mainnet,253,109296000,109691909,395910,364219,31691,0.0800459700436968,2021-12-02 08:21:07 UTC
803245,mainnet,253,109296000,109692279,396280,364575,31705,0.0800065610174624,2021-12-02 08:24:58 UTC
803247,mainnet,253,109296000,109692624,396625,364895,31730,0.08,2021-12-02 08:28:16 UTC
803248,mainnet,253,109296000,109692954,396955,365193,31762,0.0800141073925256,2021-12-02 08:31:37 UTC
803250,mainnet,253,109296000,109693312,397313,365528,31785,0.079999899323707,2021-12-02 08:35:19 UTC
803251,mainnet,253,109296000,109693643,397644,365822,31822,0.08002635523231835,2021-12-02 08:38:38 UTC
803253,mainnet,253,109296000,109694006,398007,366141,31866,0.08006391847379568,2021-12-02 08:42:25 UTC
803254,mainnet,253,109296000,109694362,398363,366447,31916,0.08011788243386057,2021-12-02 08:46:02 UTC
803256,mainnet,253,109296000,109694680,398681,366726,31955,0.08015180056235437,2021-12-02 08:49:21 UTC
803257,mainnet,253,109296000,109695055,399056,367078,31978,0.08013411651497535,2021-12-02 08:52:56 UTC
803259,mainnet,253,109296000,109695416,399417,367417,32000,0.08011677019255566,2021-12-02 08:56:24 UTC
803260,mainnet,253,109296000,109695591,399592,367579,32013,0.08011421650083085,2021-12-02 08:58:10 UTC
803262,mainnet,253,109296000,109695764,399765,367718,32047,0.08016459670056159,2021-12-02 09:00:02 UTC
803263,mainnet,253,109296000,109695957,399958,367892,32066,0.08017341820891194,2021-12-02 09:01:38 UTC
803265,mainnet,253,109296000,109696135,400136,368060,32076,0.08016274466681328,2021-12-02 09:03:31 UTC
803266,mainnet,253,109296000,109696311,400312,368225,32087,0.0801549791162893,2021-12-02 09:05:12 UTC
803268,mainnet,253,109296000,109696451,400452,368354,32098,0.08015442549918592,2021-12-02 09:06:41 UTC
803270,mainnet,253,109296000,109696605,400606,368499,32107,0.08014607869078347,2021-12-02 09:08:10 UTC
803271,mainnet,253,109296000,109696764,400765,368646,32119,0.08014422417127244,2021-12-02 09:09:51 UTC
803272,mainnet,253,109296000,109696934,400935,368791,32144,0.0801725965555514,2021-12-02 09:11:35 UTC
803273,mainnet,253,109296000,109697111,401112,368942,32170,0.08020203833343306,2021-12-02 09:13:07 UTC
803275,mainnet,253,109296000,109697266,401267,369080,32187,0.0802134239795448,2021-12-02 09:14:38 UTC
803276,mainnet,253,109296000,109697426,401427,369233,32194,0.08019889045829005,2021-12-02 09:16:10 UTC
803278,mainnet,253,109296000,109697558,401559,369352,32207,0.08020490139680594,2021-12-02 09:17:39 UTC
803279,mainnet,253,109296000,109697765,401766,369537,32229,0.08021833604635534,2021-12-02 09:19:28 UTC
803280,mainnet,253,109296000,109697936,401937,369695,32242,0.0802165513500872,2021-12-02 09:21:09 UTC
803281,mainnet,253,109296000,109698087,402088,369834,32254,0.08021627106504049,2021-12-02 09:22:40 UTC
803282,mainnet,253,109296000,109698239,402240,369976,32264,0.08021081941129674,2021-12-02 09:24:10 UTC
803284,mainnet,253,109296000,109698391,402392,370113,32279,0.08021779757052824,2021-12-02 09:25:43 UTC
803285,mainnet,253,109296000,109698544,402545,370262,32283,0.08019724502850613,2021-12-02 09:27:15 UTC
803286,mainnet,253,109296000,109698727,402728,370422,32306,0.08021791382769512,2021-12-02 09:28:47 UTC
803287,mainnet,253,109296000,109698869,402870,370551,32319,0.08022190781145283,2021-12-02 09:30:18 UTC
803289,mainnet,253,109296000,109699020,403021,370681,32340,0.08024395751089894,2021-12-02 09:31:50 UTC
803290,mainnet,253,109296000,109699165,403166,370803,32363,0.08027214596468948,2021-12-02 09:33:22 UTC
803292,mainnet,253,109296000,109699308,403309,370940,32369,0.0802585610536834,2021-12-02 09:34:55 UTC
803293,mainnet,253,109296000,109699436,403437,371052,32385,0.08027275634113877,2021-12-02 09:36:30 UTC
803295,mainnet,253,109296000,109699612,403613,371211,32402,0.08027987205565727,2021-12-02 09:38:09 UTC
803296,mainnet,253,109296000,109699754,403755,371341,32414,0.08028135874478334,2021-12-02 09:39:36 UTC
803298,mainnet,253,109296000,109699860,403861,371441,32420,0.08027514417089048,2021-12-02 09:41:25 UTC
803300,mainnet,253,109296000,109700133,404134,371694,32440,0.08027040536059822,2021-12-02 09:43:09 UTC
803301,mainnet,253,109296000,109700322,404323,371841,32482,0.08033676046131434,2021-12-02 09:44:58 UTC
803303,mainnet,253,109296000,109700490,404491,371981,32510,0.08037261644882086,2021-12-02 09:46:55 UTC
803304,mainnet,253,109296000,109700636,404637,372097,32540,0.08041775715023589,2021-12-02 09:48:26 UTC
803306,mainnet,253,109296000,109700851,404852,372283,32569,0.08044668175036804,2021-12-02 09:50:29 UTC
803308,mainnet,253,109296000,109701020,405021,372440,32581,0.08044274247508154,2021-12-02 09:52:11 UTC
803309,mainnet,253,109296000,109701181,405182,372598,32584,0.0804181824464068,2021-12-02 09:54:03 UTC
803310,mainnet,253,109296000,109701354,405355,372767,32588,0.08039372895363324,2021-12-02 09:55:38 UTC
803312,mainnet,253,109296000,109701533,405534,372930,32604,0.08039769785024191,2021-12-02 09:57:29 UTC
803313,mainnet,253,109296000,109701685,405686,373068,32618,0.08040208437067091,2021-12-02 09:59:04 UTC
803315,mainnet,253,109296000,109701861,405862,373223,32639,0.0804189601391606,2021-12-02 10:00:48 UTC
803316,mainnet,253,109296000,109702005,406006,373355,32651,0.08041999379319517,2021-12-02 10:02:28 UTC
803318,mainnet,253,109296000,109702196,406197,373528,32669,0.08042649256395296,2021-12-02 10:04:11 UTC
803319,mainnet,253,109296000,109702345,406346,373670,32676,0.08041422826851993,2021-12-02 10:05:40 UTC
803321,mainnet,253,109296000,109702508,406509,373818,32691,0.0804188837147517,2021-12-02 10:07:16 UTC
803323,mainnet,253,109296000,109702652,406653,373951,32702,0.08041745665223175,2021-12-02 10:08:47 UTC
803324,mainnet,253,109296000,109702724,406725,374014,32711,0.08042534882291474,2021-12-02 10:10:18 UTC
803325,mainnet,253,109296000,109702984,406985,374249,32736,0.08043539688194896,2021-12-02 10:11:55 UTC
803326,mainnet,253,109296000,109703140,407141,374367,32774,0.080497911043103,2021-12-02 10:13:27 UTC
803328,mainnet,253,109296000,109703306,407307,374507,32800,0.08052893763181089,2021-12-02 10:14:58 UTC
803329,mainnet,253,109296000,109703453,407454,374639,32815,0.08053669862119404,2021-12-02 10:16:28 UTC
803331,mainnet,253,109296000,109703600,407601,374756,32845,0.08058125470742221,2021-12-02 10:17:59 UTC
803332,mainnet,253,109296000,109703761,407762,374884,32878,0.08063036771450012,2021-12-02 10:19:30 UTC
803333,mainnet,253,109296000,109703923,407924,375022,32902,0.08065718123964268,2021-12-02 10:21:04 UTC
803335,mainnet,253,109296000,109704061,408062,375147,32915,0.08066176218319765,2021-12-02 10:22:36 UTC
803336,mainnet,253,109296000,109704202,408203,375283,32920,0.08064614909738536,2021-12-02 10:24:06 UTC
803338,mainnet,253,109296000,109704365,408366,375419,32947,0.08068007620614841,2021-12-02 10:25:40 UTC
803339,mainnet,253,109296000,109704514,408515,375547,32968,0.08070205500410021,2021-12-02 10:27:12 UTC
803341,mainnet,253,109296000,109704651,408652,375674,32978,0.08069947045407828,2021-12-02 10:28:43 UTC
803343,mainnet,253,109296000,109704844,408845,375850,32995,0.08070295588792818,2021-12-02 10:30:33 UTC
803344,mainnet,253,109296000,109704993,408994,375990,33004,0.08069556032606835,2021-12-02 10:32:04 UTC
803345,mainnet,253,109296000,109705178,409179,376159,33020,0.08069817854777493,2021-12-02 10:34:05 UTC
803346,mainnet,253,109296000,109705364,409365,376338,33027,0.08067861199662893,2021-12-02 10:35:39 UTC
803348,mainnet,253,109296000,109705500,409501,376465,33036,0.08067379566838664,2021-12-02 10:37:11 UTC
803349,mainnet,253,109296000,109705665,409666,376610,33056,0.08069012317351208,2021-12-02 10:38:40 UTC
803351,mainnet,253,109296000,109705814,409815,376750,33065,0.08068274709320059,2021-12-02 10:40:34 UTC
803352,mainnet,253,109296000,109706015,410016,376922,33094,0.08071392335908843,2021-12-02 10:42:13 UTC
803353,mainnet,253,109296000,109706196,410197,377097,33100,0.08069293534569975,2021-12-02 10:43:54 UTC
803354,mainnet,253,109296000,109706359,410360,377256,33104,0.0806706306657569,2021-12-02 10:45:39 UTC
803356,mainnet,253,109296000,109706511,410512,377385,33127,0.08069678840082628,2021-12-02 10:47:08 UTC
803357,mainnet,253,109296000,109706645,410646,377512,33134,0.08068750213078905,2021-12-02 10:48:40 UTC
803359,mainnet,253,109296000,109706848,410849,377702,33147,0.08067927632779927,2021-12-02 10:50:21 UTC
803361,mainnet,253,109296000,109707006,411007,377850,33157,0.08067259195098866,2021-12-02 10:52:04 UTC
803362,mainnet,253,109296000,109707186,411187,378014,33173,0.0806761886927359,2021-12-02 10:53:35 UTC
803364,mainnet,253,109296000,109707350,411351,378163,33188,0.08068048941171894,2021-12-02 10:55:07 UTC
803365,mainnet,253,109296000,109707513,411514,378310,33204,0.080687412821921,2021-12-02 10:56:38 UTC
803367,mainnet,253,109296000,109707664,411665,378451,33214,0.08068210802472885,2021-12-02 10:58:11 UTC
803368,mainnet,253,109296000,109707819,411820,378594,33226,0.08068087999611481,2021-12-02 10:59:41 UTC
803369,mainnet,253,109296000,109707966,411967,378740,33227,0.08065451844443851,2021-12-02 11:01:15 UTC
803370,mainnet,253,109296000,109708115,412116,378882,33234,0.08064234341787264,2021-12-02 11:02:48 UTC
803371,mainnet,253,109296000,109708266,412267,379023,33244,0.08063706287430233,2021-12-02 11:04:16 UTC
803373,mainnet,253,109296000,109708397,412398,379145,33253,0.08063327174234598,2021-12-02 11:05:45 UTC
803374,mainnet,253,109296000,109708553,412554,379278,33276,0.08065853197399613,2021-12-02 11:07:19 UTC
803376,mainnet,253,109296000,109708691,412692,379397,33295,0.08067759975962703,2021-12-02 11:08:48 UTC
803377,mainnet,253,109296000,109708834,412835,379525,33310,0.08068598834885608,2021-12-02 11:10:22 UTC
803379,mainnet,253,109296000,109708976,412977,379661,33316,0.0806727735442894,2021-12-02 11:11:55 UTC
803381,mainnet,253,109296000,109709102,413103,379758,33345,0.08071836805832928,2021-12-02 11:13:24 UTC
803382,mainnet,253,109296000,109709230,413231,379862,33369,0.08075144410753307,2021-12-02 11:14:54 UTC
803383,mainnet,253,109296000,109709373,413374,379981,33393,0.0807815682650578,2021-12-02 11:16:24 UTC
803384,mainnet,253,109296000,109709528,413529,380109,33420,0.08081658118294001,2021-12-02 11:17:55 UTC
803386,mainnet,253,109296000,109709676,413677,380248,33429,0.08080942377748823,2021-12-02 11:19:28 UTC
803388,mainnet,253,109296000,109709883,413884,380441,33443,0.08080283364420948,2021-12-02 11:21:20 UTC
803389,mainnet,253,109296000,109710015,414016,380555,33461,0.080820547998145,2021-12-02 11:22:54 UTC
803391,mainnet,253,109296000,109710159,414160,380672,33488,0.0808576395595905,2021-12-02 11:24:10 UTC
803392,mainnet,253,109296000,109710343,414344,380837,33507,0.08086758828413106,2021-12-02 11:26:04 UTC
803394,mainnet,253,109296000,109710505,414506,380972,33534,0.08090112085229165,2021-12-02 11:27:48 UTC
803395,mainnet,253,109296000,109710651,414652,381101,33551,0.08091363360118847,2021-12-02 11:29:29 UTC
803397,mainnet,253,109296000,109710738,414739,381174,33565,0.0809304164787975,2021-12-02 11:30:58 UTC
803398,mainnet,253,109296000,109710973,414974,381376,33598,0.08096410859475534,2021-12-02 11:32:28 UTC
803400,mainnet,253,109296000,109711107,415108,381500,33608,0.0809620628848396,2021-12-02 11:33:57 UTC
803401,mainnet,253,109296000,109711267,415268,381633,33635,0.08099588699345965,2021-12-02 11:35:38 UTC
803403,mainnet,253,109296000,109711509,415510,381847,33663,0.0810161006955308,2021-12-02 11:37:54 UTC
803405,mainnet,253,109296000,109711704,415705,382015,33690,0.0810430473532914,2021-12-02 11:39:44 UTC
803406,mainnet,253,109296000,109711848,415849,382149,33700,0.08103903099442346,2021-12-02 11:41:13 UTC
803408,mainnet,253,109296000,109712022,416023,382310,33713,0.08103638500755968,2021-12-02 11:43:05 UTC
803410,mainnet,253,109296000,109712188,416189,382463,33726,0.0810352988666207,2021-12-02 11:44:42 UTC
803411,mainnet,253,109296000,109712328,416329,382594,33735,0.08102966644168434,2021-12-02 11:46:22 UTC
803413,mainnet,253,109296000,109712516,416517,382769,33748,0.08102430392997165,2021-12-02 11:48:07 UTC
803414,mainnet,253,109296000,109712639,416640,382885,33755,0.08101718509984639,2021-12-02 11:49:36 UTC
803416,mainnet,253,109296000,109712823,416824,383044,33780,0.08104139876782526,2021-12-02 11:51:08 UTC
803417,mainnet,253,109296000,109712977,416978,383176,33802,0.08106422880823448,2021-12-02 11:52:38 UTC
803418,mainnet,253,109296000,109713118,417119,383304,33815,0.08106799258724728,2021-12-02 11:54:09 UTC
803420,mainnet,253,109296000,109713270,417271,383445,33826,0.08106482357987974,2021-12-02 11:55:38 UTC
803421,mainnet,253,109296000,109713406,417407,383570,33837,0.08106476412709897,2021-12-02 11:57:09 UTC
803423,mainnet,253,109296000,109713564,417565,383712,33853,0.0810724078885922,2021-12-02 11:58:39 UTC
803424,mainnet,253,109296000,109713716,417717,383862,33855,0.08104769497051832,2021-12-02 12:00:14 UTC
803426,mainnet,253,109296000,109713884,417885,384023,33862,0.08103186283307609,2021-12-02 12:01:48 UTC
803427,mainnet,253,109296000,109714012,418013,384146,33867,0.08101901137045978,2021-12-02 12:03:21 UTC
803428,mainnet,253,109296000,109714170,418171,384296,33875,0.0810075304121998,2021-12-02 12:04:53 UTC
803430,mainnet,253,109296000,109714336,418337,384433,33904,0.08104470797467114,2021-12-02 12:06:24 UTC
803431,mainnet,253,109296000,109714461,418462,384550,33912,0.08103961650042298,2021-12-02 12:07:53 UTC
803432,mainnet,253,109296000,109714591,418592,384670,33922,0.08103833804754988,2021-12-02 12:09:23 UTC
803434,mainnet,253,109296000,109714756,418757,384817,33940,0.08104939141315846,2021-12-02 12:10:53 UTC
803435,mainnet,253,109296000,109714939,418940,384978,33962,0.08106650116961855,2021-12-02 12:12:39 UTC
803437,mainnet,253,109296000,109715087,419088,385109,33979,0.08107843698698125,2021-12-02 12:14:09 UTC
803438,mainnet,253,109296000,109715224,419225,385230,33995,0.08109010674458823,2021-12-02 12:15:38 UTC
803439,mainnet,253,109296000,109715358,419359,385351,34008,0.08109519528613908,2021-12-02 12:17:07 UTC
803441,mainnet,253,109296000,109715497,419498,385486,34012,0.08107785972757915,2021-12-02 12:18:41 UTC
803442,mainnet,253,109296000,109715644,419645,385615,34030,0.08109235186884152,2021-12-02 12:20:12 UTC
803444,mainnet,253,109296000,109715785,419786,385749,34037,0.08108178929263958,2021-12-02 12:21:50 UTC
803445,mainnet,253,109296000,109715930,419931,385891,34040,0.08106093620142357,2021-12-02 12:23:22 UTC
803447,mainnet,253,109296000,109716079,420080,386028,34052,0.08106075033326986,2021-12-02 12:24:55 UTC
803448,mainnet,253,109296000,109716219,420220,386141,34079,0.08109799628765885,2021-12-02 12:26:26 UTC
803450,mainnet,253,109296000,109716366,420367,386272,34095,0.08110769874895032,2021-12-02 12:27:53 UTC
803451,mainnet,253,109296000,109716520,420521,386400,34121,0.08113982417049327,2021-12-02 12:29:22 UTC
803452,mainnet,253,109296000,109716671,420672,386522,34150,0.08117963639129773,2021-12-02 12:30:53 UTC
803453,mainnet,253,109296000,109716816,420817,386654,34163,0.08118255678834267,2021-12-02 12:32:22 UTC
803454,mainnet,253,109296000,109716955,420956,386767,34189,0.0812175144195593,2021-12-02 12:33:53 UTC
803456,mainnet,253,109296000,109717089,421090,386885,34205,0.08122966586715429,2021-12-02 12:35:23 UTC
803457,mainnet,253,109296000,109717232,421233,387010,34223,0.08124482174948307,2021-12-02 12:36:55 UTC
803459,mainnet,253,109296000,109717372,421373,387131,34242,0.08126291907644771,2021-12-02 12:38:28 UTC
803460,mainnet,253,109296000,109717521,421522,387250,34272,0.08130536484453955,2021-12-02 12:40:00 UTC
803462,mainnet,253,109296000,109717637,421638,387351,34287,0.08131857185547792,2021-12-02 12:41:32 UTC
803463,mainnet,253,109296000,109717789,421790,387475,34315,0.08135565091633278,2021-12-02 12:43:02 UTC
803465,mainnet,253,109296000,109717946,421947,387595,34352,0.08141306846594477,2021-12-02 12:44:33 UTC
803466,mainnet,253,109296000,109718074,422075,387709,34366,0.08142154830302671,2021-12-02 12:46:01 UTC
803467,mainnet,253,109296000,109718236,422237,387848,34389,0.08144478101161196,2021-12-02 12:47:30 UTC
803469,mainnet,253,109296000,109718412,422413,388007,34406,0.08145109170409055,2021-12-02 12:49:23 UTC
803470,mainnet,253,109296000,109718583,422584,388168,34416,0.08144179618726691,2021-12-02 12:51:23 UTC
803472,mainnet,253,109296000,109718694,422695,388265,34430,0.08145353032328274,2021-12-02 12:52:54 UTC
803474,mainnet,253,109296000,109718900,422901,388428,34473,0.08151553200394418,2021-12-02 12:54:34 UTC
803475,mainnet,253,109296000,109719041,423042,388556,34486,0.08151909266692196,2021-12-02 12:56:07 UTC
803477,mainnet,253,109296000,109719215,423216,388716,34500,0.08151865713961665,2021-12-02 12:57:48 UTC
803478,mainnet,253,109296000,109719331,423332,388815,34517,0.08153647728024341,2021-12-02 12:59:27 UTC
803480,mainnet,253,109296000,109719576,423577,389024,34553,0.08157430644251222,2021-12-02 13:01:37 UTC
803481,mainnet,253,109296000,109719717,423718,389157,34561,0.08156604156538075,2021-12-02 13:03:16 UTC
803483,mainnet,253,109296000,109719852,423853,389270,34583,0.08159196702630393,2021-12-02 13:04:49 UTC
803485,mainnet,253,109296000,109720028,424029,389422,34607,0.08161470088130765,2021-12-02 13:06:41 UTC
803486,mainnet,253,109296000,109720202,424203,389564,34639,0.08165665966530175,2021-12-02 13:08:29 UTC
803488,mainnet,253,109296000,109720372,424373,389720,34653,0.0816569385894013,2021-12-02 13:10:17 UTC
803489,mainnet,253,109296000,109720516,424517,389854,34663,0.08165279600110242,2021-12-02 13:12:03 UTC
803491,mainnet,253,109296000,109720691,424692,390008,34684,0.08166859747770149,2021-12-02 13:13:50 UTC
803492,mainnet,253,109296000,109720799,424800,390108,34692,0.08166666666666667,2021-12-02 13:15:53 UTC
803494,mainnet,253,109296000,109721075,425076,390326,34750,0.08175008704325815,2021-12-02 13:17:45 UTC
803495,mainnet,253,109296000,109721334,425335,390551,34784,0.08178024380782208,2021-12-02 13:20:42 UTC
803496,mainnet,253,109296000,109721494,425495,390687,34808,0.08180589666153538,2021-12-02 13:22:03 UTC
803498,mainnet,253,109296000,109721570,425571,390756,34815,0.08180773595945212,2021-12-02 13:23:41 UTC
803499,mainnet,253,109296000,109721820,425821,390982,34839,0.08181606825403162,2021-12-02 13:25:09 UTC
803501,mainnet,253,109296000,109722007,426008,391131,34877,0.08186935456611144,2021-12-02 13:27:01 UTC
803502,mainnet,253,109296000,109722138,426139,391250,34889,0.08187234681641437,2021-12-02 13:28:30 UTC
803504,mainnet,253,109296000,109722298,426299,391368,34931,0.08194014060553743,2021-12-02 13:30:29 UTC
803505,mainnet,253,109296000,109722432,426433,391473,34960,0.0819823981727493,2021-12-02 13:32:00 UTC
803507,mainnet,253,109296000,109722521,426522,391538,34984,0.08202156043533511,2021-12-02 13:33:31 UTC
803508,mainnet,253,109296000,109722722,426723,391703,35020,0.08206728955317619,2021-12-02 13:35:06 UTC
803510,mainnet,253,109296000,109722884,426885,391827,35058,0.08212516251449453,2021-12-02 13:36:39 UTC
803512,mainnet,253,109296000,109722994,426995,391931,35064,0.08211805758849636,2021-12-02 13:38:05 UTC
803513,mainnet,253,109296000,109723130,427131,392033,35098,0.08217151178444083,2021-12-02 13:39:30 UTC
803515,mainnet,253,109296000,109723262,427263,392142,35121,0.08219995646709403,2021-12-02 13:40:57 UTC
803516,mainnet,253,109296000,109723407,427408,392269,35139,0.08221418410511735,2021-12-02 13:42:33 UTC
803518,mainnet,253,109296000,109723566,427567,392399,35168,0.08225143661695127,2021-12-02 13:44:09 UTC
803519,mainnet,253,109296000,109723716,427717,392537,35180,0.08225064703998204,2021-12-02 13:45:56 UTC
803521,mainnet,253,109296000,109723917,427918,392703,35215,0.08229380395309381,2021-12-02 13:47:48 UTC
803523,mainnet,253,109296000,109724070,428071,392851,35220,0.08227607102560089,2021-12-02 13:49:26 UTC
803524,mainnet,253,109296000,109724263,428264,393011,35253,0.08231604804513104,2021-12-02 13:51:29 UTC
803526,mainnet,253,109296000,109724440,428441,393165,35276,0.08233572417205637,2021-12-02 13:53:11 UTC
803528,mainnet,253,109296000,109724476,428477,393200,35277,0.08233114029457823,2021-12-02 13:54:35 UTC
803529,mainnet,253,109296000,109724736,428737,393409,35328,0.08240016606917527,2021-12-02 13:55:58 UTC
803531,mainnet,253,109296000,109724799,428800,393462,35338,0.08241138059701493,2021-12-02 13:57:24 UTC
803532,mainnet,253,109296000,109725004,429005,393635,35370,0.08244659153156723,2021-12-02 13:58:48 UTC
803533,mainnet,253,109296000,109725108,429109,393734,35375,0.08243826160719071,2021-12-02 14:00:15 UTC
803534,mainnet,253,109296000,109725268,429269,393860,35409,0.08248673908435038,2021-12-02 14:01:44 UTC
803536,mainnet,253,109296000,109725387,429388,393969,35419,0.08248716778298415,2021-12-02 14:03:07 UTC
803537,mainnet,253,109296000,109725543,429544,394109,35435,0.08249445924049689,2021-12-02 14:04:31 UTC
803538,mainnet,253,109296000,109725707,429708,394262,35446,0.08248857363605053,2021-12-02 14:06:07 UTC
803539,mainnet,253,109296000,109725869,429870,394404,35466,0.08250401284109149,2021-12-02 14:07:43 UTC
803541,mainnet,253,109296000,109726013,430014,394534,35480,0.08250894156934425,2021-12-02 14:09:06 UTC
803542,mainnet,253,109296000,109726143,430144,394662,35482,0.08248865496205922,2021-12-02 14:10:31 UTC
803544,mainnet,253,109296000,109726259,430260,394775,35485,0.08247338818388882,2021-12-02 14:11:56 UTC
803545,mainnet,253,109296000,109726404,430405,394902,35503,0.08248742463493686,2021-12-02 14:13:20 UTC
803547,mainnet,253,109296000,109726591,430592,395062,35530,0.08251430588585018,2021-12-02 14:15:07 UTC
803549,mainnet,253,109296000,109726717,430718,395175,35543,0.08252034974159426,2021-12-02 14:17:01 UTC
803550,mainnet,253,109296000,109726905,430906,395343,35563,0.08253076076917007,2021-12-02 14:18:27 UTC
803552,mainnet,253,109296000,109727046,431047,395463,35584,0.0825524826759031,2021-12-02 14:19:54 UTC
803553,mainnet,253,109296000,109727201,431202,395593,35609,0.08258078580340536,2021-12-02 14:21:20 UTC
803555,mainnet,253,109296000,109727327,431328,395717,35611,0.08256129905779361,2021-12-02 14:22:47 UTC
803556,mainnet,253,109296000,109727460,431461,395846,35615,0.0825451199529042,2021-12-02 14:24:14 UTC
803557,mainnet,253,109296000,109727692,431693,396062,35631,0.08253782201703526,2021-12-02 14:26:42 UTC
803559,mainnet,253,109296000,109727798,431799,396165,35634,0.08252450793077334,2021-12-02 14:28:03 UTC
803560,mainnet,253,109296000,109727930,431931,396283,35648,0.08253170066515253,2021-12-02 14:29:27 UTC
803566,mainnet,254,109728000,109728923,924,819,105,0.11363636363636363,2021-12-02 14:39:25 UTC
803567,mainnet,254,109728000,109729071,1072,963,109,0.10167910447761194,2021-12-02 14:40:51 UTC
803569,mainnet,254,109728000,109729285,1286,1168,118,0.09175738724727839,2021-12-02 14:43:19 UTC
803571,mainnet,254,109728000,109729391,1392,1264,128,0.09195402298850575,2021-12-02 14:44:53 UTC
803572,mainnet,254,109728000,109729601,1602,1456,146,0.09113607990012484,2021-12-02 14:46:07 UTC
803574,mainnet,254,109728000,109729740,1741,1573,168,0.09649626651349799,2021-12-02 14:47:30 UTC
803575,mainnet,254,109728000,109729793,1794,1621,173,0.09643255295429208,2021-12-02 14:49:06 UTC
803577,mainnet,254,109728000,109730062,2063,1867,196,0.09500727096461464,2021-12-02 14:51:12 UTC
803578,mainnet,254,109728000,109730264,2265,2055,210,0.09271523178807947,2021-12-02 14:52:45 UTC
803580,mainnet,254,109728000,109730412,2413,2202,211,0.08744301699129714,2021-12-02 14:54:11 UTC
803581,mainnet,254,109728000,109730540,2541,2299,242,0.09523809523809523,2021-12-02 14:55:26 UTC
803582,mainnet,254,109728000,109730602,2603,2353,250,0.09604302727621974,2021-12-02 14:56:39 UTC
803584,mainnet,254,109728000,109730744,2745,2471,274,0.09981785063752277,2021-12-02 14:57:56 UTC
803585,mainnet,254,109728000,109730935,2936,2648,288,0.09809264305177112,2021-12-02 14:59:09 UTC
803586,mainnet,254,109728000,109731076,3077,2769,308,0.10009749756256094,2021-12-02 15:00:29 UTC
803587,mainnet,254,109728000,109731157,3158,2848,310,0.09816339455351489,2021-12-02 15:01:44 UTC
803588,mainnet,254,109728000,109731341,3342,3011,331,0.0990424895272292,2021-12-02 15:03:02 UTC
803590,mainnet,254,109728000,109731440,3441,3095,346,0.1005521650682941,2021-12-02 15:04:13 UTC
803592,mainnet,254,109728000,109731609,3610,3236,374,0.10360110803324099,2021-12-02 15:07:14 UTC
803593,mainnet,254,109728000,109731864,3865,3454,411,0.10633893919793014,2021-12-02 15:08:36 UTC
803595,mainnet,254,109728000,109731997,3998,3579,419,0.1048024012006003,2021-12-02 15:09:55 UTC
803596,mainnet,254,109728000,109732121,4122,3700,422,0.10237748665696264,2021-12-02 15:11:15 UTC
803598,mainnet,254,109728000,109732252,4253,3820,433,0.10181048671525982,2021-12-02 15:12:29 UTC
803599,mainnet,254,109728000,109732360,4361,3921,440,0.10089429030038982,2021-12-02 15:13:42 UTC
803600,mainnet,254,109728000,109732467,4468,4007,461,0.10317815577439571,2021-12-02 15:15:00 UTC
803601,mainnet,254,109728000,109732650,4651,4169,482,0.1036336271769512,2021-12-02 15:16:37 UTC
803603,mainnet,254,109728000,109732780,4781,4292,489,0.10227985777034093,2021-12-02 15:17:55 UTC
803604,mainnet,254,109728000,109732882,4883,4385,498,0.10198648371902519,2021-12-02 15:19:13 UTC
803606,mainnet,254,109728000,109733015,5016,4494,522,0.10406698564593302,2021-12-02 15:20:32 UTC
803607,mainnet,254,109728000,109733130,5131,4602,529,0.10309881114792438,2021-12-02 15:21:56 UTC
803609,mainnet,254,109728000,109733279,5280,4726,554,0.10492424242424242,2021-12-02 15:23:23 UTC
803610,mainnet,254,109728000,109733469,5470,4889,581,0.10621572212065813,2021-12-02 15:25:18 UTC
803612,mainnet,254,109728000,109733548,5549,4960,589,0.10614525139664804,2021-12-02 15:26:35 UTC
803613,mainnet,254,109728000,109733705,5706,5088,618,0.10830704521556257,2021-12-02 15:28:00 UTC
803615,mainnet,254,109728000,109733861,5862,5219,643,0.10968952575912658,2021-12-02 15:29:32 UTC
803617,mainnet,254,109728000,109734028,6029,5379,650,0.10781224083595953,2021-12-02 15:31:08 UTC
803618,mainnet,254,109728000,109734228,6229,5566,663,0.10643763043827259,2021-12-02 15:32:48 UTC
803620,mainnet,254,109728000,109734368,6369,5691,678,0.10645313235986811,2021-12-02 15:34:24 UTC
803621,mainnet,254,109728000,109734494,6495,5796,699,0.10762124711316397,2021-12-02 15:35:41 UTC
803623,mainnet,254,109728000,109734631,6632,5902,730,0.11007237635705669,2021-12-02 15:37:11 UTC
803624,mainnet,254,109728000,109734780,6781,6019,762,0.11237280637074178,2021-12-02 15:38:39 UTC
803626,mainnet,254,109728000,109734904,6905,6116,789,0.11426502534395366,2021-12-02 15:40:02 UTC
803627,mainnet,254,109728000,109735017,7018,6212,806,0.11484753491023084,2021-12-02 15:41:25 UTC
803629,mainnet,254,109728000,109735125,7126,6308,818,0.11479090653943307,2021-12-02 15:42:57 UTC
803630,mainnet,254,109728000,109735275,7276,6440,836,0.1148982957669049,2021-12-02 15:44:26 UTC
803632,mainnet,254,109728000,109735385,7386,6530,856,0.11589493636609802,2021-12-02 15:45:44 UTC
803633,mainnet,254,109728000,109735475,7476,6603,873,0.11677367576243981,2021-12-02 15:47:03 UTC
803635,mainnet,254,109728000,109735664,7665,6748,917,0.11963470319634703,2021-12-02 15:48:22 UTC
803636,mainnet,254,109728000,109735680,7681,6764,917,0.11938549668011977,2021-12-02 15:49:45 UTC
803638,mainnet,254,109728000,109735896,7897,6939,958,0.12131189059136381,2021-12-02 15:51:06 UTC
803639,mainnet,254,109728000,109735989,7990,7018,972,0.12165206508135169,2021-12-02 15:52:26 UTC
803640,mainnet,254,109728000,109736090,8091,7095,996,0.12309974045235447,2021-12-02 15:53:50 UTC
803642,mainnet,254,109728000,109736236,8237,7198,1039,0.1261381570960301,2021-12-02 15:55:12 UTC
803643,mainnet,254,109728000,109736344,8345,7275,1070,0.12822049131216298,2021-12-02 15:56:32 UTC
803645,mainnet,254,109728000,109736444,8445,7338,1107,0.13108348134991119,2021-12-02 15:57:50 UTC
803646,mainnet,254,109728000,109736581,8582,7429,1153,0.1343509671405267,2021-12-02 15:59:08 UTC
803647,mainnet,254,109728000,109736697,8698,7505,1193,0.13715796734881583,2021-12-02 16:00:30 UTC
803648,mainnet,254,109728000,109736806,8807,7593,1214,0.13784489610537073,2021-12-02 16:01:55 UTC
803649,mainnet,254,109728000,109736917,8918,7690,1228,0.13769903565821934,2021-12-02 16:03:17 UTC
803651,mainnet,254,109728000,109737035,9036,7774,1262,0.13966356795042054,2021-12-02 16:04:38 UTC
803652,mainnet,254,109728000,109737120,9121,7843,1278,0.14011621532726676,2021-12-02 16:05:57 UTC
803654,mainnet,254,109728000,109737255,9256,7941,1315,0.14207000864304234,2021-12-02 16:07:19 UTC
803655,mainnet,254,109728000,109737368,9369,8036,1333,0.14227772441028924,2021-12-02 16:08:39 UTC
803656,mainnet,254,109728000,109737474,9475,8122,1353,0.14279683377308708,2021-12-02 16:10:01 UTC
803658,mainnet,254,109728000,109737573,9574,8199,1375,0.1436181324420305,2021-12-02 16:11:22 UTC
803659,mainnet,254,109728000,109737648,9649,8256,1393,0.14436729194735207,2021-12-02 16:12:47 UTC
803661,mainnet,254,109728000,109737790,9791,8363,1428,0.14584822796445715,2021-12-02 16:14:11 UTC
803662,mainnet,254,109728000,109737912,9913,8467,1446,0.14586906082921416,2021-12-02 16:15:36 UTC
803664,mainnet,254,109728000,109738013,10014,8548,1466,0.14639504693429198,2021-12-02 16:16:57 UTC
803665,mainnet,254,109728000,109738119,10120,8630,1490,0.14723320158102768,2021-12-02 16:18:20 UTC
803667,mainnet,254,109728000,109738229,10230,8726,1504,0.14701857282502445,2021-12-02 16:19:44 UTC
803668,mainnet,254,109728000,109738324,10325,8800,1525,0.14769975786924938,2021-12-02 16:21:09 UTC
803669,mainnet,254,109728000,109738478,10479,8919,1560,0.14886916690523905,2021-12-02 16:22:28 UTC
803670,mainnet,254,109728000,109738608,10609,9015,1594,0.15024978791592045,2021-12-02 16:23:52 UTC
803672,mainnet,254,109728000,109738711,10712,9092,1620,0.15123226288274833,2021-12-02 16:25:17 UTC
803673,mainnet,254,109728000,109738854,10855,9189,1666,0.1534776600644864,2021-12-02 16:26:38 UTC
803675,mainnet,254,109728000,109738987,10988,9294,1694,0.1541681834728795,2021-12-02 16:28:05 UTC
803676,mainnet,254,109728000,109739061,11062,9367,1695,0.15322726450913035,2021-12-02 16:29:30 UTC
803678,mainnet,254,109728000,109739222,11223,9481,1742,0.15521696516083044,2021-12-02 16:30:54 UTC
803679,mainnet,254,109728000,109739381,11382,9614,1768,0.15533298190124759,2021-12-02 16:32:17 UTC
803681,mainnet,254,109728000,109739487,11488,9710,1778,0.15477019498607242,2021-12-02 16:33:37 UTC
803682,mainnet,254,109728000,109739610,11611,9807,1804,0.1553699078460081,2021-12-02 16:35:00 UTC
803684,mainnet,254,109728000,109739751,11752,9923,1829,0.15563308373042886,2021-12-02 16:36:29 UTC
803685,mainnet,254,109728000,109739840,11841,9999,1842,0.15556118571066632,2021-12-02 16:37:55 UTC
803687,mainnet,254,109728000,109740024,12025,10138,1887,0.15692307692307692,2021-12-02 16:39:17 UTC
803688,mainnet,254,109728000,109740156,12157,10245,1912,0.15727564366208768,2021-12-02 16:40:43 UTC
803690,mainnet,254,109728000,109740301,12302,10360,1942,0.1578605104860998,2021-12-02 16:42:10 UTC
803691,mainnet,254,109728000,109740393,12394,10443,1951,0.15741487816685493,2021-12-02 16:43:30 UTC
803693,mainnet,254,109728000,109740556,12557,10578,1979,0.15760133789917974,2021-12-02 16:44:54 UTC
803694,mainnet,254,109728000,109740675,12676,10685,1991,0.1570684758598927,2021-12-02 16:46:17 UTC
803696,mainnet,254,109728000,109740797,12798,10789,2009,0.15697765275824346,2021-12-02 16:47:43 UTC
803697,mainnet,254,109728000,109740927,12928,10903,2025,0.15663675742574257,2021-12-02 16:49:07 UTC
803699,mainnet,254,109728000,109741064,13065,11021,2044,0.15644852659778033,2021-12-02 16:50:32 UTC
803700,mainnet,254,109728000,109741086,13087,11042,2045,0.15626193932910523,2021-12-02 16:51:56 UTC
803702,mainnet,254,109728000,109741355,13356,11277,2079,0.15566037735849056,2021-12-02 16:53:22 UTC
803703,mainnet,254,109728000,109741474,13475,11380,2095,0.1554730983302412,2021-12-02 16:54:42 UTC
803704,mainnet,254,109728000,109741589,13590,11488,2102,0.15467255334805002,2021-12-02 16:56:06 UTC
803705,mainnet,254,109728000,109741712,13713,11602,2111,0.15394151535039743,2021-12-02 16:57:38 UTC
803706,mainnet,254,109728000,109741851,13852,11718,2134,0.1540571758590817,2021-12-02 16:59:00 UTC
803707,mainnet,254,109728000,109741984,13985,11832,2153,0.15395066142295316,2021-12-02 17:00:29 UTC
803708,mainnet,254,109728000,109742131,14132,11967,2165,0.15319841494480613,2021-12-02 17:02:07 UTC
803710,mainnet,254,109728000,109742276,14277,12087,2190,0.15339357007774743,2021-12-02 17:03:55 UTC
803711,mainnet,254,109728000,109742428,14429,12219,2210,0.15316376741284912,2021-12-02 17:05:37 UTC
803713,mainnet,254,109728000,109742617,14618,12384,2234,0.15282528389656588,2021-12-02 17:07:49 UTC
803715,mainnet,254,109728000,109742790,14791,12519,2272,0.15360692312892976,2021-12-02 17:09:22 UTC
803716,mainnet,254,109728000,109742964,14965,12680,2285,0.1526896090878717,2021-12-02 17:11:09 UTC
803717,mainnet,254,109728000,109743105,15106,12808,2298,0.15212498345028466,2021-12-02 17:12:32 UTC
803719,mainnet,254,109728000,109743285,15286,12980,2306,0.15085699332722752,2021-12-02 17:14:11 UTC
803721,mainnet,254,109728000,109743456,15457,13139,2318,0.14996441741605746,2021-12-02 17:15:57 UTC
803722,mainnet,254,109728000,109743608,15609,13282,2327,0.14908065859440067,2021-12-02 17:17:30 UTC
803724,mainnet,254,109728000,109743748,15749,13408,2341,0.14864435837196013,2021-12-02 17:19:06 UTC
803725,mainnet,254,109728000,109743942,15943,13582,2361,0.1480900708775011,2021-12-02 17:20:36 UTC
803727,mainnet,254,109728000,109744127,16128,13732,2396,0.14856150793650794,2021-12-02 17:22:32 UTC
803728,mainnet,254,109728000,109744245,16246,13844,2402,0.1478517788994214,2021-12-02 17:23:58 UTC
803730,mainnet,254,109728000,109744403,16404,13973,2431,0.14819556205803464,2021-12-02 17:25:34 UTC
803732,mainnet,254,109728000,109744557,16558,14109,2449,0.1479043362724967,2021-12-02 17:27:09 UTC
803733,mainnet,254,109728000,109744780,16781,14302,2479,0.14772659555449616,2021-12-02 17:29:20 UTC
803734,mainnet,254,109728000,109744914,16915,14425,2490,0.14720662134200413,2021-12-02 17:30:47 UTC
803735,mainnet,254,109728000,109744982,16983,14488,2495,0.1469116174998528,2021-12-02 17:32:24 UTC
803737,mainnet,254,109728000,109745228,17229,14716,2513,0.14585872656567414,2021-12-02 17:33:55 UTC
803738,mainnet,254,109728000,109745247,17248,14735,2513,0.14569805194805194,2021-12-02 17:35:27 UTC
803740,mainnet,254,109728000,109745552,17553,15010,2543,0.14487551985415598,2021-12-02 17:37:02 UTC
803741,mainnet,254,109728000,109745700,17701,15139,2562,0.14473758544714987,2021-12-02 17:38:37 UTC
803743,mainnet,254,109728000,109745829,17830,15247,2583,0.1448681996634885,2021-12-02 17:40:11 UTC
803744,mainnet,254,109728000,109746016,18017,15387,2630,0.1459732474884831,2021-12-02 17:41:47 UTC
803745,mainnet,254,109728000,109746133,18134,15501,2633,0.14519686776221463,2021-12-02 17:43:10 UTC
803747,mainnet,254,109728000,109746268,18269,15612,2657,0.1454376265805463,2021-12-02 17:44:36 UTC
803748,mainnet,254,109728000,109746417,18418,15733,2685,0.1457813009012922,2021-12-02 17:46:08 UTC
803750,mainnet,254,109728000,109746551,18552,15860,2692,0.14510564898663217,2021-12-02 17:47:44 UTC
803751,mainnet,254,109728000,109746719,18720,16011,2709,0.14471153846153847,2021-12-02 17:49:28 UTC
803752,mainnet,254,109728000,109746909,18910,16184,2726,0.1441565309360127,2021-12-02 17:51:18 UTC
803754,mainnet,254,109728000,109747058,19059,16324,2735,0.14350175769977438,2021-12-02 17:52:56 UTC
803755,mainnet,254,109728000,109747212,19213,16468,2745,0.1428720137406964,2021-12-02 17:54:31 UTC
803757,mainnet,254,109728000,109747304,19305,16548,2757,0.1428127428127428,2021-12-02 17:55:58 UTC
803758,mainnet,254,109728000,109747455,19456,16691,2765,0.14211554276315788,2021-12-02 17:57:47 UTC
803760,mainnet,254,109728000,109747712,19713,16931,2782,0.14112514584284483,2021-12-02 17:59:12 UTC
803761,mainnet,254,109728000,109747899,19900,17102,2798,0.1406030150753769,2021-12-02 18:01:08 UTC
803763,mainnet,254,109728000,109748066,20067,17255,2812,0.14013056261523896,2021-12-02 18:02:38 UTC
803764,mainnet,254,109728000,109748173,20174,17359,2815,0.13953603648260138,2021-12-02 18:04:05 UTC
803766,mainnet,254,109728000,109748368,20369,17540,2829,0.13888752516078354,2021-12-02 18:05:28 UTC
803767,mainnet,254,109728000,109748521,20522,17656,2866,0.13965500438553746,2021-12-02 18:07:06 UTC
803769,mainnet,254,109728000,109748650,20651,17764,2887,0.1397995254467096,2021-12-02 18:08:40 UTC
803771,mainnet,254,109728000,109748872,20873,17953,2920,0.1398936425046711,2021-12-02 18:10:48 UTC
803772,mainnet,254,109728000,109749067,21068,18130,2938,0.13945319916460983,2021-12-02 18:12:26 UTC
803774,mainnet,254,109728000,109749233,21234,18280,2954,0.13911651125553356,2021-12-02 18:14:00 UTC
803775,mainnet,254,109728000,109749393,21394,18432,2962,0.13845003271945405,2021-12-02 18:15:38 UTC
803777,mainnet,254,109728000,109749545,21546,18571,2975,0.13807667316439245,2021-12-02 18:17:06 UTC
803778,mainnet,254,109728000,109749710,21711,18709,3002,0.13827092257381052,2021-12-02 18:18:41 UTC
803779,mainnet,254,109728000,109749884,21885,18873,3012,0.13762851267991774,2021-12-02 18:20:20 UTC
803780,mainnet,254,109728000,109750038,22039,19009,3030,0.13748355188529426,2021-12-02 18:21:57 UTC
803782,mainnet,254,109728000,109750215,22216,19177,3039,0.1367933021245949,2021-12-02 18:23:46 UTC
803784,mainnet,254,109728000,109750362,22363,19301,3062,0.1369225953584045,2021-12-02 18:25:19 UTC
803785,mainnet,254,109728000,109750481,22482,19409,3073,0.13668712747976158,2021-12-02 18:26:46 UTC
803787,mainnet,254,109728000,109750623,22624,19540,3084,0.13631541725601132,2021-12-02 18:28:11 UTC
803788,mainnet,254,109728000,109750755,22756,19657,3099,0.13618386359641413,2021-12-02 18:29:35 UTC
803790,mainnet,254,109728000,109750916,22917,19797,3120,0.13614347427673779,2021-12-02 18:31:09 UTC
803791,mainnet,254,109728000,109751069,23070,19937,3133,0.13580407455570004,2021-12-02 18:32:36 UTC
803793,mainnet,254,109728000,109751225,23226,20080,3146,0.135451649014036,2021-12-02 18:34:04 UTC
803794,mainnet,254,109728000,109751356,23357,20206,3151,0.13490602389005438,2021-12-02 18:35:33 UTC
803796,mainnet,254,109728000,109751526,23527,20363,3164,0.13448378458792026,2021-12-02 18:37:29 UTC
803797,mainnet,254,109728000,109751692,23693,20505,3188,0.1345545097708184,2021-12-02 18:38:54 UTC
803799,mainnet,254,109728000,109751872,23873,20666,3207,0.134335860595652,2021-12-02 18:40:32 UTC
803800,mainnet,254,109728000,109752029,24030,20816,3214,0.13374947981689556,2021-12-02 18:42:05 UTC
803802,mainnet,254,109728000,109752223,24224,20991,3233,0.13346268163804492,2021-12-02 18:43:48 UTC
803803,mainnet,254,109728000,109752361,24362,21123,3239,0.13295295952713243,2021-12-02 18:45:12 UTC
803805,mainnet,254,109728000,109752576,24577,21314,3263,0.13276640761687758,2021-12-02 18:47:23 UTC
803807,mainnet,254,109728000,109752744,24745,21460,3285,0.13275409173570418,2021-12-02 18:49:05 UTC
803808,mainnet,254,109728000,109752928,24929,21644,3285,0.13177423883830078,2021-12-02 18:50:47 UTC
803810,mainnet,254,109728000,109753072,25073,21772,3301,0.1316555657480158,2021-12-02 18:52:30 UTC
803811,mainnet,254,109728000,109753247,25248,21915,3333,0.13201045627376426,2021-12-02 18:54:00 UTC
803813,mainnet,254,109728000,109753411,25412,22060,3352,0.13190618605383284,2021-12-02 18:55:35 UTC
803814,mainnet,254,109728000,109753567,25568,22205,3363,0.13153160200250313,2021-12-02 18:57:12 UTC
803816,mainnet,254,109728000,109753572,25573,22210,3363,0.13150588511320532,2021-12-02 18:58:50 UTC
803817,mainnet,254,109728000,109753899,25900,22522,3378,0.13042471042471043,2021-12-02 19:00:35 UTC
803818,mainnet,254,109728000,109754123,26124,22726,3398,0.13007196447710917,2021-12-02 19:02:19 UTC
803820,mainnet,254,109728000,109754291,26292,22888,3404,0.129469040012171,2021-12-02 19:04:00 UTC
803821,mainnet,254,109728000,109754466,26467,23055,3412,0.12891525295651188,2021-12-02 19:05:37 UTC
803823,mainnet,254,109728000,109754620,26621,23204,3417,0.12835731189662297,2021-12-02 19:07:21 UTC
803824,mainnet,254,109728000,109754758,26759,23327,3432,0.12825591389812774,2021-12-02 19:08:50 UTC
803825,mainnet,254,109728000,109754920,26921,23477,3444,0.12792986887559898,2021-12-02 19:10:19 UTC
803826,mainnet,254,109728000,109755075,27076,23621,3455,0.12760378194711183,2021-12-02 19:11:50 UTC
803828,mainnet,254,109728000,109755210,27211,23744,3467,0.12741170850023886,2021-12-02 19:13:17 UTC
803829,mainnet,254,109728000,109755362,27363,23870,3493,0.12765413149143004,2021-12-02 19:14:44 UTC
803831,mainnet,254,109728000,109755503,27504,24011,3493,0.12699970913321698,2021-12-02 19:16:11 UTC
803832,mainnet,254,109728000,109755697,27698,24184,3514,0.1268683659469998,2021-12-02 19:17:40 UTC
803834,mainnet,254,109728000,109755854,27855,24317,3538,0.1270148985819422,2021-12-02 19:19:08 UTC
803835,mainnet,254,109728000,109756011,28012,24466,3546,0.1265886048836213,2021-12-02 19:20:37 UTC
803837,mainnet,254,109728000,109756154,28155,24598,3557,0.1263363523352868,2021-12-02 19:22:03 UTC
803838,mainnet,254,109728000,109756299,28300,24743,3557,0.12568904593639577,2021-12-02 19:23:34 UTC
803840,mainnet,254,109728000,109756481,28482,24916,3566,0.1252018818903167,2021-12-02 19:25:03 UTC
803841,mainnet,254,109728000,109756641,28642,25067,3575,0.12481670274422177,2021-12-02 19:26:31 UTC
803843,mainnet,254,109728000,109756789,28790,25210,3580,0.1243487321986801,2021-12-02 19:27:58 UTC
803844,mainnet,254,109728000,109756950,28951,25360,3591,0.12403716624641636,2021-12-02 19:29:28 UTC
803846,mainnet,254,109728000,109757016,29017,25422,3595,0.12389289037460799,2021-12-02 19:30:59 UTC
803847,mainnet,254,109728000,109757281,29282,25665,3617,0.12352298340277304,2021-12-02 19:32:35 UTC
803849,mainnet,254,109728000,109757436,29437,25785,3652,0.12406155518565071,2021-12-02 19:34:07 UTC
803850,mainnet,254,109728000,109757567,29568,25908,3660,0.12378246753246754,2021-12-02 19:35:39 UTC
803852,mainnet,254,109728000,109757720,29721,26057,3664,0.12327983580633223,2021-12-02 19:37:12 UTC
803853,mainnet,254,109728000,109757872,29873,26188,3685,0.12335553844608844,2021-12-02 19:38:43 UTC
803855,mainnet,254,109728000,109758024,30025,26326,3699,0.12319733555370524,2021-12-02 19:40:14 UTC
803856,mainnet,254,109728000,109758182,30183,26478,3705,0.12275121757280588,2021-12-02 19:41:48 UTC
803858,mainnet,254,109728000,109758341,30342,26625,3717,0.12250346054973305,2021-12-02 19:43:16 UTC
803859,mainnet,254,109728000,109758521,30522,26800,3722,0.12194482668239302,2021-12-02 19:44:47 UTC
803861,mainnet,254,109728000,109758667,30668,26924,3744,0.12208164862397287,2021-12-02 19:46:18 UTC
803862,mainnet,254,109728000,109758826,30827,27075,3752,0.12171148668375126,2021-12-02 19:47:51 UTC
803864,mainnet,254,109728000,109758978,30979,27212,3767,0.12159850221117531,2021-12-02 19:49:24 UTC
803865,mainnet,254,109728000,109759133,31134,27345,3789,0.12169974947003276,2021-12-02 19:50:55 UTC
803866,mainnet,254,109728000,109759318,31319,27517,3802,0.12139595772534244,2021-12-02 19:52:29 UTC
803868,mainnet,254,109728000,109759415,31416,27601,3815,0.1214349376114082,2021-12-02 19:53:50 UTC
803869,mainnet,254,109728000,109759592,31593,27752,3841,0.12157756465039724,2021-12-02 19:55:24 UTC
803871,mainnet,254,109728000,109759744,31745,27898,3847,0.12118443849425106,2021-12-02 19:56:55 UTC
803872,mainnet,254,109728000,109759810,31811,27958,3853,0.12112162459526579,2021-12-02 19:58:25 UTC
803874,mainnet,254,109728000,109760072,32073,28198,3875,0.12081813363265051,2021-12-02 19:59:59 UTC
803875,mainnet,254,109728000,109760243,32244,28349,3895,0.12079766778315346,2021-12-02 20:01:35 UTC
803876,mainnet,254,109728000,109760403,32404,28501,3903,0.12044809282804592,2021-12-02 20:03:12 UTC
803878,mainnet,254,109728000,109760576,32577,28671,3906,0.11990054332811492,2021-12-02 20:04:46 UTC
803879,mainnet,254,109728000,109760748,32749,28830,3919,0.11966777611530123,2021-12-02 20:06:23 UTC
803881,mainnet,254,109728000,109760922,32923,28995,3928,0.1193086899735747,2021-12-02 20:08:08 UTC
803882,mainnet,254,109728000,109761087,33088,29145,3943,0.11916706963249517,2021-12-02 20:09:52 UTC
803884,mainnet,254,109728000,109761328,33329,29367,3962,0.11887545380899517,2021-12-02 20:12:02 UTC
803885,mainnet,254,109728000,109761503,33504,29536,3968,0.11843361986628462,2021-12-02 20:13:52 UTC
803887,mainnet,254,109728000,109761703,33704,29722,3982,0.1181462140992167,2021-12-02 20:15:22 UTC
803888,mainnet,254,109728000,109761846,33847,29852,3995,0.11803114013058764,2021-12-02 20:16:52 UTC
803890,mainnet,254,109728000,109762024,34025,30017,4008,0.11779573842762675,2021-12-02 20:18:55 UTC
803892,mainnet,254,109728000,109762235,34236,30220,4016,0.11730342329711414,2021-12-02 20:20:42 UTC
803893,mainnet,254,109728000,109762396,34397,30364,4033,0.11724859726138907,2021-12-02 20:22:12 UTC
803895,mainnet,254,109728000,109762569,34570,30525,4045,0.11700896731269887,2021-12-02 20:23:59 UTC
803896,mainnet,254,109728000,109762741,34742,30680,4062,0.11691900293592769,2021-12-02 20:25:33 UTC
803898,mainnet,254,109728000,109762900,34901,30831,4070,0.1166155697544483,2021-12-02 20:27:21 UTC
803899,mainnet,254,109728000,109763033,35034,30953,4081,0.11648684135411315,2021-12-02 20:29:23 UTC
803901,mainnet,254,109728000,109763276,35277,31191,4086,0.11582617569521218,2021-12-02 20:31:05 UTC
803903,mainnet,254,109728000,109763469,35470,31362,4108,0.11581618268959684,2021-12-02 20:32:46 UTC
803904,mainnet,254,109728000,109763607,35608,31488,4120,0.11570433610424624,2021-12-02 20:34:18 UTC
803906,mainnet,254,109728000,109763770,35771,31641,4130,0.11545665483212658,2021-12-02 20:35:51 UTC
803907,mainnet,254,109728000,109763936,35937,31795,4142,0.11525725575312352,2021-12-02 20:37:30 UTC
803909,mainnet,254,109728000,109764091,36092,31932,4160,0.11526099966751635,2021-12-02 20:39:26 UTC
803910,mainnet,254,109728000,109764302,36303,32112,4191,0.11544500454507892,2021-12-02 20:41:18 UTC
803912,mainnet,254,109728000,109764455,36456,32238,4218,0.11570111915734035,2021-12-02 20:42:56 UTC
803914,mainnet,254,109728000,109764621,36622,32379,4243,0.11585931953470592,2021-12-02 20:44:33 UTC
803915,mainnet,254,109728000,109764746,36747,32493,4254,0.11576455220834354,2021-12-02 20:46:03 UTC
803917,mainnet,254,109728000,109764881,36882,32605,4277,0.11596442709180631,2021-12-02 20:47:33 UTC
803918,mainnet,254,109728000,109764944,36945,32656,4289,0.11609148734605494,2021-12-02 20:49:05 UTC
803920,mainnet,254,109728000,109765220,37221,32917,4304,0.1156336476720131,2021-12-02 20:50:54 UTC
803921,mainnet,254,109728000,109765398,37399,33059,4340,0.11604588357977486,2021-12-02 20:52:23 UTC
803923,mainnet,254,109728000,109765554,37555,33203,4352,0.11588337105578485,2021-12-02 20:53:59 UTC
803924,mainnet,254,109728000,109765689,37690,33323,4367,0.11586627752719554,2021-12-02 20:55:30 UTC
803926,mainnet,254,109728000,109765844,37845,33455,4390,0.11599947152860351,2021-12-02 20:57:09 UTC
803927,mainnet,254,109728000,109765974,37975,33565,4410,0.11612903225806452,2021-12-02 20:58:40 UTC
803929,mainnet,254,109728000,109766139,38140,33710,4430,0.11615102254850551,2021-12-02 21:00:19 UTC
803930,mainnet,254,109728000,109766284,38285,33835,4450,0.11623351181925036,2021-12-02 21:01:55 UTC
803932,mainnet,254,109728000,109766455,38456,33983,4473,0.11631474932390264,2021-12-02 21:03:25 UTC
803933,mainnet,254,109728000,109766618,38619,34127,4492,0.1163158031021,2021-12-02 21:05:06 UTC
803935,mainnet,254,109728000,109766800,38801,34294,4507,0.1161568000824721,2021-12-02 21:06:55 UTC
803937,mainnet,254,109728000,109766972,38973,34447,4526,0.1161316809072948,2021-12-02 21:08:41 UTC
803938,mainnet,254,109728000,109767139,39140,34604,4536,0.11589167092488503,2021-12-02 21:10:12 UTC
803940,mainnet,254,109728000,109767326,39327,34771,4556,0.11584916215322806,2021-12-02 21:12:05 UTC
803941,mainnet,254,109728000,109767492,39493,34920,4573,0.11579267211910972,2021-12-02 21:13:45 UTC
803943,mainnet,254,109728000,109767668,39669,35082,4587,0.11563185358844438,2021-12-02 21:15:27 UTC
803944,mainnet,254,109728000,109767837,39838,35243,4595,0.11534213564937999,2021-12-02 21:17:03 UTC
803946,mainnet,254,109728000,109768033,40034,35410,4624,0.11550182345006745,2021-12-02 21:18:53 UTC
803948,mainnet,254,109728000,109768236,40237,35606,4631,0.11509307353927976,2021-12-02 21:20:37 UTC
803949,mainnet,254,109728000,109768409,40410,35764,4646,0.1149715416975996,2021-12-02 21:22:09 UTC
803951,mainnet,254,109728000,109768572,40573,35921,4652,0.11465753087028319,2021-12-02 21:23:47 UTC
803952,mainnet,254,109728000,109768762,40763,36086,4677,0.11473640311066408,2021-12-02 21:25:27 UTC
803954,mainnet,254,109728000,109768918,40919,36231,4688,0.11456780468730908,2021-12-02 21:27:01 UTC
803955,mainnet,254,109728000,109769064,41065,36368,4697,0.11437964203092658,2021-12-02 21:28:41 UTC
803957,mainnet,254,109728000,109769273,41274,36568,4706,0.11401851044240927,2021-12-02 21:30:34 UTC
803958,mainnet,254,109728000,109769447,41448,36731,4717,0.11380524995174676,2021-12-02 21:32:12 UTC
803960,mainnet,254,109728000,109769627,41628,36891,4737,0.11379360046122802,2021-12-02 21:33:44 UTC
803961,mainnet,254,109728000,109769792,41793,37042,4751,0.11367932428875649,2021-12-02 21:35:15 UTC
803963,mainnet,254,109728000,109769896,41897,37141,4756,0.11351648089362007,2021-12-02 21:36:43 UTC
803964,mainnet,254,109728000,109770135,42136,37368,4768,0.11315739510157585,2021-12-02 21:38:14 UTC
803966,mainnet,254,109728000,109770197,42198,37422,4776,0.1131807194653775,2021-12-02 21:39:44 UTC
803967,mainnet,254,109728000,109770399,42400,37607,4793,0.11304245283018868,2021-12-02 21:41:17 UTC
803969,mainnet,254,109728000,109770576,42577,37749,4828,0.11339455574606008,2021-12-02 21:42:46 UTC
803970,mainnet,254,109728000,109770732,42733,37898,4835,0.11314440830271687,2021-12-02 21:44:17 UTC
803972,mainnet,254,109728000,109770904,42905,38056,4849,0.11301713087052791,2021-12-02 21:45:58 UTC
803973,mainnet,254,109728000,109771055,43056,38192,4864,0.11296915644741731,2021-12-02 21:47:28 UTC
803974,mainnet,254,109728000,109771218,43219,38328,4891,0.11316781970892431,2021-12-02 21:49:01 UTC
803976,mainnet,254,109728000,109771377,43378,38479,4899,0.1129374337221633,2021-12-02 21:50:33 UTC
803977,mainnet,254,109728000,109771540,43541,38628,4913,0.11283617739601755,2021-12-02 21:52:09 UTC
803979,mainnet,254,109728000,109771683,43684,38759,4925,0.11274150718798645,2021-12-02 21:53:39 UTC
803980,mainnet,254,109728000,109771846,43847,38908,4939,0.11264168586220266,2021-12-02 21:55:09 UTC
803981,mainnet,254,109728000,109771985,43986,39042,4944,0.11239939980903015,2021-12-02 21:56:49 UTC
803982,mainnet,254,109728000,109772196,44197,39223,4974,0.11254157522003756,2021-12-02 21:58:29 UTC
803984,mainnet,254,109728000,109772442,44443,39460,4983,0.11212114393717795,2021-12-02 22:01:05 UTC
803986,mainnet,254,109728000,109772687,44688,39684,5004,0.11197636949516648,2021-12-02 22:02:56 UTC
803987,mainnet,254,109728000,109772907,44908,39892,5016,0.11169502093168256,2021-12-02 22:04:45 UTC
803989,mainnet,254,109728000,109773078,45079,40058,5021,0.11138224006743716,2021-12-02 22:06:44 UTC
803991,mainnet,254,109728000,109773328,45329,40297,5032,0.1110106113084339,2021-12-02 22:08:19 UTC
803992,mainnet,254,109728000,109773490,45491,40451,5040,0.11079114550130795,2021-12-02 22:09:46 UTC
803994,mainnet,254,109728000,109773665,45666,40617,5049,0.11056365786361845,2021-12-02 22:11:14 UTC
803995,mainnet,254,109728000,109773852,45853,40794,5059,0.11033083985780646,2021-12-02 22:12:55 UTC
803997,mainnet,254,109728000,109774046,46047,40981,5066,0.11001802506135036,2021-12-02 22:14:34 UTC
803998,mainnet,254,109728000,109774190,46191,41108,5083,0.1100430819856682,2021-12-02 22:16:00 UTC
804000,mainnet,254,109728000,109774358,46359,41248,5111,0.11024827972993377,2021-12-02 22:17:39 UTC
804001,mainnet,254,109728000,109774510,46511,41378,5133,0.11036098987336329,2021-12-02 22:19:04 UTC
804003,mainnet,254,109728000,109774692,46693,41539,5154,0.11038057096352773,2021-12-02 22:20:42 UTC
804004,mainnet,254,109728000,109774860,46861,41696,5165,0.11021958558289409,2021-12-02 22:22:09 UTC
804006,mainnet,254,109728000,109775053,47054,41880,5174,0.10995877077400433,2021-12-02 22:23:43 UTC
804007,mainnet,254,109728000,109775192,47193,42007,5186,0.1098891784798593,2021-12-02 22:25:13 UTC
804008,mainnet,254,109728000,109775328,47329,42132,5197,0.10980582729404804,2021-12-02 22:26:45 UTC
804009,mainnet,254,109728000,109775536,47537,42312,5225,0.10991438248101479,2021-12-02 22:28:29 UTC
804011,mainnet,254,109728000,109775750,47751,42525,5226,0.1094427341835773,2021-12-02 22:30:29 UTC
804013,mainnet,254,109728000,109775921,47922,42670,5252,0.10959475814865824,2021-12-02 22:32:17 UTC
804014,mainnet,254,109728000,109776140,48141,42880,5261,0.10928314742111714,2021-12-02 22:33:48 UTC
804016,mainnet,254,109728000,109776382,48383,43103,5280,0.10912923960895356,2021-12-02 22:35:51 UTC
804017,mainnet,254,109728000,109776577,48578,43297,5281,0.10871176252624645,2021-12-02 22:37:30 UTC
804019,mainnet,254,109728000,109776770,48771,43477,5294,0.10854811260790223,2021-12-02 22:39:19 UTC
804021,mainnet,254,109728000,109776925,48926,43614,5312,0.10857212933818419,2021-12-02 22:40:46 UTC
804022,mainnet,254,109728000,109777104,49105,43782,5323,0.10840036656144995,2021-12-02 22:42:16 UTC
804024,mainnet,254,109728000,109777275,49276,43937,5339,0.10834889195551586,2021-12-02 22:43:47 UTC
804025,mainnet,254,109728000,109777457,49458,44111,5347,0.10811193335759635,2021-12-02 22:45:18 UTC
804026,mainnet,254,109728000,109777600,49601,44230,5371,0.10828410717525856,2021-12-02 22:46:48 UTC
804027,mainnet,254,109728000,109777759,49760,44360,5400,0.1085209003215434,2021-12-02 22:48:17 UTC
804028,mainnet,254,109728000,109777904,49905,44480,5425,0.10870654243061817,2021-12-02 22:49:49 UTC
804030,mainnet,254,109728000,109778043,50044,44598,5446,0.10882423467348733,2021-12-02 22:51:20 UTC
804031,mainnet,254,109728000,109778184,50185,44707,5478,0.10915612234731494,2021-12-02 22:52:51 UTC
804032,mainnet,254,109728000,109778326,50327,44835,5492,0.10912631390704791,2021-12-02 22:54:23 UTC
804033,mainnet,254,109728000,109778503,50504,45000,5504,0.10898146681450974,2021-12-02 22:55:53 UTC
804034,mainnet,254,109728000,109778675,50676,45168,5508,0.10869050438077196,2021-12-02 22:57:21 UTC
804036,mainnet,254,109728000,109778848,50849,45333,5516,0.10847804283270074,2021-12-02 22:58:48 UTC
804037,mainnet,254,109728000,109779020,51021,45495,5526,0.10830834362321397,2021-12-02 23:00:20 UTC
804039,mainnet,254,109728000,109779184,51185,45646,5539,0.10821529745042494,2021-12-02 23:01:52 UTC
804040,mainnet,254,109728000,109779318,51319,45766,5553,0.1082055379099359,2021-12-02 23:03:20 UTC
804042,mainnet,254,109728000,109779495,51496,45910,5586,0.10847444461705763,2021-12-02 23:04:46 UTC
804043,mainnet,254,109728000,109779615,51616,46014,5602,0.10853223806571606,2021-12-02 23:06:16 UTC
804044,mainnet,254,109728000,109779824,51825,46212,5613,0.1083068017366136,2021-12-02 23:07:46 UTC
804046,mainnet,254,109728000,109779968,51969,46341,5628,0.10829532990821451,2021-12-02 23:09:21 UTC
804047,mainnet,254,109728000,109780143,52144,46484,5660,0.1085455661245781,2021-12-02 23:10:49 UTC
804049,mainnet,254,109728000,109780275,52276,46596,5680,0.108654066875813,2021-12-02 23:12:19 UTC
804050,mainnet,254,109728000,109780437,52438,46731,5707,0.10883328883634005,2021-12-02 23:13:51 UTC
804051,mainnet,254,109728000,109780632,52633,46925,5708,0.10844907187505938,2021-12-02 23:15:33 UTC
804052,mainnet,254,109728000,109780812,52813,47094,5719,0.10828773218715089,2021-12-02 23:17:35 UTC
804054,mainnet,254,109728000,109781028,53029,47285,5744,0.10831809010164249,2021-12-02 23:19:23 UTC
804056,mainnet,254,109728000,109781199,53200,47420,5780,0.10864661654135338,2021-12-02 23:20:57 UTC
804057,mainnet,254,109728000,109781369,53370,47569,5801,0.10869402285928424,2021-12-02 23:22:29 UTC
804059,mainnet,254,109728000,109781533,53534,47716,5818,0.10867859677961669,2021-12-02 23:24:01 UTC
804060,mainnet,254,109728000,109781753,53754,47918,5836,0.10856866465751386,2021-12-02 23:25:40 UTC
804062,mainnet,254,109728000,109781903,53904,48067,5837,0.10828509943603443,2021-12-02 23:27:15 UTC
804063,mainnet,254,109728000,109782153,54154,48294,5860,0.10820991985818222,2021-12-02 23:29:14 UTC
804065,mainnet,254,109728000,109782304,54305,48443,5862,0.10794586133873492,2021-12-02 23:31:18 UTC
804067,mainnet,254,109728000,109782581,54582,48700,5882,0.1077644644754681,2021-12-02 23:32:54 UTC
804068,mainnet,254,109728000,109782743,54744,48860,5884,0.10748209849481222,2021-12-02 23:34:33 UTC
804069,mainnet,254,109728000,109782912,54913,49016,5897,0.10738805018847995,2021-12-02 23:36:02 UTC
804071,mainnet,254,109728000,109783026,55027,49124,5903,0.10727461064568303,2021-12-02 23:37:43 UTC
804073,mainnet,254,109728000,109783275,55276,49362,5914,0.10699037556986757,2021-12-02 23:39:17 UTC
804074,mainnet,254,109728000,109783441,55442,49522,5920,0.10677825475271455,2021-12-02 23:40:50 UTC
804076,mainnet,254,109728000,109783659,55660,49736,5924,0.10643190801293569,2021-12-02 23:43:09 UTC
804077,mainnet,254,109728000,109783897,55898,49957,5941,0.10628287237468245,2021-12-02 23:44:51 UTC
804079,mainnet,254,109728000,109784074,56075,50121,5954,0.10617922425323228,2021-12-02 23:46:23 UTC
804080,mainnet,254,109728000,109784244,56245,50278,5967,0.10608943017157081,2021-12-02 23:47:51 UTC
804082,mainnet,254,109728000,109784338,56339,50366,5973,0.10601892117360975,2021-12-02 23:49:24 UTC
804083,mainnet,254,109728000,109784602,56603,50630,5973,0.10552444216737629,2021-12-02 23:50:58 UTC
804085,mainnet,254,109728000,109784733,56734,50758,5976,0.1053336623541439,2021-12-02 23:52:27 UTC
804086,mainnet,254,109728000,109784912,56913,50914,5999,0.1054064976367438,2021-12-02 23:53:58 UTC
804088,mainnet,254,109728000,109785072,57073,51074,5999,0.10511099819529375,2021-12-02 23:55:32 UTC
804089,mainnet,254,109728000,109785241,57242,51230,6012,0.10502777680723945,2021-12-02 23:57:08 UTC
804091,mainnet,254,109728000,109785427,57428,51415,6013,0.10470502194051683,2021-12-02 23:58:41 UTC
804092,mainnet,254,109728000,109785630,57631,51604,6027,0.10457913275841127,2021-12-03 00:00:18 UTC
804094,mainnet,254,109728000,109785791,57792,51752,6040,0.10451273532668881,2021-12-03 00:01:48 UTC
804096,mainnet,254,109728000,109785963,57964,51915,6049,0.10435787730315368,2021-12-03 00:03:20 UTC
804097,mainnet,254,109728000,109786149,58150,52094,6056,0.1041444539982803,2021-12-03 00:04:54 UTC
804098,mainnet,254,109728000,109786310,58311,52250,6061,0.1039426523297491,2021-12-03 00:06:28 UTC
804100,mainnet,254,109728000,109786506,58507,52430,6077,0.10386791324115063,2021-12-03 00:08:10 UTC
804101,mainnet,254,109728000,109786690,58691,52578,6113,0.10415566270808131,2021-12-03 00:09:42 UTC
804103,mainnet,254,109728000,109786871,58872,52754,6118,0.10392036961543688,2021-12-03 00:11:15 UTC
804104,mainnet,254,109728000,109787047,59048,52920,6128,0.10377997561306056,2021-12-03 00:12:46 UTC
804105,mainnet,254,109728000,109787236,59237,53100,6137,0.10360079004676132,2021-12-03 00:14:14 UTC
804106,mainnet,254,109728000,109787368,59369,53228,6141,0.10343782108507807,2021-12-03 00:15:45 UTC
804107,mainnet,254,109728000,109787577,59578,53424,6154,0.10329316190540132,2021-12-03 00:17:17 UTC
804109,mainnet,254,109728000,109787770,59771,53599,6172,0.10326077863847016,2021-12-03 00:18:47 UTC
804110,mainnet,254,109728000,109787930,59931,53755,6176,0.10305184295272897,2021-12-03 00:20:17 UTC
804111,mainnet,254,109728000,109788113,60114,53933,6181,0.10282130618491533,2021-12-03 00:21:50 UTC
804113,mainnet,254,109728000,109788300,60301,54109,6192,0.10268486426427423,2021-12-03 00:23:20 UTC
804114,mainnet,254,109728000,109788486,60487,54285,6202,0.10253442888554565,2021-12-03 00:24:52 UTC
804116,mainnet,254,109728000,109788652,60653,54442,6211,0.10240218950422897,2021-12-03 00:26:26 UTC
804117,mainnet,254,109728000,109788797,60798,54575,6223,0.10235534063620513,2021-12-03 00:27:58 UTC
804119,mainnet,254,109728000,109788968,60969,54741,6228,0.10215027308960291,2021-12-03 00:29:32 UTC
804120,mainnet,254,109728000,109789152,61153,54917,6236,0.10197373800140631,2021-12-03 00:31:06 UTC
804122,mainnet,254,109728000,109789349,61350,55093,6257,0.10198859005704972,2021-12-03 00:32:46 UTC
804124,mainnet,254,109728000,109789550,61551,55278,6273,0.1019154847199883,2021-12-03 00:34:27 UTC
804125,mainnet,254,109728000,109789724,61725,55450,6275,0.1016605913325233,2021-12-03 00:36:01 UTC
804126,mainnet,254,109728000,109789974,61975,55699,6276,0.10126663977410245,2021-12-03 00:38:14 UTC
804127,mainnet,254,109728000,109790183,62184,55899,6285,0.10107101505210343,2021-12-03 00:39:50 UTC
804129,mainnet,254,109728000,109790370,62371,56081,6290,0.1008481505828029,2021-12-03 00:41:33 UTC
804130,mainnet,254,109728000,109790530,62531,56231,6300,0.10075002798611889,2021-12-03 00:43:03 UTC
804132,mainnet,254,109728000,109790725,62726,56409,6317,0.10070784044893664,2021-12-03 00:44:32 UTC
804133,mainnet,254,109728000,109790873,62874,56557,6317,0.10047078283551229,2021-12-03 00:46:25 UTC
804135,mainnet,254,109728000,109791105,63106,56752,6354,0.10068773175292366,2021-12-03 00:47:56 UTC
804136,mainnet,254,109728000,109791287,63288,56929,6359,0.10047718366830995,2021-12-03 00:49:28 UTC
804138,mainnet,254,109728000,109791468,63469,57105,6364,0.10026942286785676,2021-12-03 00:51:06 UTC
804139,mainnet,254,109728000,109791653,63654,57276,6378,0.1001979451409181,2021-12-03 00:52:47 UTC
804141,mainnet,254,109728000,109791817,63818,57433,6385,0.10005014259299884,2021-12-03 00:54:33 UTC
804142,mainnet,254,109728000,109792023,64024,57620,6404,0.1000249906285143,2021-12-03 00:56:10 UTC
804144,mainnet,254,109728000,109792208,64209,57800,6409,0.09981466772570824,2021-12-03 00:57:39 UTC
804145,mainnet,254,109728000,109792390,64391,57976,6415,0.0996257240918762,2021-12-03 00:59:13 UTC
804147,mainnet,254,109728000,109792596,64597,58174,6423,0.09943186216078147,2021-12-03 01:00:56 UTC
804149,mainnet,254,109728000,109792812,64813,58377,6436,0.09930106614413775,2021-12-03 01:02:46 UTC
804150,mainnet,254,109728000,109792996,64997,58560,6437,0.09903534009261966,2021-12-03 01:04:22 UTC
804152,mainnet,254,109728000,109793175,65176,58734,6442,0.09884006382717565,2021-12-03 01:05:56 UTC
804153,mainnet,254,109728000,109793365,65366,58909,6457,0.09878224153229508,2021-12-03 01:07:29 UTC
804155,mainnet,254,109728000,109793552,65553,59082,6471,0.09871401766509542,2021-12-03 01:09:12 UTC
804156,mainnet,254,109728000,109793766,65767,59283,6484,0.09859047850745815,2021-12-03 01:10:56 UTC
804157,mainnet,254,109728000,109793948,65949,59460,6489,0.09839421371059455,2021-12-03 01:12:33 UTC
804159,mainnet,254,109728000,109794141,66142,59652,6490,0.09812222188624474,2021-12-03 01:14:07 UTC
804160,mainnet,254,109728000,109794326,66327,59830,6497,0.09795407601730818,2021-12-03 01:15:47 UTC
804162,mainnet,254,109728000,109794492,66493,59994,6499,0.09773961168844841,2021-12-03 01:17:23 UTC
804163,mainnet,254,109728000,109794691,66692,60173,6519,0.09774785581479038,2021-12-03 01:19:04 UTC
804165,mainnet,254,109728000,109795129,67130,60597,6533,0.09731863548339044,2021-12-03 01:22:44 UTC
804167,mainnet,254,109728000,109795300,67301,60767,6534,0.09708622457318614,2021-12-03 01:24:18 UTC
804168,mainnet,254,109728000,109795486,67487,60944,6543,0.09695200557144339,2021-12-03 01:25:51 UTC
804170,mainnet,254,109728000,109795653,67654,61106,6548,0.09678659059331303,2021-12-03 01:27:32 UTC
804171,mainnet,254,109728000,109795849,67850,61291,6559,0.09666912306558585,2021-12-03 01:29:11 UTC
804172,mainnet,254,109728000,109796030,68031,61459,6572,0.0966030192118299,2021-12-03 01:30:47 UTC
804173,mainnet,254,109728000,109796173,68174,61577,6597,0.09676709596033678,2021-12-03 01:32:22 UTC
804175,mainnet,254,109728000,109796393,68394,61788,6606,0.09658741994911835,2021-12-03 01:34:11 UTC
804176,mainnet,254,109728000,109796565,68566,61949,6617,0.09650555668990461,2021-12-03 01:35:44 UTC
804178,mainnet,254,109728000,109796743,68744,62125,6619,0.0962847666705458,2021-12-03 01:37:14 UTC
804179,mainnet,254,109728000,109796962,68963,62331,6632,0.09616751011411917,2021-12-03 01:39:06 UTC
804181,mainnet,254,109728000,109797150,69151,62513,6638,0.09599282729100085,2021-12-03 01:40:38 UTC
804182,mainnet,254,109728000,109797366,69367,62717,6650,0.09586691077890062,2021-12-03 01:42:23 UTC
804184,mainnet,254,109728000,109797560,69561,62899,6662,0.09577205618090597,2021-12-03 01:44:04 UTC
804186,mainnet,254,109728000,109797776,69777,63102,6675,0.0956618943204781,2021-12-03 01:45:57 UTC
804187,mainnet,254,109728000,109797997,69998,63311,6687,0.09553130089431126,2021-12-03 01:48:03 UTC
804189,mainnet,254,109728000,109798188,70189,63474,6715,0.09567026172192224,2021-12-03 01:49:37 UTC
804190,mainnet,254,109728000,109798362,70363,63631,6732,0.09567528388499638,2021-12-03 01:51:14 UTC
804192,mainnet,254,109728000,109798544,70545,63807,6738,0.09551350201998725,2021-12-03 01:52:45 UTC
804193,mainnet,254,109728000,109798734,70735,63988,6747,0.09538418039160246,2021-12-03 01:54:21 UTC
804195,mainnet,254,109728000,109798908,70909,64160,6749,0.09517832715170148,2021-12-03 01:55:54 UTC
804196,mainnet,254,109728000,109799038,71039,64287,6752,0.09504638297273328,2021-12-03 01:57:26 UTC
804198,mainnet,254,109728000,109799287,71288,64520,6768,0.09493883963640444,2021-12-03 01:59:27 UTC
804199,mainnet,254,109728000,109799516,71517,64734,6783,0.09484458240698015,2021-12-03 02:01:07 UTC
804200,mainnet,254,109728000,109799697,71698,64913,6785,0.09463304415743815,2021-12-03 02:02:40 UTC
804202,mainnet,254,109728000,109799855,71856,65058,6798,0.0946058784235137,2021-12-03 02:04:12 UTC
804203,mainnet,254,109728000,109800047,72048,65241,6807,0.09447868087941372,2021-12-03 02:05:42 UTC
804204,mainnet,254,109728000,109800230,72231,65412,6819,0.09440544918386842,2021-12-03 02:07:16 UTC
804206,mainnet,254,109728000,109800397,72398,65567,6831,0.09435343517776734,2021-12-03 02:08:48 UTC
804207,mainnet,254,109728000,109800597,72598,65753,6845,0.09428634397641808,2021-12-03 02:10:20 UTC
804209,mainnet,254,109728000,109800789,72790,65944,6846,0.09405138068415991,2021-12-03 02:11:55 UTC
804210,mainnet,254,109728000,109800964,72965,66115,6850,0.09388062769821147,2021-12-03 02:13:26 UTC
804212,mainnet,254,109728000,109801147,73148,66289,6859,0.09376879750642533,2021-12-03 02:14:55 UTC
804213,mainnet,254,109728000,109801326,73327,66464,6863,0.09359444679313213,2021-12-03 02:16:25 UTC
804214,mainnet,254,109728000,109801500,73501,66634,6867,0.09342730030883933,2021-12-03 02:17:56 UTC
804215,mainnet,254,109728000,109801676,73677,66805,6872,0.09327198447276626,2021-12-03 02:19:31 UTC
804217,mainnet,254,109728000,109801846,73847,66972,6875,0.0930978915866589,2021-12-03 02:21:01 UTC
804218,mainnet,254,109728000,109802016,74017,67135,6882,0.09297864004215248,2021-12-03 02:22:32 UTC
804219,mainnet,254,109728000,109802187,74188,67303,6885,0.09280476626947755,2021-12-03 02:24:00 UTC
804220,mainnet,254,109728000,109802367,74368,67478,6890,0.0926473752151463,2021-12-03 02:25:37 UTC
804221,mainnet,254,109728000,109802552,74553,67655,6898,0.09252478102826177,2021-12-03 02:27:08 UTC
804222,mainnet,254,109728000,109802736,74737,67835,6902,0.0923505091186427,2021-12-03 02:28:44 UTC
804224,mainnet,254,109728000,109802918,74919,68012,6907,0.09219290166713384,2021-12-03 02:30:29 UTC
804225,mainnet,254,109728000,109803125,75126,68191,6935,0.09231158320687911,2021-12-03 02:32:01 UTC
804227,mainnet,254,109728000,109803269,75270,68335,6935,0.092134980736017,2021-12-03 02:33:31 UTC
804228,mainnet,254,109728000,109803468,75469,68524,6945,0.09202453987730061,2021-12-03 02:35:04 UTC
804230,mainnet,254,109728000,109803632,75633,68679,6954,0.0919439927015985,2021-12-03 02:36:35 UTC
804231,mainnet,254,109728000,109803813,75814,68847,6967,0.0918959558920516,2021-12-03 02:38:11 UTC
804233,mainnet,254,109728000,109803997,75998,69023,6975,0.09177873101923735,2021-12-03 02:39:44 UTC
804234,mainnet,254,109728000,109804164,76165,69184,6981,0.0916562725661393,2021-12-03 02:41:18 UTC
804236,mainnet,254,109728000,109804339,76340,69349,6991,0.09157715483363899,2021-12-03 02:42:50 UTC
804237,mainnet,254,109728000,109804508,76509,69509,7000,0.09149250414983857,2021-12-03 02:44:23 UTC
804239,mainnet,254,109728000,109804669,76670,69656,7014,0.091482979000913,2021-12-03 02:45:57 UTC
804240,mainnet,254,109728000,109804814,76815,69793,7022,0.09141443728438456,2021-12-03 02:47:30 UTC
804242,mainnet,254,109728000,109804999,77000,69954,7046,0.09150649350649351,2021-12-03 02:49:06 UTC
804243,mainnet,254,109728000,109805144,77145,70097,7048,0.09136042517337481,2021-12-03 02:50:43 UTC
804245,mainnet,254,109728000,109805303,77304,70249,7055,0.09126306530063127,2021-12-03 02:52:16 UTC
804246,mainnet,254,109728000,109805515,77516,70454,7062,0.09110377212446463,2021-12-03 02:54:08 UTC
804248,mainnet,254,109728000,109805696,77697,70622,7075,0.09105885684131948,2021-12-03 02:55:54 UTC
804249,mainnet,254,109728000,109805885,77886,70788,7098,0.0911331946691318,2021-12-03 02:57:36 UTC
804251,mainnet,254,109728000,109806105,78106,70994,7112,0.09105574475712493,2021-12-03 02:59:30 UTC
804253,mainnet,254,109728000,109806340,78341,71212,7129,0.09099960429404781,2021-12-03 03:01:29 UTC
804254,mainnet,254,109728000,109806513,78514,71375,7139,0.09092645897546935,2021-12-03 03:03:15 UTC
804256,mainnet,254,109728000,109806735,78736,71587,7149,0.09079709408656778,2021-12-03 03:05:02 UTC
804257,mainnet,254,109728000,109806889,78890,71735,7155,0.09069590569146914,2021-12-03 03:06:36 UTC
804259,mainnet,254,109728000,109807074,79075,71902,7173,0.09071134998419222,2021-12-03 03:08:09 UTC
804260,mainnet,254,109728000,109807298,79299,72122,7177,0.09050555492503058,2021-12-03 03:10:13 UTC
804262,mainnet,254,109728000,109807500,79501,72318,7183,0.09035106476648093,2021-12-03 03:11:58 UTC
804264,mainnet,254,109728000,109807705,79706,72515,7191,0.09021905502722505,2021-12-03 03:13:53 UTC
804265,mainnet,254,109728000,109807883,79884,72688,7196,0.09008061689449702,2021-12-03 03:15:30 UTC
804267,mainnet,254,109728000,109808039,80040,72837,7203,0.08999250374812594,2021-12-03 03:17:06 UTC
804268,mainnet,254,109728000,109808245,80246,73031,7215,0.08991102360242255,2021-12-03 03:18:47 UTC
804270,mainnet,254,109728000,109808430,80431,73209,7222,0.08979124964255075,2021-12-03 03:20:33 UTC
804271,mainnet,254,109728000,109808505,80506,73268,7238,0.08990634238441855,2021-12-03 03:22:06 UTC
804273,mainnet,254,109728000,109808756,80757,73516,7241,0.08966405389006525,2021-12-03 03:23:40 UTC
804274,mainnet,254,109728000,109808945,80946,73695,7251,0.08957823734341412,2021-12-03 03:25:17 UTC
804276,mainnet,254,109728000,109809096,81097,73844,7253,0.08943610737758487,2021-12-03 03:26:49 UTC
804277,mainnet,254,109728000,109809263,81264,74006,7258,0.08931384130734396,2021-12-03 03:28:23 UTC
804279,mainnet,254,109728000,109809446,81447,74172,7275,0.08932189030903533,2021-12-03 03:29:59 UTC
804280,mainnet,254,109728000,109809626,81627,74350,7277,0.08914942359758413,2021-12-03 03:31:34 UTC
804281,mainnet,254,109728000,109809799,81800,74516,7284,0.08904645476772616,2021-12-03 03:33:06 UTC
804282,mainnet,254,109728000,109809977,81978,74680,7298,0.08902388445680548,2021-12-03 03:34:37 UTC
804283,mainnet,254,109728000,109810145,82146,74838,7308,0.08896355269885325,2021-12-03 03:36:09 UTC
804284,mainnet,254,109728000,109810307,82308,74985,7323,0.08897069543665258,2021-12-03 03:37:41 UTC
804286,mainnet,254,109728000,109810476,82477,75134,7343,0.08903088133661506,2021-12-03 03:39:14 UTC
804287,mainnet,254,109728000,109810653,82654,75297,7357,0.08900960631064438,2021-12-03 03:40:51 UTC
804289,mainnet,254,109728000,109810834,82835,75475,7360,0.08885133095913562,2021-12-03 03:42:27 UTC
804290,mainnet,254,109728000,109811009,83010,75646,7364,0.0887122033489941,2021-12-03 03:43:57 UTC
804292,mainnet,254,109728000,109811192,83193,75810,7383,0.08874544733330929,2021-12-03 03:45:32 UTC
804293,mainnet,254,109728000,109811328,83329,75946,7383,0.08860060723157605,2021-12-03 03:47:03 UTC
804294,mainnet,254,109728000,109811413,83414,76009,7405,0.08877406670343108,2021-12-03 03:48:42 UTC
804295,mainnet,254,109728000,109811690,83691,76265,7426,0.08873116583623089,2021-12-03 03:50:14 UTC
804297,mainnet,254,109728000,109811854,83855,76408,7447,0.0888080615347922,2021-12-03 03:51:47 UTC
804298,mainnet,254,109728000,109812030,84031,76576,7455,0.08871725910675822,2021-12-03 03:53:18 UTC
804300,mainnet,254,109728000,109812212,84213,76752,7461,0.0885967724698087,2021-12-03 03:54:53 UTC
804301,mainnet,254,109728000,109812383,84384,76918,7466,0.08847648843382631,2021-12-03 03:56:29 UTC
804303,mainnet,254,109728000,109812572,84573,77099,7474,0.08837335792747095,2021-12-03 03:58:07 UTC
804304,mainnet,254,109728000,109812726,84727,77244,7483,0.08831895381637495,2021-12-03 03:59:38 UTC
804306,mainnet,254,109728000,109812930,84931,77431,7500,0.08830697860616266,2021-12-03 04:01:29 UTC
804308,mainnet,254,109728000,109813080,85081,77558,7523,0.08842162174868655,2021-12-03 04:03:12 UTC
804309,mainnet,254,109728000,109813337,85338,77791,7547,0.08843656987508496,2021-12-03 04:04:56 UTC
804311,mainnet,254,109728000,109813500,85501,77948,7553,0.08833814809183518,2021-12-03 04:06:32 UTC
804312,mainnet,254,109728000,109813674,85675,78109,7566,0.08831047563466589,2021-12-03 04:08:07 UTC
804314,mainnet,254,109728000,109813876,85877,78310,7567,0.0881143961712682,2021-12-03 04:09:52 UTC
804315,mainnet,254,109728000,109814083,86084,78508,7576,0.0880070628688258,2021-12-03 04:11:37 UTC
804317,mainnet,254,109728000,109814261,86262,78682,7580,0.08787183232477801,2021-12-03 04:13:09 UTC
804318,mainnet,254,109728000,109814443,86444,78856,7588,0.08777937161630651,2021-12-03 04:14:47 UTC
804320,mainnet,254,109728000,109814632,86633,79034,7599,0.08771484307365554,2021-12-03 04:16:31 UTC
804321,mainnet,254,109728000,109814822,86823,79213,7610,0.08764958593920966,2021-12-03 04:18:16 UTC
804322,mainnet,254,109728000,109814996,86997,79379,7618,0.08756623791624998,2021-12-03 04:19:51 UTC
804324,mainnet,254,109728000,109815150,87151,79513,7638,0.08764099092379893,2021-12-03 04:21:47 UTC
804326,mainnet,254,109728000,109815394,87395,79746,7649,0.08752216946049546,2021-12-03 04:23:22 UTC
804327,mainnet,254,109728000,109815583,87584,79929,7655,0.08740180854950676,2021-12-03 04:25:06 UTC
804329,mainnet,254,109728000,109815783,87784,80124,7660,0.08725963729153377,2021-12-03 04:26:56 UTC
804330,mainnet,254,109728000,109815979,87980,80307,7673,0.0872130029552171,2021-12-03 04:28:27 UTC
804332,mainnet,254,109728000,109816152,88153,80477,7676,0.08707587943688813,2021-12-03 04:30:00 UTC
804333,mainnet,254,109728000,109816324,88325,80644,7681,0.08696292103028587,2021-12-03 04:31:36 UTC
804335,mainnet,254,109728000,109816501,88502,80815,7687,0.08685679419674132,2021-12-03 04:33:08 UTC
804336,mainnet,254,109728000,109816693,88694,81001,7693,0.08673641959997294,2021-12-03 04:34:49 UTC
804338,mainnet,254,109728000,109816876,88877,81172,7705,0.08669284516804122,2021-12-03 04:36:34 UTC
804339,mainnet,254,109728000,109817111,89112,81404,7708,0.08649789029535865,2021-12-03 04:38:35 UTC
804341,mainnet,254,109728000,109817317,89318,81609,7709,0.08630959045209252,2021-12-03 04:40:21 UTC
804343,mainnet,254,109728000,109817510,89511,81793,7718,0.08622403950352471,2021-12-03 04:41:57 UTC
804344,mainnet,254,109728000,109817733,89734,82004,7730,0.08614349076158424,2021-12-03 04:43:51 UTC
804345,mainnet,254,109728000,109817902,89903,82168,7735,0.08603717339799562,2021-12-03 04:45:27 UTC
804346,mainnet,254,109728000,109818086,90087,82341,7746,0.08598354923573878,2021-12-03 04:47:01 UTC
804348,mainnet,254,109728000,109818291,90292,82542,7750,0.08583263190537367,2021-12-03 04:48:47 UTC
804349,mainnet,254,109728000,109818502,90503,82736,7767,0.08582035954609239,2021-12-03 04:50:24 UTC
804351,mainnet,254,109728000,109818642,90643,82866,7777,0.08579813112981698,2021-12-03 04:52:00 UTC
804352,mainnet,254,109728000,109818841,90842,83047,7795,0.0858083265449902,2021-12-03 04:53:33 UTC
804354,mainnet,254,109728000,109819080,91081,83271,7810,0.08574785081411052,2021-12-03 04:55:45 UTC
804356,mainnet,254,109728000,109819314,91315,83483,7832,0.08576904123090401,2021-12-03 04:57:59 UTC
804357,mainnet,254,109728000,109819525,91526,83692,7834,0.08559316478377729,2021-12-03 04:59:32 UTC
804359,mainnet,254,109728000,109819796,91797,83950,7847,0.08548209636480494,2021-12-03 05:01:50 UTC
804360,mainnet,254,109728000,109819966,91967,84095,7872,0.08559592027575108,2021-12-03 05:03:23 UTC
804362,mainnet,254,109728000,109820151,92152,84272,7880,0.08551089504297248,2021-12-03 05:05:01 UTC
804363,mainnet,254,109728000,109820340,92341,84445,7896,0.08550914545001678,2021-12-03 05:06:34 UTC
804365,mainnet,254,109728000,109820506,92507,84599,7908,0.08548542272476678,2021-12-03 05:08:06 UTC
804366,mainnet,254,109728000,109820648,92649,84741,7908,0.08535440209824176,2021-12-03 05:09:41 UTC
804368,mainnet,254,109728000,109820780,92781,84863,7918,0.08534074864465785,2021-12-03 05:11:18 UTC
804369,mainnet,254,109728000,109821011,93012,85061,7951,0.0854835935148153,2021-12-03 05:12:53 UTC
804370,mainnet,254,109728000,109821225,93226,85272,7954,0.08531954604938537,2021-12-03 05:14:33 UTC
804372,mainnet,254,109728000,109821393,93394,85438,7956,0.08518748527742681,2021-12-03 05:16:06 UTC
804373,mainnet,254,109728000,109821567,93568,85612,7956,0.08502906976744186,2021-12-03 05:17:39 UTC
804374,mainnet,254,109728000,109821752,93753,85788,7965,0.08495728136699626,2021-12-03 05:19:12 UTC
804375,mainnet,254,109728000,109821929,93930,85957,7973,0.0848823592036623,2021-12-03 05:20:45 UTC
804377,mainnet,254,109728000,109821998,93999,86022,7977,0.08486260492132895,2021-12-03 05:22:33 UTC
804379,mainnet,254,109728000,109822308,94309,86295,8014,0.08497598320414806,2021-12-03 05:24:08 UTC
804380,mainnet,254,109728000,109822534,94535,86500,8035,0.08499497540593431,2021-12-03 05:26:09 UTC
804382,mainnet,254,109728000,109822750,94751,86701,8050,0.08495952549313464,2021-12-03 05:27:53 UTC
804383,mainnet,254,109728000,109822938,94939,86884,8055,0.08484395243261462,2021-12-03 05:29:31 UTC
804384,mainnet,254,109728000,109823092,95093,87024,8069,0.08485377472579475,2021-12-03 05:31:05 UTC
804385,mainnet,254,109728000,109823281,95282,87206,8076,0.08475892613505175,2021-12-03 05:32:41 UTC
804387,mainnet,254,109728000,109823471,95472,87382,8090,0.08473688620747444,2021-12-03 05:34:14 UTC
804388,mainnet,254,109728000,109823653,95654,87558,8096,0.0846383841763021,2021-12-03 05:35:49 UTC
804390,mainnet,254,109728000,109823836,95837,87730,8107,0.08459154606258543,2021-12-03 05:37:33 UTC
804391,mainnet,254,109728000,109824029,96030,87916,8114,0.08449442882432573,2021-12-03 05:39:11 UTC
804392,mainnet,254,109728000,109824207,96208,88094,8114,0.08433810078163978,2021-12-03 05:40:46 UTC
804393,mainnet,254,109728000,109824406,96407,88270,8137,0.0844025848745423,2021-12-03 05:42:34 UTC
804395,mainnet,254,109728000,109824571,96572,88425,8147,0.08436192685250384,2021-12-03 05:44:12 UTC
804397,mainnet,254,109728000,109824821,96822,88648,8174,0.08442296172357522,2021-12-03 05:46:20 UTC
804398,mainnet,254,109728000,109825016,97017,88837,8180,0.08431512003051012,2021-12-03 05:48:02 UTC
804400,mainnet,254,109728000,109825227,97228,89034,8194,0.08427613444686716,2021-12-03 05:49:57 UTC
804401,mainnet,254,109728000,109825442,97443,89239,8204,0.08419281015568075,2021-12-03 05:51:48 UTC
804403,mainnet,254,109728000,109825629,97630,89401,8229,0.08428761651131825,2021-12-03 05:53:32 UTC
804404,mainnet,254,109728000,109825839,97840,89607,8233,0.08414758789860997,2021-12-03 05:55:19 UTC
804406,mainnet,254,109728000,109826028,98029,89786,8243,0.08408736190311031,2021-12-03 05:57:04 UTC
804408,mainnet,254,109728000,109826223,98224,89974,8250,0.08399169245805506,2021-12-03 05:58:49 UTC
804409,mainnet,254,109728000,109826426,98427,90172,8255,0.0838692635150924,2021-12-03 06:00:37 UTC
804411,mainnet,254,109728000,109826593,98594,90330,8264,0.08381848794044262,2021-12-03 06:02:14 UTC
804412,mainnet,254,109728000,109826785,98786,90509,8277,0.08378717632053125,2021-12-03 06:03:58 UTC
804414,mainnet,254,109728000,109826972,98973,90692,8281,0.0836692835419761,2021-12-03 06:05:33 UTC
804415,mainnet,254,109728000,109827133,99134,90833,8301,0.08373514636754292,2021-12-03 06:07:07 UTC
804416,mainnet,254,109728000,109827309,99310,91004,8306,0.08363709596213875,2021-12-03 06:08:39 UTC
804417,mainnet,254,109728000,109827488,99489,91172,8317,0.0835971815979656,2021-12-03 06:10:16 UTC
804418,mainnet,254,109728000,109827673,99674,91349,8325,0.083522282641411,2021-12-03 06:11:51 UTC
804419,mainnet,254,109728000,109827856,99857,91520,8337,0.08348938982745326,2021-12-03 06:13:33 UTC
804421,mainnet,254,109728000,109828049,100050,91704,8346,0.08341829085457271,2021-12-03 06:15:08 UTC
804422,mainnet,254,109728000,109828224,100225,91872,8353,0.08334247942130207,2021-12-03 06:16:45 UTC
804424,mainnet,254,109728000,109828412,100413,92046,8367,0.08332586418093275,2021-12-03 06:18:23 UTC
804425,mainnet,254,109728000,109828589,100590,92219,8371,0.08321900785366339,2021-12-03 06:20:00 UTC
804427,mainnet,254,109728000,109828782,100783,92405,8378,0.0831290991536271,2021-12-03 06:21:39 UTC
804428,mainnet,254,109728000,109828956,100957,92569,8388,0.08308487772021751,2021-12-03 06:23:13 UTC
804430,mainnet,254,109728000,109829142,101143,92742,8401,0.08306061714602098,2021-12-03 06:24:51 UTC
804431,mainnet,254,109728000,109829339,101340,92935,8405,0.08293862245904875,2021-12-03 06:26:25 UTC
804433,mainnet,254,109728000,109829532,101533,93126,8407,0.08280066579338737,2021-12-03 06:28:12 UTC
804435,mainnet,254,109728000,109829734,101735,93316,8419,0.08275421438049835,2021-12-03 06:29:56 UTC
804436,mainnet,254,109728000,109829911,101912,93472,8440,0.08281654760970249,2021-12-03 06:31:34 UTC
804438,mainnet,254,109728000,109830085,102086,93636,8450,0.08277334796152264,2021-12-03 06:33:14 UTC
804439,mainnet,254,109728000,109830216,102217,93753,8464,0.08280423021610887,2021-12-03 06:34:53 UTC
804441,mainnet,254,109728000,109830458,102459,93970,8489,0.08285265325642452,2021-12-03 06:36:28 UTC
804442,mainnet,254,109728000,109830635,102636,94131,8505,0.08286566117151876,2021-12-03 06:38:17 UTC
804444,mainnet,254,109728000,109830819,102820,94302,8518,0.0828438047072554,2021-12-03 06:39:53 UTC
804445,mainnet,254,109728000,109831000,103001,94474,8527,0.0827856040232619,2021-12-03 06:41:31 UTC
804447,mainnet,254,109728000,109831144,103145,94616,8529,0.08268941780987929,2021-12-03 06:43:09 UTC
804448,mainnet,254,109728000,109831381,103382,94829,8553,0.08273200363699677,2021-12-03 06:44:48 UTC
804450,mainnet,254,109728000,109831583,103584,95020,8564,0.08267686129131913,2021-12-03 06:46:33 UTC
804451,mainnet,254,109728000,109831770,103771,95193,8578,0.08266278632758671,2021-12-03 06:48:12 UTC
804452,mainnet,254,109728000,109832016,104017,95431,8586,0.08254419950585,2021-12-03 06:50:23 UTC
804454,mainnet,254,109728000,109832197,104198,95606,8592,0.08245839651432849,2021-12-03 06:52:05 UTC
804456,mainnet,254,109728000,109832383,104384,95778,8606,0.08244558553034947,2021-12-03 06:54:03 UTC
804457,mainnet,254,109728000,109832626,104627,96011,8616,0.08234968029284984,2021-12-03 06:55:48 UTC
804458,mainnet,254,109728000,109832845,104846,96225,8621,0.0822253590981058,2021-12-03 06:57:38 UTC
804460,mainnet,254,109728000,109833034,105035,96390,8645,0.08230589803398868,2021-12-03 06:59:18 UTC
804461,mainnet,254,109728000,109833273,105274,96611,8663,0.08229002412751486,2021-12-03 07:01:19 UTC
804463,mainnet,254,109728000,109833479,105480,96811,8669,0.0821861964353432,2021-12-03 07:03:10 UTC
804465,mainnet,254,109728000,109833680,105681,96997,8684,0.08217181896461995,2021-12-03 07:04:49 UTC
804466,mainnet,254,109728000,109833871,105872,97179,8693,0.0821085839504307,2021-12-03 07:06:34 UTC
804468,mainnet,254,109728000,109834076,106077,97370,8707,0.08208188391451493,2021-12-03 07:08:37 UTC
804469,mainnet,254,109728000,109834289,106290,97570,8720,0.08203970270015994,2021-12-03 07:10:18 UTC
804471,mainnet,254,109728000,109834470,106471,97750,8721,0.08190962797381447,2021-12-03 07:11:53 UTC
804472,mainnet,254,109728000,109834635,106636,97912,8724,0.08181102066844217,2021-12-03 07:13:32 UTC
804474,mainnet,254,109728000,109834846,106847,98102,8745,0.0818460040993196,2021-12-03 07:15:08 UTC
804475,mainnet,254,109728000,109835009,107010,98263,8747,0.0817400242967947,2021-12-03 07:16:44 UTC
804477,mainnet,254,109728000,109835187,107188,98435,8753,0.08166026047691906,2021-12-03 07:18:19 UTC
804478,mainnet,254,109728000,109835385,107386,98624,8762,0.08159350380869014,2021-12-03 07:19:55 UTC
804480,mainnet,254,109728000,109835575,107576,98800,8776,0.08157953446865472,2021-12-03 07:21:33 UTC
804481,mainnet,254,109728000,109835752,107753,98963,8790,0.08157545497573153,2021-12-03 07:23:10 UTC
804483,mainnet,254,109728000,109835958,107959,99160,8799,0.08150316323789587,2021-12-03 07:24:53 UTC
804484,mainnet,254,109728000,109836134,108135,99335,8800,0.08137975678549961,2021-12-03 07:26:27 UTC
804485,mainnet,254,109728000,109836323,108324,99504,8820,0.08142239946826188,2021-12-03 07:28:05 UTC
804486,mainnet,254,109728000,109836504,108505,99680,8825,0.08133265748122206,2021-12-03 07:29:38 UTC
804487,mainnet,254,109728000,109836668,108669,99838,8831,0.08126512620894644,2021-12-03 07:31:13 UTC
804488,mainnet,254,109728000,109836857,108858,100013,8845,0.08125264105531978,2021-12-03 07:33:01 UTC
804490,mainnet,254,109728000,109837073,109074,100205,8869,0.08131176999101528,2021-12-03 07:34:48 UTC
804491,mainnet,254,109728000,109837264,109265,100374,8891,0.08137097881297763,2021-12-03 07:36:33 UTC
804493,mainnet,254,109728000,109837469,109470,100568,8902,0.08131908285374989,2021-12-03 07:38:31 UTC
804494,mainnet,254,109728000,109837632,109633,100701,8932,0.08147181961635638,2021-12-03 07:40:09 UTC
804495,mainnet,254,109728000,109837836,109837,100905,8932,0.08132050219871263,2021-12-03 07:41:50 UTC
804497,mainnet,254,109728000,109838028,110029,101092,8937,0.08122404093466268,2021-12-03 07:43:28 UTC
804498,mainnet,254,109728000,109838242,110243,101290,8953,0.08121150549241221,2021-12-03 07:45:25 UTC
804500,mainnet,254,109728000,109838428,110429,101466,8963,0.08116527361472077,2021-12-03 07:47:13 UTC
804501,mainnet,254,109728000,109838621,110622,101659,8963,0.08102366617851783,2021-12-03 07:48:55 UTC
804503,mainnet,254,109728000,109838838,110839,101871,8968,0.08091014895479028,2021-12-03 07:50:50 UTC
804504,mainnet,254,109728000,109839007,111008,102035,8973,0.08083201210723552,2021-12-03 07:52:25 UTC
804506,mainnet,254,109728000,109839221,111222,102232,8990,0.08082933232633832,2021-12-03 07:54:21 UTC
804508,mainnet,254,109728000,109839399,111400,102399,9001,0.08079892280071813,2021-12-03 07:56:07 UTC
804509,mainnet,254,109728000,109839599,111600,102577,9023,0.08085125448028674,2021-12-03 07:57:52 UTC
804511,mainnet,254,109728000,109839800,111801,102775,9026,0.08073273047647159,2021-12-03 07:59:41 UTC
804512,mainnet,254,109728000,109840017,112018,102983,9035,0.08065668017640022,2021-12-03 08:01:40 UTC
804514,mainnet,254,109728000,109840210,112211,103173,9038,0.08054468813217955,2021-12-03 08:03:15 UTC
804515,mainnet,254,109728000,109840398,112399,103361,9038,0.08040996806021405,2021-12-03 08:05:04 UTC
804517,mainnet,254,109728000,109840562,112563,103516,9047,0.08037276902712259,2021-12-03 08:06:41 UTC
804518,mainnet,254,109728000,109840767,112768,103717,9051,0.08026213110102157,2021-12-03 08:08:32 UTC
804520,mainnet,254,109728000,109840982,112983,103920,9063,0.08021560765778922,2021-12-03 08:10:24 UTC
804522,mainnet,254,109728000,109841173,113174,104098,9076,0.08019509781398554,2021-12-03 08:12:02 UTC
804523,mainnet,254,109728000,109841368,113369,104281,9088,0.08016300752410271,2021-12-03 08:13:47 UTC
804525,mainnet,254,109728000,109841544,113545,104442,9103,0.08017085736932494,2021-12-03 08:15:22 UTC
804526,mainnet,254,109728000,109841708,113709,104604,9105,0.08007281745508271,2021-12-03 08:17:00 UTC
804527,mainnet,254,109728000,109841897,113898,104786,9112,0.08000140476566753,2021-12-03 08:18:38 UTC
804529,mainnet,254,109728000,109842081,114082,104963,9119,0.07993373187707088,2021-12-03 08:20:21 UTC
804530,mainnet,254,109728000,109842325,114326,105188,9138,0.07992932491296818,2021-12-03 08:22:20 UTC
804532,mainnet,254,109728000,109842455,114456,105314,9142,0.07987348850213183,2021-12-03 08:23:58 UTC
804533,mainnet,254,109728000,109842700,114701,105539,9162,0.07987724605713986,2021-12-03 08:25:38 UTC
804535,mainnet,254,109728000,109842904,114905,105732,9173,0.07983116487533179,2021-12-03 08:27:33 UTC
804537,mainnet,254,109728000,109843096,115097,105908,9189,0.07983700704623058,2021-12-03 08:29:30 UTC
804538,mainnet,254,109728000,109843284,115285,106082,9203,0.07982825172398837,2021-12-03 08:31:11 UTC
804540,mainnet,254,109728000,109843480,115481,106263,9218,0.07982265480901621,2021-12-03 08:32:53 UTC
804541,mainnet,254,109728000,109843699,115700,106473,9227,0.07974935177182368,2021-12-03 08:34:43 UTC
804543,mainnet,254,109728000,109843933,115934,106697,9237,0.07967464246899097,2021-12-03 08:36:42 UTC
804545,mainnet,254,109728000,109844136,116137,106896,9241,0.07956981840412616,2021-12-03 08:38:51 UTC
804546,mainnet,254,109728000,109844398,116399,107134,9265,0.07959690375346867,2021-12-03 08:40:52 UTC
804548,mainnet,254,109728000,109844594,116595,107322,9273,0.0795317123375788,2021-12-03 08:42:32 UTC
804549,mainnet,254,109728000,109844842,116843,107561,9282,0.07943993221673527,2021-12-03 08:44:30 UTC
804551,mainnet,254,109728000,109845024,117025,107739,9286,0.07935056611835078,2021-12-03 08:46:18 UTC
804552,mainnet,254,109728000,109845249,117250,107955,9295,0.07927505330490404,2021-12-03 08:48:10 UTC
804553,mainnet,254,109728000,109845440,117441,108134,9307,0.07924830340341107,2021-12-03 08:49:47 UTC
804554,mainnet,254,109728000,109845621,117622,108304,9318,0.07921987383312645,2021-12-03 08:51:22 UTC
804555,mainnet,254,109728000,109845805,117806,108475,9331,0.07920649202926845,2021-12-03 08:53:01 UTC
804557,mainnet,254,109728000,109845977,117978,108647,9331,0.07909101696926546,2021-12-03 08:54:39 UTC
804558,mainnet,254,109728000,109846167,118168,108823,9345,0.07908232347166745,2021-12-03 08:56:21 UTC
804560,mainnet,254,109728000,109846343,118344,108993,9351,0.07901541269519367,2021-12-03 08:57:58 UTC
804561,mainnet,254,109728000,109846544,118545,109170,9375,0.07908389219283816,2021-12-03 08:59:39 UTC
804563,mainnet,254,109728000,109846746,118747,109367,9380,0.07899146925817073,2021-12-03 09:01:28 UTC
804564,mainnet,254,109728000,109846920,118921,109533,9388,0.07894316394917635,2021-12-03 09:03:05 UTC
804565,mainnet,254,109728000,109847097,119098,109696,9402,0.07894339115686241,2021-12-03 09:04:45 UTC
804567,mainnet,254,109728000,109847278,119279,109863,9416,0.07894097033006649,2021-12-03 09:06:20 UTC
804568,mainnet,254,109728000,109847468,119469,110043,9426,0.0788991286442508,2021-12-03 09:08:08 UTC
804570,mainnet,254,109728000,109847645,119646,110200,9446,0.07894956789194792,2021-12-03 09:09:56 UTC
804571,mainnet,254,109728000,109847862,119863,110396,9467,0.07898183759792429,2021-12-03 09:11:54 UTC
804573,mainnet,254,109728000,109848084,120085,110599,9486,0.07899404588416538,2021-12-03 09:13:50 UTC
804574,mainnet,254,109728000,109848297,120298,110796,9502,0.07898718183178441,2021-12-03 09:15:37 UTC
804575,mainnet,254,109728000,109848480,120481,110951,9530,0.07909960906698982,2021-12-03 09:17:21 UTC
804577,mainnet,254,109728000,109848712,120713,111173,9540,0.07903042754301524,2021-12-03 09:19:25 UTC
804578,mainnet,254,109728000,109848894,120895,111349,9546,0.07896108193060093,2021-12-03 09:21:06 UTC
804580,mainnet,254,109728000,109849087,121088,111513,9575,0.07907472251585623,2021-12-03 09:22:44 UTC
804581,mainnet,254,109728000,109849249,121250,111670,9580,0.07901030927835051,2021-12-03 09:24:32 UTC
804583,mainnet,254,109728000,109849510,121511,111900,9611,0.07909571972907803,2021-12-03 09:26:33 UTC
804584,mainnet,254,109728000,109849676,121677,112054,9623,0.07908643375494136,2021-12-03 09:28:11 UTC
804586,mainnet,254,109728000,109849892,121893,112250,9643,0.07911036728934394,2021-12-03 09:29:59 UTC
804587,mainnet,254,109728000,109850073,122074,112409,9665,0.07917328833330603,2021-12-03 09:31:36 UTC
804589,mainnet,254,109728000,109850272,122273,112603,9670,0.07908532546024061,2021-12-03 09:33:25 UTC
804591,mainnet,254,109728000,109850441,122442,112764,9678,0.07904150536580586,2021-12-03 09:35:23 UTC
804592,mainnet,254,109728000,109850713,122714,113032,9682,0.07889890314063595,2021-12-03 09:37:23 UTC
804594,mainnet,254,109728000,109850897,122898,113216,9682,0.07878077755537112,2021-12-03 09:39:27 UTC
804595,mainnet,254,109728000,109851090,123091,113403,9688,0.07870599800147858,2021-12-03 09:41:10 UTC
804597,mainnet,254,109728000,109851318,123319,113611,9708,0.07872266236346387,2021-12-03 09:42:47 UTC
804599,mainnet,254,109728000,109851550,123551,113829,9722,0.07868815307039198,2021-12-03 09:44:58 UTC
804600,mainnet,254,109728000,109851746,123747,114010,9737,0.07868473579157474,2021-12-03 09:46:41 UTC
804602,mainnet,254,109728000,109851929,123930,114168,9762,0.07877027354151538,2021-12-03 09:48:15 UTC
804603,mainnet,254,109728000,109852095,124096,114334,9762,0.07866490458999484,2021-12-03 09:49:51 UTC
804604,mainnet,254,109728000,109852288,124289,114518,9771,0.07861516304741369,2021-12-03 09:51:31 UTC
804605,mainnet,254,109728000,109852457,124458,114676,9782,0.078596795706182,2021-12-03 09:53:11 UTC
804606,mainnet,254,109728000,109852650,124651,114861,9790,0.07853928167443502,2021-12-03 09:54:52 UTC
804608,mainnet,254,109728000,109852835,124836,115037,9799,0.07849498542087219,2021-12-03 09:56:38 UTC
804609,mainnet,254,109728000,109853001,125002,115200,9802,0.07841474536407418,2021-12-03 09:58:13 UTC
804610,mainnet,254,109728000,109853167,125168,115363,9805,0.07833471813882142,2021-12-03 09:59:51 UTC
804611,mainnet,254,109728000,109853340,125341,115517,9824,0.07837818431319361,2021-12-03 10:01:39 UTC
804612,mainnet,254,109728000,109853555,125556,115721,9835,0.07833158112714646,2021-12-03 10:03:38 UTC
804614,mainnet,254,109728000,109853764,125765,115917,9848,0.07830477477835646,2021-12-03 10:05:35 UTC
804616,mainnet,254,109728000,109853964,125965,116098,9867,0.0783312824991069,2021-12-03 10:07:35 UTC
804617,mainnet,254,109728000,109854137,126138,116266,9872,0.07826348919437441,2021-12-03 10:09:24 UTC
804619,mainnet,254,109728000,109854359,126360,116474,9886,0.07823678379233935,2021-12-03 10:11:07 UTC
804620,mainnet,254,109728000,109854546,126547,116655,9892,0.07816858558480248,2021-12-03 10:12:53 UTC
804622,mainnet,254,109728000,109854735,126736,116835,9901,0.07812302739553087,2021-12-03 10:14:43 UTC
804623,mainnet,254,109728000,109854931,126932,117012,9920,0.07815208142942678,2021-12-03 10:16:21 UTC
804625,mainnet,254,109728000,109855133,127134,117213,9921,0.07803577327858795,2021-12-03 10:18:08 UTC
804626,mainnet,254,109728000,109855316,127317,117386,9931,0.07800215210851653,2021-12-03 10:19:45 UTC
804628,mainnet,254,109728000,109855526,127527,117590,9937,0.07792075403640014,2021-12-03 10:21:34 UTC
804629,mainnet,254,109728000,109855696,127697,117755,9942,0.07785617516464756,2021-12-03 10:23:09 UTC
804631,mainnet,254,109728000,109855927,127928,117986,9942,0.07771559001938591,2021-12-03 10:25:00 UTC
804632,mainnet,254,109728000,109856077,128078,118133,9945,0.07764799575258827,2021-12-03 10:26:44 UTC
804634,mainnet,254,109728000,109856279,128280,118308,9972,0.07773620205799812,2021-12-03 10:28:29 UTC
804635,mainnet,254,109728000,109856480,128481,118503,9978,0.0776612884395358,2021-12-03 10:30:15 UTC
804636,mainnet,254,109728000,109856676,128677,118690,9987,0.07761293782105583,2021-12-03 10:32:01 UTC
804638,mainnet,254,109728000,109856861,128862,118875,9987,0.07750151324672906,2021-12-03 10:33:39 UTC
804639,mainnet,254,109728000,109857050,129051,119058,9993,0.07743450263849176,2021-12-03 10:35:17 UTC
804641,mainnet,254,109728000,109857173,129174,119176,9998,0.07739947667487265,2021-12-03 10:36:52 UTC
804642,mainnet,254,109728000,109857355,129356,119357,9999,0.07729830854386345,2021-12-03 10:38:30 UTC
804643,mainnet,254,109728000,109857595,129596,119577,10019,0.07730948486064385,2021-12-03 10:40:08 UTC
804645,mainnet,254,109728000,109857780,129781,119759,10022,0.07722239773156317,2021-12-03 10:41:50 UTC
804646,mainnet,254,109728000,109857956,129957,119931,10026,0.07714859530460075,2021-12-03 10:43:28 UTC
804647,mainnet,254,109728000,109858149,130150,120120,10030,0.07706492508643872,2021-12-03 10:45:05 UTC
804648,mainnet,254,109728000,109858328,130329,120299,10030,0.0769590804809367,2021-12-03 10:46:41 UTC
804650,mainnet,254,109728000,109858485,130486,120454,10032,0.07688181107551768,2021-12-03 10:48:15 UTC
804651,mainnet,254,109728000,109858576,130577,120537,10040,0.07688949815051656,2021-12-03 10:49:49 UTC
804653,mainnet,254,109728000,109858790,130791,120697,10094,0.07717656413667608,2021-12-03 10:51:26 UTC
804654,mainnet,254,109728000,109858803,130804,120706,10098,0.07719947402220116,2021-12-03 10:53:04 UTC
804655,mainnet,254,109728000,109859145,131146,120921,10225,0.07796654110685801,2021-12-03 10:54:44 UTC
804656,mainnet,254,109728000,109859274,131275,121028,10247,0.07805751285469434,2021-12-03 10:56:18 UTC
804657,mainnet,254,109728000,109859429,131430,121142,10288,0.07827741002815186,2021-12-03 10:57:57 UTC
804658,mainnet,254,109728000,109859546,131547,121245,10302,0.07831421469132706,2021-12-03 10:59:32 UTC
804660,mainnet,254,109728000,109859691,131692,121347,10345,0.07855450596847188,2021-12-03 11:01:16 UTC
804661,mainnet,254,109728000,109859847,131848,121469,10379,0.07871943450033372,2021-12-03 11:03:08 UTC
804663,mainnet,254,109728000,109859995,131996,121579,10417,0.07891905815327738,2021-12-03 11:05:16 UTC
804664,mainnet,254,109728000,109860131,132132,121665,10467,0.0792162383071474,2021-12-03 11:06:50 UTC
804666,mainnet,254,109728000,109860304,132305,121792,10513,0.07946033785571217,2021-12-03 11:08:35 UTC
804667,mainnet,254,109728000,109860417,132418,121876,10542,0.07961153317524808,2021-12-03 11:10:13 UTC
804669,mainnet,254,109728000,109860598,132599,121996,10603,0.07996289564778016,2021-12-03 11:11:54 UTC
804670,mainnet,254,109728000,109860733,132734,122107,10627,0.08006238039989753,2021-12-03 11:13:31 UTC
804672,mainnet,254,109728000,109860870,132871,122217,10654,0.08018303467272768,2021-12-03 11:15:22 UTC
804673,mainnet,254,109728000,109861014,133015,122329,10686,0.08033680411983611,2021-12-03 11:17:00 UTC
804675,mainnet,254,109728000,109861149,133150,122448,10702,0.08037551633496057,2021-12-03 11:18:35 UTC
804676,mainnet,254,109728000,109861301,133302,122582,10720,0.08041889844113366,2021-12-03 11:20:16 UTC
804677,mainnet,254,109728000,109861460,133461,122722,10739,0.08046545432748144,2021-12-03 11:21:54 UTC
804679,mainnet,254,109728000,109861652,133653,122907,10746,0.08040223564005297,2021-12-03 11:23:39 UTC
804681,mainnet,254,109728000,109861790,133791,123040,10751,0.08035667571062328,2021-12-03 11:25:27 UTC
804682,mainnet,254,109728000,109862000,134001,123222,10779,0.08043969821120737,2021-12-03 11:27:07 UTC
804684,mainnet,254,109728000,109862175,134176,123378,10798,0.08047638922012879,2021-12-03 11:29:07 UTC
804685,mainnet,254,109728000,109862385,134386,123573,10813,0.08046225053204947,2021-12-03 11:31:02 UTC
804687,mainnet,254,109728000,109862558,134559,123744,10815,0.08037366508371792,2021-12-03 11:32:41 UTC
804688,mainnet,254,109728000,109862731,134732,123910,10822,0.08032241783689101,2021-12-03 11:34:21 UTC
804689,mainnet,254,109728000,109862926,134927,124099,10828,0.0802508022856804,2021-12-03 11:35:59 UTC
804690,mainnet,254,109728000,109863111,135112,124272,10840,0.08022973533068861,2021-12-03 11:37:38 UTC
804692,mainnet,254,109728000,109863274,135275,124431,10844,0.08016263167621512,2021-12-03 11:39:12 UTC
804693,mainnet,254,109728000,109863448,135449,124603,10846,0.08007441915407275,2021-12-03 11:40:50 UTC
804695,mainnet,254,109728000,109863619,135620,124763,10857,0.08005456422356584,2021-12-03 11:42:26 UTC
804696,mainnet,254,109728000,109863785,135786,124925,10861,0.0799861546845772,2021-12-03 11:44:01 UTC
804698,mainnet,254,109728000,109863982,135983,125117,10866,0.07990704720442997,2021-12-03 11:45:40 UTC
804699,mainnet,254,109728000,109864146,136147,125276,10871,0.07984751775654256,2021-12-03 11:47:20 UTC
804701,mainnet,254,109728000,109864340,136341,125469,10872,0.07974123704534952,2021-12-03 11:49:03 UTC
804702,mainnet,254,109728000,109864495,136496,125619,10877,0.07968731684444966,2021-12-03 11:50:43 UTC
804704,mainnet,254,109728000,109864602,136603,125717,10886,0.07969078277929474,2021-12-03 11:52:27 UTC
804705,mainnet,254,109728000,109864907,136908,125996,10912,0.07970315832529874,2021-12-03 11:54:02 UTC
804706,mainnet,254,109728000,109865097,137098,126184,10914,0.07960728821718771,2021-12-03 11:55:43 UTC
804708,mainnet,254,109728000,109865272,137273,126353,10920,0.07954951082878643,2021-12-03 11:57:18 UTC
804709,mainnet,254,109728000,109865375,137376,126456,10920,0.07948986722571628,2021-12-03 11:58:51 UTC
804711,mainnet,254,109728000,109865638,137639,126691,10948,0.07954140904830753,2021-12-03 12:00:35 UTC
804712,mainnet,254,109728000,109865803,137804,126821,10983,0.0797001538416882,2021-12-03 12:02:15 UTC
804714,mainnet,254,109728000,109865990,137991,127000,10991,0.07965012210941293,2021-12-03 12:03:53 UTC
804715,mainnet,254,109728000,109866164,138165,127165,11000,0.0796149531357435,2021-12-03 12:05:28 UTC
804717,mainnet,254,109728000,109866243,138244,127238,11006,0.0796128584242354,2021-12-03 12:07:08 UTC
804718,mainnet,254,109728000,109866519,138520,127475,11045,0.07973577822697084,2021-12-03 12:08:48 UTC
804720,mainnet,254,109728000,109866685,138686,127629,11057,0.07972686500439842,2021-12-03 12:10:28 UTC
804721,mainnet,254,109728000,109866867,138868,127799,11069,0.07970878820174554,2021-12-03 12:12:07 UTC
804723,mainnet,254,109728000,109867053,139054,127970,11084,0.07971004070361154,2021-12-03 12:13:47 UTC
804724,mainnet,254,109728000,109867233,139234,128135,11099,0.07971472485168853,2021-12-03 12:15:27 UTC
804726,mainnet,254,109728000,109867407,139408,128304,11104,0.0796510960633536,2021-12-03 12:17:04 UTC
804727,mainnet,254,109728000,109867584,139585,128474,11111,0.07960024357918115,2021-12-03 12:18:42 UTC
804728,mainnet,254,109728000,109867829,139830,128687,11143,0.07968962311378101,2021-12-03 12:20:56 UTC
804729,mainnet,254,109728000,109867975,139976,128825,11151,0.07966365662685032,2021-12-03 12:22:36 UTC
804730,mainnet,254,109728000,109868197,140198,129031,11167,0.07965163554401632,2021-12-03 12:24:12 UTC
804731,mainnet,254,109728000,109868384,140385,129202,11183,0.07965950778217046,2021-12-03 12:25:51 UTC
804732,mainnet,254,109728000,109868535,140536,129347,11189,0.07961661069049923,2021-12-03 12:27:30 UTC
804733,mainnet,254,109728000,109868712,140713,129509,11204,0.07962306254574915,2021-12-03 12:29:07 UTC
804734,mainnet,254,109728000,109868898,140899,129676,11223,0.07965280094251911,2021-12-03 12:30:44 UTC
804736,mainnet,254,109728000,109869057,141058,129822,11236,0.07965517730295339,2021-12-03 12:32:23 UTC
804737,mainnet,254,109728000,109869263,141264,130016,11248,0.07962396647411937,2021-12-03 12:34:01 UTC
804739,mainnet,254,109728000,109869370,141371,130118,11253,0.07959906911601389,2021-12-03 12:35:41 UTC
804740,mainnet,254,109728000,109869629,141630,130368,11262,0.07951705147214573,2021-12-03 12:37:40 UTC
804742,mainnet,254,109728000,109869829,141830,130553,11277,0.0795106818021575,2021-12-03 12:39:21 UTC
804743,mainnet,254,109728000,109869959,141960,130660,11300,0.07959988729219498,2021-12-03 12:41:10 UTC
804745,mainnet,254,109728000,109870180,142181,130871,11310,0.07954649355399104,2021-12-03 12:42:50 UTC
804746,mainnet,254,109728000,109870393,142394,131075,11319,0.07949070887818308,2021-12-03 12:44:29 UTC
804748,mainnet,254,109728000,109870594,142595,131267,11328,0.07944177565833305,2021-12-03 12:46:26 UTC
804749,mainnet,254,109728000,109870826,142827,131473,11354,0.0794947733971868,2021-12-03 12:48:32 UTC
804751,mainnet,254,109728000,109871005,143006,131644,11362,0.07945121183726557,2021-12-03 12:50:24 UTC
804752,mainnet,254,109728000,109871152,143153,131777,11376,0.07946742296703527,2021-12-03 12:52:05 UTC
804754,mainnet,254,109728000,109871417,143418,132027,11391,0.07942517675605573,2021-12-03 12:53:51 UTC
804755,mainnet,254,109728000,109871670,143671,132278,11393,0.07929923227373652,2021-12-03 12:56:00 UTC
804757,mainnet,254,109728000,109871807,143808,132414,11394,0.07923064085447264,2021-12-03 12:57:38 UTC
804759,mainnet,254,109728000,109872052,144053,132645,11408,0.0791930747710912,2021-12-03 12:59:45 UTC
804760,mainnet,254,109728000,109872296,144297,132871,11426,0.07918390541729904,2021-12-03 13:01:52 UTC
804762,mainnet,254,109728000,109872489,144490,133061,11429,0.07909889957782545,2021-12-03 13:03:37 UTC
804763,mainnet,254,109728000,109872706,144707,133263,11444,0.07908394203459404,2021-12-03 13:05:31 UTC
804765,mainnet,254,109728000,109872871,144872,133419,11453,0.07905599425699929,2021-12-03 13:07:16 UTC
804766,mainnet,254,109728000,109873086,145087,133608,11479,0.07911804641353119,2021-12-03 13:09:15 UTC
804768,mainnet,254,109728000,109873320,145321,133817,11504,0.07916268123671046,2021-12-03 13:11:13 UTC
804769,mainnet,254,109728000,109873531,145532,134013,11519,0.07915097710469175,2021-12-03 13:13:11 UTC
804771,mainnet,254,109728000,109873747,145748,134215,11533,0.07912973076817521,2021-12-03 13:15:08 UTC
804772,mainnet,254,109728000,109873993,145994,134448,11546,0.079085441867474,2021-12-03 13:17:33 UTC
804774,mainnet,254,109728000,109874228,146229,134675,11554,0.07901305486599786,2021-12-03 13:19:39 UTC
804775,mainnet,254,109728000,109874403,146404,134845,11559,0.07895276085352859,2021-12-03 13:21:21 UTC
804777,mainnet,254,109728000,109874605,146606,135034,11572,0.07893264941407582,2021-12-03 13:23:10 UTC
804779,mainnet,254,109728000,109874878,146879,135290,11589,0.07890168097549684,2021-12-03 13:25:52 UTC
804780,mainnet,254,109728000,109875101,147102,135501,11601,0.07886364563364197,2021-12-03 13:27:37 UTC
804782,mainnet,254,109728000,109875294,147295,135687,11608,0.07880783461760413,2021-12-03 13:29:32 UTC
804783,mainnet,254,109728000,109875502,147503,135867,11636,0.07888653112140093,2021-12-03 13:31:28 UTC
804784,mainnet,254,109728000,109875690,147691,136036,11655,0.07891476122444833,2021-12-03 13:33:17 UTC
804785,mainnet,254,109728000,109875857,147858,136197,11661,0.07886620947124945,2021-12-03 13:35:07 UTC
804786,mainnet,254,109728000,109876044,148045,136375,11670,0.0788273835658077,2021-12-03 13:36:51 UTC
804788,mainnet,254,109728000,109876237,148238,136552,11686,0.07883268797474331,2021-12-03 13:38:33 UTC
804789,mainnet,254,109728000,109876407,148408,136715,11693,0.07878955312382081,2021-12-03 13:40:13 UTC
804791,mainnet,254,109728000,109876604,148605,136902,11703,0.07875239729484203,2021-12-03 13:41:56 UTC
804792,mainnet,254,109728000,109876790,148791,137076,11715,0.07873460088311793,2021-12-03 13:43:36 UTC
804793,mainnet,254,109728000,109876950,148951,137235,11716,0.07865673946465616,2021-12-03 13:45:16 UTC
804795,mainnet,254,109728000,109877142,149143,137400,11743,0.07873651462019672,2021-12-03 13:46:54 UTC
804797,mainnet,254,109728000,109877306,149307,137554,11753,0.07871700590059408,2021-12-03 13:48:31 UTC
804798,mainnet,254,109728000,109877472,149473,137710,11763,0.07869648699096157,2021-12-03 13:50:05 UTC
804799,mainnet,254,109728000,109877650,149651,137878,11773,0.07866970484660978,2021-12-03 13:51:49 UTC
804801,mainnet,254,109728000,109877820,149821,138040,11781,0.07863383637807785,2021-12-03 13:53:26 UTC
804802,mainnet,254,109728000,109878013,150014,138221,11793,0.07861266281813697,2021-12-03 13:55:01 UTC
804804,mainnet,254,109728000,109878199,150200,138401,11799,0.07855525965379494,2021-12-03 13:56:46 UTC
804805,mainnet,254,109728000,109878371,150372,138563,11809,0.07853190753597744,2021-12-03 13:58:30 UTC
804807,mainnet,254,109728000,109878580,150581,138767,11814,0.07845611332106972,2021-12-03 14:00:16 UTC
804809,mainnet,254,109728000,109878757,150758,138939,11819,0.07839716631953196,2021-12-03 14:01:56 UTC
804810,mainnet,254,109728000,109878925,150926,139100,11826,0.07835628056133469,2021-12-03 14:03:41 UTC
804812,mainnet,254,109728000,109879152,151153,139310,11843,0.07835107473884077,2021-12-03 14:05:21 UTC
804813,mainnet,254,109728000,109879341,151342,139489,11853,0.07831930329981103,2021-12-03 14:07:04 UTC
804814,mainnet,254,109728000,109879502,151503,139632,11871,0.07835488406170175,2021-12-03 14:08:38 UTC
804815,mainnet,254,109728000,109879709,151710,139826,11884,0.07833366290949839,2021-12-03 14:10:20 UTC
804817,mainnet,254,109728000,109879887,151888,139995,11893,0.0783011166122406,2021-12-03 14:11:58 UTC
804818,mainnet,254,109728000,109880063,152064,140157,11907,0.07830255681818182,2021-12-03 14:13:35 UTC
804820,mainnet,254,109728000,109880211,152212,140296,11916,0.07828554910256748,2021-12-03 14:15:10 UTC
804821,mainnet,254,109728000,109880418,152419,140463,11956,0.07844166409699578,2021-12-03 14:16:45 UTC
804822,mainnet,254,109728000,109880581,152582,140610,11972,0.07846272823793107,2021-12-03 14:18:23 UTC
804823,mainnet,254,109728000,109880764,152765,140787,11978,0.07840801230648381,2021-12-03 14:19:57 UTC
804824,mainnet,254,109728000,109880936,152937,140956,11981,0.07833944696182088,2021-12-03 14:21:35 UTC
804826,mainnet,254,109728000,109881137,153138,141149,11989,0.07828886363933184,2021-12-03 14:23:21 UTC
804828,mainnet,254,109728000,109881321,153322,141320,12002,0.07827969893426906,2021-12-03 14:25:02 UTC
804829,mainnet,254,109728000,109881488,153489,141481,12008,0.07823361934731479,2021-12-03 14:26:41 UTC
804831,mainnet,254,109728000,109881672,153673,141658,12015,0.07818549777774886,2021-12-03 14:28:24 UTC
804832,mainnet,254,109728000,109881905,153906,141881,12025,0.07813210661052851,2021-12-03 14:30:29 UTC
804834,mainnet,254,109728000,109882107,154108,142072,12036,0.0781010719754977,2021-12-03 14:32:20 UTC
804835,mainnet,254,109728000,109882254,154255,142196,12059,0.07817574794982335,2021-12-03 14:34:00 UTC
804836,mainnet,254,109728000,109882431,154432,142354,12078,0.07820917944467468,2021-12-03 14:35:43 UTC
804838,mainnet,254,109728000,109882614,154615,142518,12097,0.07823949810820426,2021-12-03 14:37:21 UTC
804840,mainnet,254,109728000,109882811,154812,142710,12102,0.07817223471048756,2021-12-03 14:39:12 UTC
804841,mainnet,254,109728000,109882985,154986,142876,12110,0.07813608971132877,2021-12-03 14:40:53 UTC
804842,mainnet,254,109728000,109883174,155175,143053,12122,0.07811825358466248,2021-12-03 14:42:36 UTC
804844,mainnet,254,109728000,109883324,155325,143192,12133,0.07811363270561725,2021-12-03 14:44:14 UTC
804846,mainnet,254,109728000,109883427,155428,143279,12149,0.07816480942944644,2021-12-03 14:45:56 UTC
804847,mainnet,254,109728000,109883659,155660,143499,12161,0.07812540151612489,2021-12-03 14:47:36 UTC
804849,mainnet,254,109728000,109883837,155838,143660,12178,0.07814525340417613,2021-12-03 14:49:16 UTC
804850,mainnet,254,109728000,109883968,155969,143762,12207,0.07826555277010175,2021-12-03 14:50:56 UTC
804852,mainnet,254,109728000,109884147,156148,143921,12227,0.078303916796885,2021-12-03 14:53:03 UTC
804853,mainnet,254,109728000,109884354,156355,144104,12251,0.07835374628249817,2021-12-03 14:54:42 UTC
804855,mainnet,254,109728000,109884533,156534,144256,12278,0.07843663357481442,2021-12-03 14:56:40 UTC
804856,mainnet,254,109728000,109884698,156699,144398,12301,0.07850082004352293,2021-12-03 14:58:21 UTC
804858,mainnet,254,109728000,109884866,156867,144541,12326,0.07857611862278235,2021-12-03 15:00:04 UTC
804860,mainnet,254,109728000,109885066,157067,144715,12352,0.07864159880815194,2021-12-03 15:01:57 UTC
804861,mainnet,254,109728000,109885186,157187,144834,12353,0.07858792393773022,2021-12-03 15:03:34 UTC
804863,mainnet,254,109728000,109885372,157373,145013,12360,0.07853952075641946,2021-12-03 15:05:13 UTC
804864,mainnet,254,109728000,109885470,157471,145098,12373,0.07857319760463831,2021-12-03 15:06:52 UTC
804866,mainnet,254,109728000,109885699,157700,145299,12401,0.07863665187064045,2021-12-03 15:08:32 UTC
804867,mainnet,254,109728000,109885880,157881,145462,12419,0.07866051013104806,2021-12-03 15:10:32 UTC
804869,mainnet,254,109728000,109886067,158068,145619,12449,0.07875724371789357,2021-12-03 15:12:14 UTC
804871,mainnet,254,109728000,109886312,158313,145857,12456,0.078679577798412,2021-12-03 15:14:34 UTC
804872,mainnet,254,109728000,109886464,158465,146003,12462,0.07864197141324583,2021-12-03 15:16:27 UTC
804874,mainnet,254,109728000,109886705,158706,146221,12485,0.07866747318941943,2021-12-03 15:18:15 UTC
804875,mainnet,254,109728000,109886919,158920,146409,12511,0.07872514472690662,2021-12-03 15:20:20 UTC
804877,mainnet,254,109728000,109887107,159108,146573,12535,0.07878296503004249,2021-12-03 15:22:16 UTC
804878,mainnet,254,109728000,109887264,159265,146720,12545,0.07876809091765297,2021-12-03 15:23:56 UTC
804880,mainnet,254,109728000,109887474,159475,146910,12565,0.07878977896221978,2021-12-03 15:25:49 UTC
804882,mainnet,254,109728000,109887648,159649,147071,12578,0.07878533532937883,2021-12-03 15:27:30 UTC
804883,mainnet,254,109728000,109887820,159821,147241,12580,0.07871306023613918,2021-12-03 15:29:08 UTC
804885,mainnet,254,109728000,109887987,159988,147401,12587,0.07867465059879492,2021-12-03 15:31:08 UTC
804886,mainnet,254,109728000,109888237,160238,147610,12628,0.07880777343701244,2021-12-03 15:32:47 UTC
804888,mainnet,254,109728000,109888409,160410,147766,12644,0.07882301602144505,2021-12-03 15:34:36 UTC
804889,mainnet,254,109728000,109888551,160552,147889,12663,0.0788716428322288,2021-12-03 15:36:29 UTC
804891,mainnet,254,109728000,109888780,160781,148077,12704,0.07901431139251529,2021-12-03 15:38:28 UTC
804892,mainnet,254,109728000,109888964,160965,148260,12705,0.07893020221787345,2021-12-03 15:40:11 UTC
804894,mainnet,254,109728000,109889160,161161,148443,12718,0.07891487394592984,2021-12-03 15:41:52 UTC
804895,mainnet,254,109728000,109889342,161343,148621,12722,0.07885064737856616,2021-12-03 15:43:30 UTC
804896,mainnet,254,109728000,109889507,161508,148771,12737,0.07886296654035714,2021-12-03 15:45:07 UTC
804898,mainnet,254,109728000,109889672,161673,148909,12764,0.07894948445318636,2021-12-03 15:46:50 UTC
804899,mainnet,254,109728000,109889815,161816,149037,12779,0.07897241311118802,2021-12-03 15:48:27 UTC
804901,mainnet,254,109728000,109889968,161969,149180,12789,0.07895955398872624,2021-12-03 15:50:07 UTC
804902,mainnet,254,109728000,109890093,162094,149296,12798,0.07895418707663454,2021-12-03 15:51:46 UTC
804904,mainnet,254,109728000,109890252,162253,149442,12811,0.07895693762210869,2021-12-03 15:53:23 UTC
804905,mainnet,254,109728000,109890422,162423,149593,12830,0.0789912758661027,2021-12-03 15:55:01 UTC
804906,mainnet,254,109728000,109890564,162565,149728,12837,0.07896533694214622,2021-12-03 15:56:39 UTC
804908,mainnet,254,109728000,109890711,162712,149861,12851,0.07898003834996804,2021-12-03 15:58:16 UTC
804909,mainnet,254,109728000,109890863,162864,149998,12866,0.07899842813635917,2021-12-03 16:00:03 UTC
804910,mainnet,254,109728000,109891047,163048,150174,12874,0.07895834355527206,2021-12-03 16:01:50 UTC
804912,mainnet,254,109728000,109891240,163241,150356,12885,0.07893237605748556,2021-12-03 16:03:33 UTC
804913,mainnet,254,109728000,109891410,163411,150510,12901,0.07894817362356267,2021-12-03 16:05:11 UTC
804915,mainnet,254,109728000,109891531,163532,150629,12903,0.07890198860161926,2021-12-03 16:06:49 UTC
804916,mainnet,254,109728000,109891717,163718,150789,12929,0.07897115772242515,2021-12-03 16:08:30 UTC
804918,mainnet,254,109728000,109891881,163882,150938,12944,0.07898365897413993,2021-12-03 16:10:16 UTC
804919,mainnet,254,109728000,109892046,164047,151071,12976,0.07909928252269166,2021-12-03 16:11:54 UTC
804921,mainnet,254,109728000,109892207,164208,151202,13006,0.07920442365779987,2021-12-03 16:13:32 UTC
804922,mainnet,254,109728000,109892374,164375,151340,13035,0.07930038022813689,2021-12-03 16:15:11 UTC
804924,mainnet,254,109728000,109892531,164532,151473,13059,0.07937057836773394,2021-12-03 16:16:55 UTC
804925,mainnet,254,109728000,109892642,164643,151571,13072,0.07939602655442382,2021-12-03 16:18:35 UTC
804927,mainnet,254,109728000,109892886,164887,151793,13094,0.07941196091868977,2021-12-03 16:20:16 UTC
804929,mainnet,254,109728000,109893009,165010,151900,13110,0.07944973031937458,2021-12-03 16:22:00 UTC
804930,mainnet,254,109728000,109893251,165252,152105,13147,0.07955728221141045,2021-12-03 16:23:57 UTC
804932,mainnet,254,109728000,109893399,165400,152230,13170,0.07962515114873035,2021-12-03 16:25:48 UTC
804933,mainnet,254,109728000,109893622,165623,152421,13202,0.07971115122899597,2021-12-03 16:27:50 UTC
804935,mainnet,254,109728000,109893783,165784,152571,13213,0.07970009168556676,2021-12-03 16:29:26 UTC
804937,mainnet,254,109728000,109893928,165929,152710,13219,0.07966660439103472,2021-12-03 16:31:14 UTC
804938,mainnet,254,109728000,109894126,166127,152893,13234,0.07966194537913765,2021-12-03 16:33:02 UTC
804940,mainnet,254,109728000,109894328,166329,153084,13245,0.07963133308082175,2021-12-03 16:34:48 UTC
804941,mainnet,254,109728000,109894497,166498,153251,13247,0.07956251726747468,2021-12-03 16:36:27 UTC
804943,mainnet,254,109728000,109894671,166672,153415,13257,0.0795394547374484,2021-12-03 16:38:06 UTC
804944,mainnet,254,109728000,109894849,166850,153583,13267,0.07951453401258615,2021-12-03 16:39:40 UTC
804946,mainnet,254,109728000,109895049,167050,153774,13276,0.07947321161328944,2021-12-03 16:41:46 UTC
804948,mainnet,254,109728000,109895269,167270,153966,13304,0.0795360793925988,2021-12-03 16:43:43 UTC
804949,mainnet,254,109728000,109895446,167447,154134,13313,0.07950575405949345,2021-12-03 16:45:32 UTC
804951,mainnet,254,109728000,109895632,167633,154310,13323,0.07947719124516056,2021-12-03 16:47:11 UTC
804952,mainnet,254,109728000,109895805,167806,154473,13333,0.07945484666817634,2021-12-03 16:48:46 UTC
804954,mainnet,254,109728000,109895894,167895,154531,13364,0.07959736740224545,2021-12-03 16:50:46 UTC
804955,mainnet,254,109728000,109896166,168167,154807,13360,0.07944483757217528,2021-12-03 16:52:34 UTC
804957,mainnet,254,109728000,109896420,168421,155033,13388,0.07949127484102339,2021-12-03 16:54:47 UTC
804959,mainnet,254,109728000,109896592,168593,155193,13400,0.07948135450463542,2021-12-03 16:56:36 UTC
804960,mainnet,254,109728000,109896772,168773,155332,13441,0.0796395157993281,2021-12-03 16:58:23 UTC
804962,mainnet,254,109728000,109896928,168929,155474,13455,0.07964884655683749,2021-12-03 17:00:11 UTC
804963,mainnet,254,109728000,109897078,169079,155600,13479,0.07972013082641842,2021-12-03 17:01:54 UTC
804965,mainnet,254,109728000,109897228,169229,155720,13509,0.079826743643229,2021-12-03 17:03:30 UTC
804966,mainnet,254,109728000,109897375,169376,155832,13544,0.07996410353296807,2021-12-03 17:05:08 UTC
804968,mainnet,254,109728000,109897546,169547,155979,13568,0.08002500781494216,2021-12-03 17:07:03 UTC
804969,mainnet,254,109728000,109897700,169701,156105,13596,0.08011738292644122,2021-12-03 17:08:34 UTC
804971,mainnet,254,109728000,109897841,169842,156229,13613,0.0801509638369779,2021-12-03 17:10:09 UTC
804972,mainnet,254,109728000,109898028,170029,156389,13640,0.08022160925489182,2021-12-03 17:12:10 UTC
804974,mainnet,254,109728000,109898163,170164,156504,13660,0.08027549893044357,2021-12-03 17:14:00 UTC
804975,mainnet,254,109728000,109898381,170382,156702,13680,0.08029017149698912,2021-12-03 17:16:03 UTC
804977,mainnet,254,109728000,109898560,170561,156862,13699,0.0803173058319311,2021-12-03 17:17:36 UTC
804978,mainnet,254,109728000,109898728,170729,157018,13711,0.08030855917858126,2021-12-03 17:19:12 UTC
804979,mainnet,254,109728000,109898866,170867,157149,13718,0.08028466585121762,2021-12-03 17:20:49 UTC
804980,mainnet,254,109728000,109899019,171020,157278,13742,0.0803531750672436,2021-12-03 17:22:30 UTC
804982,mainnet,254,109728000,109899221,171222,157463,13759,0.08035766431883754,2021-12-03 17:24:05 UTC
804983,mainnet,254,109728000,109899377,171378,157609,13769,0.0803428678126714,2021-12-03 17:25:54 UTC
804985,mainnet,254,109728000,109899548,171549,157746,13803,0.08046097616424462,2021-12-03 17:27:30 UTC
804986,mainnet,254,109728000,109899744,171745,157913,13832,0.08053800692887711,2021-12-03 17:29:32 UTC
804988,mainnet,254,109728000,109899940,171941,158097,13844,0.08051599095038414,2021-12-03 17:31:21 UTC
804989,mainnet,254,109728000,109900153,172154,158291,13863,0.08052673768834881,2021-12-03 17:33:36 UTC
804990,mainnet,254,109728000,109900330,172331,158439,13892,0.08061231003127702,2021-12-03 17:35:17 UTC
804992,mainnet,254,109728000,109900516,172517,158610,13907,0.08061234545001363,2021-12-03 17:37:07 UTC
804993,mainnet,254,109728000,109900720,172721,158797,13924,0.08061555919662346,2021-12-03 17:39:04 UTC
804995,mainnet,254,109728000,109900880,172881,158951,13930,0.08057565608713509,2021-12-03 17:40:42 UTC
804996,mainnet,254,109728000,109901071,173072,159128,13944,0.08056762503466765,2021-12-03 17:42:34 UTC
804998,mainnet,254,109728000,109901198,173199,159245,13954,0.08056628502474032,2021-12-03 17:44:15 UTC
804999,mainnet,254,109728000,109901427,173428,159456,13972,0.08056369213737113,2021-12-03 17:45:49 UTC
805001,mainnet,254,109728000,109901598,173599,159598,14001,0.08065138624070416,2021-12-03 17:47:36 UTC
805003,mainnet,254,109728000,109901796,173797,159783,14014,0.08063430323883611,2021-12-03 17:49:25 UTC
805004,mainnet,254,109728000,109901973,173974,159959,14015,0.0805580144159472,2021-12-03 17:51:05 UTC
805006,mainnet,254,109728000,109902164,174165,160136,14029,0.08055005311055609,2021-12-03 17:52:50 UTC
805007,mainnet,254,109728000,109902346,174347,160309,14038,0.080517588487327,2021-12-03 17:54:30 UTC
805009,mainnet,254,109728000,109902557,174558,160490,14068,0.08059212410774642,2021-12-03 17:56:28 UTC
805010,mainnet,254,109728000,109902732,174733,160649,14084,0.0806029771136534,2021-12-03 17:58:05 UTC
805012,mainnet,254,109728000,109902899,174900,160812,14088,0.08054888507718697,2021-12-03 17:59:46 UTC
805013,mainnet,254,109728000,109903046,175047,160924,14123,0.080681188480808,2021-12-03 18:01:29 UTC
805015,mainnet,254,109728000,109903212,175213,161065,14148,0.08074743312425448,2021-12-03 18:03:09 UTC
805016,mainnet,254,109728000,109903281,175282,161119,14163,0.08080122317180315,2021-12-03 18:04:52 UTC
805018,mainnet,254,109728000,109903557,175558,161356,14202,0.08089634194966905,2021-12-03 18:06:42 UTC
805019,mainnet,254,109728000,109903737,175738,161497,14241,0.08103540497786478,2021-12-03 18:08:22 UTC
805021,mainnet,254,109728000,109903887,175888,161631,14257,0.08105726371327208,2021-12-03 18:10:00 UTC
805023,mainnet,254,109728000,109904105,176106,161833,14273,0.08104777804276969,2021-12-03 18:12:02 UTC
805024,mainnet,254,109728000,109904331,176332,162056,14276,0.08096091463829594,2021-12-03 18:13:56 UTC
805026,mainnet,254,109728000,109904506,176507,162215,14292,0.08097129292322684,2021-12-03 18:15:38 UTC
805027,mainnet,254,109728000,109904670,176671,162369,14302,0.08095273134809901,2021-12-03 18:17:17 UTC
805029,mainnet,254,109728000,109904878,176879,162569,14310,0.08090276403643168,2021-12-03 18:19:14 UTC
805030,mainnet,254,109728000,109905052,177053,162738,14315,0.08085149644456745,2021-12-03 18:21:04 UTC
805032,mainnet,254,109728000,109905236,177237,162905,14332,0.08086347658784565,2021-12-03 18:22:54 UTC
805033,mainnet,254,109728000,109905421,177422,163080,14342,0.08083552208857978,2021-12-03 18:24:34 UTC
805034,mainnet,254,109728000,109905557,177558,163205,14353,0.08083555795852623,2021-12-03 18:26:12 UTC
805036,mainnet,254,109728000,109905772,177773,163399,14374,0.08085592300293071,2021-12-03 18:28:02 UTC
805038,mainnet,254,109728000,109905987,177988,163607,14381,0.0807975818594512,2021-12-03 18:29:41 UTC
805039,mainnet,254,109728000,109906131,178132,163740,14392,0.0807940179192958,2021-12-03 18:31:18 UTC
805040,mainnet,254,109728000,109906321,178322,163908,14414,0.08083130516705735,2021-12-03 18:32:57 UTC
805041,mainnet,254,109728000,109906492,178493,164066,14427,0.08082669908623867,2021-12-03 18:34:34 UTC
805043,mainnet,254,109728000,109906672,178673,164234,14439,0.08081243388760473,2021-12-03 18:36:16 UTC
805044,mainnet,254,109728000,109906832,178833,164374,14459,0.08085196803721909,2021-12-03 18:37:53 UTC
805046,mainnet,254,109728000,109907012,179013,164534,14479,0.08088239401607704,2021-12-03 18:39:51 UTC
805048,mainnet,254,109728000,109907249,179250,164760,14490,0.08083682008368201,2021-12-03 18:41:50 UTC
805049,mainnet,254,109728000,109907485,179486,164962,14524,0.08091996033116788,2021-12-03 18:44:01 UTC
805051,mainnet,254,109728000,109907662,179663,165137,14526,0.08085137173485915,2021-12-03 18:45:47 UTC
805052,mainnet,254,109728000,109907836,179837,165287,14550,0.0809065987533155,2021-12-03 18:47:41 UTC
805054,mainnet,254,109728000,109907996,179997,165414,14583,0.08101801696694945,2021-12-03 18:49:28 UTC
805055,mainnet,254,109728000,109908180,180181,165576,14605,0.08105738118891559,2021-12-03 18:51:42 UTC
805057,mainnet,254,109728000,109908396,180397,165774,14623,0.08106010632105855,2021-12-03 18:53:53 UTC
805058,mainnet,254,109728000,109908583,180584,165945,14639,0.08106476764275905,2021-12-03 18:55:28 UTC
805060,mainnet,254,109728000,109908757,180758,166103,14655,0.08107524978147579,2021-12-03 18:57:04 UTC
805061,mainnet,254,109728000,109908916,180917,166254,14663,0.08104821548002675,2021-12-03 18:58:50 UTC
805063,mainnet,254,109728000,109909099,181100,166429,14671,0.08101049144119271,2021-12-03 19:00:36 UTC
805064,mainnet,254,109728000,109909287,181288,166607,14681,0.0809816424694409,2021-12-03 19:02:17 UTC
805066,mainnet,254,109728000,109909377,181378,166690,14688,0.08098005270760511,2021-12-03 19:03:57 UTC
805067,mainnet,254,109728000,109909666,181667,166972,14695,0.08088975983530305,2021-12-03 19:05:40 UTC
805069,mainnet,254,109728000,109909700,181701,167006,14695,0.0808746236949714,2021-12-03 19:07:17 UTC
805070,mainnet,254,109728000,109909932,181933,167216,14717,0.08089241643901876,2021-12-03 19:08:59 UTC
805072,mainnet,254,109728000,109910141,182142,167397,14745,0.08095332213328063,2021-12-03 19:10:40 UTC
805073,mainnet,254,109728000,109910299,182300,167548,14752,0.08092155787164015,2021-12-03 19:12:20 UTC
805075,mainnet,254,109728000,109910461,182462,167693,14769,0.0809428812574673,2021-12-03 19:13:57 UTC
805076,mainnet,254,109728000,109910628,182629,167853,14776,0.0809071943667216,2021-12-03 19:15:34 UTC
805078,mainnet,254,109728000,109910793,182794,168000,14794,0.08093263455036817,2021-12-03 19:17:15 UTC
805079,mainnet,254,109728000,109910960,182961,168138,14823,0.08101726597471592,2021-12-03 19:18:58 UTC
805081,mainnet,254,109728000,109911127,183128,168283,14845,0.08106351841335023,2021-12-03 19:20:38 UTC
805082,mainnet,254,109728000,109911296,183297,168436,14861,0.08107606780252814,2021-12-03 19:22:21 UTC
805084,mainnet,254,109728000,109911453,183454,168559,14895,0.0811920154371123,2021-12-03 19:23:59 UTC
805085,mainnet,254,109728000,109911609,183610,168699,14911,0.08121017373781385,2021-12-03 19:25:42 UTC
805087,mainnet,254,109728000,109911781,183782,168844,14938,0.08128108302227639,2021-12-03 19:27:23 UTC
805088,mainnet,254,109728000,109911954,183955,169004,14951,0.08127531189693131,2021-12-03 19:29:13 UTC
805090,mainnet,254,109728000,109912108,184109,169149,14960,0.08125621235246512,2021-12-03 19:30:52 UTC
805091,mainnet,254,109728000,109912278,184279,169298,14981,0.08129520998051867,2021-12-03 19:32:50 UTC
805093,mainnet,254,109728000,109912439,184440,169441,14999,0.08132183908045977,2021-12-03 19:34:36 UTC
805094,mainnet,254,109728000,109912597,184598,169583,15015,0.08133890941396982,2021-12-03 19:36:22 UTC
805096,mainnet,254,109728000,109912766,184767,169719,15048,0.08144311484193606,2021-12-03 19:38:05 UTC
805097,mainnet,254,109728000,109912940,184941,169879,15062,0.08144218967130058,2021-12-03 19:39:56 UTC
805099,mainnet,254,109728000,109913103,185104,170028,15076,0.0814461059728585,2021-12-03 19:41:40 UTC
805100,mainnet,254,109728000,109913300,185301,170197,15104,0.08151062325621557,2021-12-03 19:43:49 UTC
805102,mainnet,254,109728000,109913458,185459,170339,15120,0.08152745350724419,2021-12-03 19:45:45 UTC
805104,mainnet,254,109728000,109913661,185662,170518,15144,0.08156757979554244,2021-12-03 19:47:52 UTC
805105,mainnet,254,109728000,109913833,185834,170658,15176,0.08166428102500081,2021-12-03 19:49:37 UTC
805107,mainnet,254,109728000,109914015,186016,170823,15193,0.08167576982625151,2021-12-03 19:51:35 UTC
805108,mainnet,254,109728000,109914224,186225,171015,15210,0.08167539267015707,2021-12-03 19:53:40 UTC
805109,mainnet,254,109728000,109914407,186408,171174,15234,0.08172396034504957,2021-12-03 19:55:40 UTC
805111,mainnet,254,109728000,109914600,186601,171350,15251,0.08173053734974625,2021-12-03 19:57:36 UTC
805112,mainnet,254,109728000,109914840,186841,171519,15322,0.08200555552582142,2021-12-03 19:59:41 UTC
805114,mainnet,254,109728000,109915041,187042,171676,15366,0.08215267159247655,2021-12-03 20:01:53 UTC
805115,mainnet,254,109728000,109915217,187218,171831,15387,0.08218761016568919,2021-12-03 20:03:39 UTC
805117,mainnet,254,109728000,109915377,187378,171978,15400,0.08218680955074768,2021-12-03 20:05:25 UTC
805118,mainnet,254,109728000,109915509,187510,172095,15415,0.082208948856061,2021-12-03 20:07:03 UTC
805119,mainnet,254,109728000,109915646,187647,172210,15437,0.08226616998939498,2021-12-03 20:08:44 UTC
805121,mainnet,254,109728000,109915836,187837,172362,15475,0.08238525956015055,2021-12-03 20:10:28 UTC
805122,mainnet,254,109728000,109915993,187994,172490,15504,0.08247071715054735,2021-12-03 20:12:13 UTC
805124,mainnet,254,109728000,109916168,188169,172638,15531,0.08253750617795705,2021-12-03 20:13:54 UTC
805125,mainnet,254,109728000,109916331,188332,172793,15539,0.08250854873308838,2021-12-03 20:15:44 UTC
805127,mainnet,254,109728000,109916474,188475,172922,15553,0.08252022814696909,2021-12-03 20:17:30 UTC
805128,mainnet,254,109728000,109916634,188635,173044,15591,0.08265168181938665,2021-12-03 20:19:13 UTC
805130,mainnet,254,109728000,109916783,188784,173157,15627,0.08277714213068904,2021-12-03 20:20:57 UTC
805131,mainnet,254,109728000,109916933,188934,173287,15647,0.08281728010839765,2021-12-03 20:22:40 UTC
805132,mainnet,254,109728000,109917083,189084,173419,15665,0.08284677709377843,2021-12-03 20:24:27 UTC
805134,mainnet,254,109728000,109917228,189229,173543,15686,0.082894270962696,2021-12-03 20:26:10 UTC
805135,mainnet,254,109728000,109917355,189356,173645,15711,0.08297070069076237,2021-12-03 20:27:57 UTC
805137,mainnet,254,109728000,109917505,189506,173767,15739,0.08305277933152512,2021-12-03 20:29:41 UTC
805138,mainnet,254,109728000,109917662,189663,173907,15756,0.08307366223248604,2021-12-03 20:31:26 UTC
805140,mainnet,254,109728000,109917794,189795,174023,15772,0.08310018704391581,2021-12-03 20:33:07 UTC
805141,mainnet,254,109728000,109917997,189998,174201,15797,0.08314298045242581,2021-12-03 20:35:28 UTC
805143,mainnet,254,109728000,109918142,190143,174314,15829,0.08324787133893964,2021-12-03 20:37:13 UTC
805144,mainnet,254,109728000,109918296,190297,174445,15852,0.08330136575983857,2021-12-03 20:38:58 UTC
805146,mainnet,254,109728000,109918445,190446,174573,15873,0.08334646041397561,2021-12-03 20:40:47 UTC
805147,mainnet,254,109728000,109918586,190587,174700,15887,0.08335825633437748,2021-12-03 20:42:32 UTC
805149,mainnet,254,109728000,109918743,190744,174834,15910,0.083410225223336,2021-12-03 20:44:14 UTC
805150,mainnet,254,109728000,109918902,190903,174961,15942,0.08350837860065059,2021-12-03 20:46:02 UTC
805152,mainnet,254,109728000,109919085,191086,175116,15970,0.08357493484609024,2021-12-03 20:47:38 UTC
805153,mainnet,254,109728000,109919226,191227,175235,15992,0.08362835792016818,2021-12-03 20:49:21 UTC
805154,mainnet,254,109728000,109919370,191371,175357,16014,0.08368039044578332,2021-12-03 20:51:02 UTC
805155,mainnet,254,109728000,109919430,191431,175404,16027,0.08372207218266633,2021-12-03 20:52:45 UTC
805157,mainnet,254,109728000,109919711,191712,175583,16129,0.08413140544149558,2021-12-03 20:54:27 UTC
805158,mainnet,254,109728000,109919872,191873,175695,16178,0.08431618831206059,2021-12-03 20:56:26 UTC
805159,mainnet,254,109728000,109919992,191993,175784,16209,0.08442495299307787,2021-12-03 20:58:08 UTC
805161,mainnet,254,109728000,109920165,192166,175917,16249,0.0845571016725123,2021-12-03 20:59:53 UTC
805162,mainnet,254,109728000,109920332,192333,176049,16284,0.08466565799940728,2021-12-03 21:02:08 UTC
805164,mainnet,254,109728000,109920499,192500,176173,16327,0.08481558441558441,2021-12-03 21:04:03 UTC
805165,mainnet,254,109728000,109920563,192564,176221,16343,0.084870484618101,2021-12-03 21:05:48 UTC
805167,mainnet,254,109728000,109920862,192863,176468,16395,0.08500852937058949,2021-12-03 21:07:38 UTC
805168,mainnet,254,109728000,109921007,193008,176586,16422,0.08508455608057697,2021-12-03 21:09:22 UTC
805170,mainnet,254,109728000,109921162,193163,176731,16432,0.08506805133488297,2021-12-03 21:11:15 UTC
805172,mainnet,254,109728000,109921375,193376,176899,16477,0.0852070577527718,2021-12-03 21:13:33 UTC
805173,mainnet,254,109728000,109921610,193611,177103,16508,0.08526375051004334,2021-12-03 21:15:41 UTC
805175,mainnet,254,109728000,109921741,193742,177218,16524,0.08528868288755148,2021-12-03 21:17:32 UTC
805177,mainnet,254,109728000,109921849,193850,177312,16538,0.08531338663915398,2021-12-03 21:19:28 UTC
805178,mainnet,254,109728000,109922127,194128,177557,16571,0.08536120497815874,2021-12-03 21:21:27 UTC
805180,mainnet,254,109728000,109922349,194350,177753,16597,0.0853974787754052,2021-12-03 21:23:40 UTC
805181,mainnet,254,109728000,109922511,194512,177906,16606,0.08537262482520358,2021-12-03 21:25:36 UTC
805183,mainnet,254,109728000,109922720,194721,178066,16655,0.08553263387102572,2021-12-03 21:27:22 UTC
805184,mainnet,254,109728000,109922893,194894,178215,16679,0.08557985366404301,2021-12-03 21:29:05 UTC
805186,mainnet,254,109728000,109923068,195069,178385,16684,0.08552871035377226,2021-12-03 21:30:55 UTC
805187,mainnet,254,109728000,109923205,195206,178513,16693,0.08551478950442097,2021-12-03 21:32:47 UTC
805189,mainnet,254,109728000,109923456,195457,178738,16719,0.08553799556935797,2021-12-03 21:34:32 UTC
805190,mainnet,254,109728000,109923642,195643,178888,16755,0.08564068226310168,2021-12-03 21:36:26 UTC
805192,mainnet,254,109728000,109923823,195824,179055,16769,0.08563301740338262,2021-12-03 21:38:23 UTC
805193,mainnet,254,109728000,109923987,195988,179210,16778,0.0856072820784946,2021-12-03 21:40:27 UTC
805195,mainnet,254,109728000,109924217,196218,179420,16798,0.08560886361088177,2021-12-03 21:42:14 UTC
805196,mainnet,254,109728000,109924416,196417,179612,16805,0.08555776740302519,2021-12-03 21:44:04 UTC
805198,mainnet,254,109728000,109924614,196615,179798,16817,0.08553263993082928,2021-12-03 21:46:11 UTC
805199,mainnet,254,109728000,109924792,196793,179955,16838,0.08556198645277018,2021-12-03 21:47:55 UTC
805201,mainnet,254,109728000,109925003,197004,180152,16852,0.08554141032669388,2021-12-03 21:49:59 UTC
805203,mainnet,254,109728000,109925213,197214,180333,16881,0.08559737138337035,2021-12-03 21:51:57 UTC
805204,mainnet,254,109728000,109925376,197377,180488,16889,0.08556721401176429,2021-12-03 21:53:44 UTC
805206,mainnet,254,109728000,109925579,197580,180667,16913,0.08560076930863447,2021-12-03 21:55:45 UTC
805207,mainnet,254,109728000,109925742,197743,180795,16948,0.0857072058176522,2021-12-03 21:57:37 UTC
805209,mainnet,254,109728000,109925895,197896,180930,16966,0.08573189958361968,2021-12-03 21:59:21 UTC
805210,mainnet,254,109728000,109926090,198091,181116,16975,0.08569293910374524,2021-12-03 22:01:13 UTC
805212,mainnet,254,109728000,109926266,198267,181272,16995,0.08571774425396057,2021-12-03 22:03:01 UTC
805213,mainnet,254,109728000,109926422,198423,181406,17017,0.08576122727707977,2021-12-03 22:04:46 UTC
805215,mainnet,254,109728000,109926588,198589,181536,17053,0.08587081862540222,2021-12-03 22:06:30 UTC
805216,mainnet,254,109728000,109926763,198764,181680,17084,0.0859511782817814,2021-12-03 22:08:23 UTC
805218,mainnet,254,109728000,109926924,198925,181826,17099,0.08595701897700138,2021-12-03 22:10:07 UTC
805219,mainnet,254,109728000,109927097,199098,181977,17121,0.08599282765271374,2021-12-03 22:12:07 UTC
805220,mainnet,254,109728000,109927271,199272,182130,17142,0.08602312417198603,2021-12-03 22:13:51 UTC
805222,mainnet,254,109728000,109927468,199469,182313,17156,0.08600835217502469,2021-12-03 22:15:50 UTC
805224,mainnet,254,109728000,109927577,199578,182416,17162,0.08599144194249868,2021-12-03 22:17:36 UTC
805225,mainnet,254,109728000,109927822,199823,182640,17183,0.08599110212538096,2021-12-03 22:19:35 UTC
805227,mainnet,254,109728000,109928028,200029,182833,17196,0.08596753470746742,2021-12-03 22:21:28 UTC
805228,mainnet,254,109728000,109928228,200229,183023,17206,0.08593160830848678,2021-12-03 22:23:22 UTC
805230,mainnet,254,109728000,109928407,200408,183197,17211,0.08587980519739731,2021-12-03 22:25:06 UTC
805231,mainnet,254,109728000,109928571,200572,183356,17216,0.08583451329198492,2021-12-03 22:27:05 UTC
805233,mainnet,254,109728000,109928796,200797,183557,17240,0.08585785644207831,2021-12-03 22:28:48 UTC
805234,mainnet,254,109728000,109928982,200983,183739,17244,0.0857983013488703,2021-12-03 22:30:34 UTC
805236,mainnet,254,109728000,109929198,201199,183942,17257,0.08577080402984111,2021-12-03 22:32:34 UTC
805238,mainnet,254,109728000,109929409,201410,184148,17262,0.0857057742912467,2021-12-03 22:34:26 UTC
805239,mainnet,254,109728000,109929664,201665,184395,17270,0.08563707138075521,2021-12-03 22:36:37 UTC
805241,mainnet,254,109728000,109929850,201851,184576,17275,0.08558292998300726,2021-12-03 22:38:15 UTC
805243,mainnet,254,109728000,109930084,202085,184805,17280,0.0855085731251701,2021-12-03 22:40:19 UTC
805244,mainnet,254,109728000,109930276,202277,184992,17285,0.08545212752809267,2021-12-03 22:42:03 UTC
805245,mainnet,254,109728000,109930462,202463,185164,17299,0.08544277225962274,2021-12-03 22:43:45 UTC
805246,mainnet,254,109728000,109930662,202663,185359,17304,0.08538312370783024,2021-12-03 22:45:29 UTC
805248,mainnet,254,109728000,109930835,202836,185521,17315,0.08536453095111321,2021-12-03 22:47:11 UTC
805249,mainnet,254,109728000,109931006,203007,185680,17327,0.08535173663962327,2021-12-03 22:48:59 UTC
805251,mainnet,254,109728000,109931153,203154,185819,17335,0.08532935605501245,2021-12-03 22:50:48 UTC
805252,mainnet,254,109728000,109931348,203349,185997,17352,0.08533113022439255,2021-12-03 22:52:31 UTC
805254,mainnet,254,109728000,109931524,203525,186156,17369,0.08534086721532981,2021-12-03 22:54:19 UTC
805255,mainnet,254,109728000,109931677,203678,186296,17382,0.08534058661220162,2021-12-03 22:56:00 UTC
805257,mainnet,254,109728000,109931833,203834,186410,17424,0.08548132303737355,2021-12-03 22:57:45 UTC
805258,mainnet,254,109728000,109932041,204042,186601,17441,0.08547749973044766,2021-12-03 22:59:28 UTC
805260,mainnet,254,109728000,109932238,204239,186784,17455,0.0854635990187966,2021-12-03 23:01:14 UTC
805261,mainnet,254,109728000,109932411,204412,186945,17467,0.08544997358276422,2021-12-03 23:02:59 UTC
805262,mainnet,254,109728000,109932598,204599,187125,17474,0.08540608702877335,2021-12-03 23:04:42 UTC
805263,mainnet,254,109728000,109932735,204736,187251,17485,0.08540266489527977,2021-12-03 23:06:30 UTC
805265,mainnet,254,109728000,109932906,204907,187393,17514,0.08547292186211305,2021-12-03 23:08:13 UTC
805266,mainnet,254,109728000,109933050,205051,187517,17534,0.08551043398959284,2021-12-03 23:09:55 UTC
805268,mainnet,254,109728000,109933208,205209,187665,17544,0.08549332631609725,2021-12-03 23:11:42 UTC
805269,mainnet,254,109728000,109933363,205364,187786,17578,0.08559435928400304,2021-12-03 23:13:27 UTC
805271,mainnet,254,109728000,109933523,205524,187939,17585,0.08556178353866215,2021-12-03 23:15:09 UTC
805272,mainnet,254,109728000,109933702,205703,188090,17613,0.08562344739746139,2021-12-03 23:16:56 UTC
805274,mainnet,254,109728000,109933856,205857,188231,17626,0.08562254380467994,2021-12-03 23:18:40 UTC
805276,mainnet,254,109728000,109934046,206047,188401,17646,0.08564065480205972,2021-12-03 23:20:21 UTC
805277,mainnet,254,109728000,109934212,206213,188556,17657,0.08562505758608817,2021-12-03 23:22:02 UTC
805278,mainnet,254,109728000,109934389,206390,188716,17674,0.08563399389505305,2021-12-03 23:23:49 UTC
805280,mainnet,254,109728000,109934587,206588,188898,17690,0.0856293685983697,2021-12-03 23:25:33 UTC
805281,mainnet,254,109728000,109934786,206787,189088,17699,0.08559048682944286,2021-12-03 23:27:23 UTC
805283,mainnet,254,109728000,109934996,206997,189293,17704,0.08552780958178138,2021-12-03 23:29:21 UTC
805284,mainnet,254,109728000,109935199,207200,189490,17710,0.08547297297297297,2021-12-03 23:31:30 UTC
805286,mainnet,254,109728000,109935439,207440,189711,17729,0.08546567682221365,2021-12-03 23:33:42 UTC
805287,mainnet,254,109728000,109935627,207628,189874,17754,0.0855086982487911,2021-12-03 23:35:36 UTC
805289,mainnet,254,109728000,109935796,207797,190027,17770,0.08551615278372643,2021-12-03 23:37:43 UTC
805291,mainnet,254,109728000,109936036,208037,190252,17785,0.0854896004076198,2021-12-03 23:39:35 UTC
805292,mainnet,254,109728000,109936231,208232,190430,17802,0.08549118291136809,2021-12-03 23:41:22 UTC
805294,mainnet,254,109728000,109936420,208421,190615,17806,0.08543284985678026,2021-12-03 23:43:09 UTC
805295,mainnet,254,109728000,109936612,208613,190799,17814,0.08539256901535379,2021-12-03 23:44:53 UTC
805297,mainnet,254,109728000,109936765,208766,190942,17824,0.08537788720385503,2021-12-03 23:46:46 UTC
805298,mainnet,254,109728000,109937011,209012,191167,17845,0.08537787304078234,2021-12-03 23:48:41 UTC
805300,mainnet,254,109728000,109937224,209225,191364,17861,0.08536742741068228,2021-12-03 23:50:46 UTC
805302,mainnet,254,109728000,109937434,209435,191572,17863,0.08529137918685989,2021-12-03 23:52:27 UTC
805303,mainnet,254,109728000,109937606,209607,191743,17864,0.08522616134003158,2021-12-03 23:54:20 UTC
805305,mainnet,254,109728000,109937859,209860,191984,17876,0.08518059658820165,2021-12-03 23:56:32 UTC
805306,mainnet,254,109728000,109938028,210029,192149,17880,0.08513110094320309,2021-12-03 23:58:29 UTC
805308,mainnet,254,109728000,109938235,210236,192341,17895,0.08511862858882399,2021-12-04 00:00:10 UTC
805309,mainnet,254,109728000,109938410,210411,192488,17923,0.0851809078422706,2021-12-04 00:01:57 UTC
805310,mainnet,254,109728000,109938568,210569,192635,17934,0.08516923193822452,2021-12-04 00:03:41 UTC
805312,mainnet,254,109728000,109938792,210793,192836,17957,0.08518783830582609,2021-12-04 00:05:24 UTC
805313,mainnet,254,109728000,109938902,210903,192941,17962,0.08516711473995155,2021-12-04 00:07:23 UTC
805315,mainnet,254,109728000,109939200,211201,193208,17993,0.08519372540849712,2021-12-04 00:09:13 UTC
805317,mainnet,254,109728000,109939426,211427,193415,18012,0.0851925250795783,2021-12-04 00:11:24 UTC
805318,mainnet,254,109728000,109939595,211596,193575,18021,0.08516701638972381,2021-12-04 00:13:09 UTC
805320,mainnet,254,109728000,109939804,211805,193769,18036,0.08515379712471377,2021-12-04 00:14:59 UTC
805321,mainnet,254,109728000,109939970,211971,193923,18048,0.08514372249034066,2021-12-04 00:16:45 UTC
805323,mainnet,254,109728000,109940151,212152,194085,18067,0.08516063954146084,2021-12-04 00:18:28 UTC
805324,mainnet,254,109728000,109940338,212339,194255,18084,0.08516570201423196,2021-12-04 00:20:21 UTC
805326,mainnet,254,109728000,109940505,212506,194414,18092,0.08513641967756204,2021-12-04 00:22:07 UTC
805327,mainnet,254,109728000,109940707,212708,194596,18112,0.0851495947496098,2021-12-04 00:24:02 UTC
805328,mainnet,254,109728000,109940895,212896,194767,18129,0.08515425372012626,2021-12-04 00:25:42 UTC
805330,mainnet,254,109728000,109941023,213024,194886,18138,0.08514533573681839,2021-12-04 00:27:27 UTC
805331,mainnet,254,109728000,109941215,213216,195046,18170,0.08521874530992046,2021-12-04 00:29:16 UTC
805333,mainnet,254,109728000,109941404,213405,195219,18186,0.08521824699515007,2021-12-04 00:31:07 UTC
805335,mainnet,254,109728000,109941550,213551,195356,18195,0.08520212970203839,2021-12-04 00:32:59 UTC
805336,mainnet,254,109728000,109941754,213755,195535,18220,0.0852377722158546,2021-12-04 00:34:43 UTC
805338,mainnet,254,109728000,109941886,213887,195662,18225,0.0852085446988363,2021-12-04 00:36:22 UTC
805339,mainnet,254,109728000,109942041,214042,195778,18264,0.08532904757010307,2021-12-04 00:38:07 UTC
805341,mainnet,254,109728000,109942216,214217,195930,18287,0.08536670759090081,2021-12-04 00:39:46 UTC
805342,mainnet,254,109728000,109942365,214366,196063,18303,0.08538201020684251,2021-12-04 00:41:30 UTC
805344,mainnet,254,109728000,109942527,214528,196205,18323,0.08541076223150358,2021-12-04 00:43:08 UTC
805345,mainnet,254,109728000,109942656,214657,196314,18343,0.08545260578504311,2021-12-04 00:44:46 UTC
805347,mainnet,254,109728000,109942780,214781,196413,18368,0.08551966887201382,2021-12-04 00:46:26 UTC
805348,mainnet,254,109728000,109942915,214916,196525,18391,0.08557296804332856,2021-12-04 00:48:16 UTC
805350,mainnet,254,109728000,109943073,215074,196657,18417,0.08563099212364117,2021-12-04 00:49:58 UTC
805351,mainnet,254,109728000,109943238,215239,196780,18459,0.08576048021037079,2021-12-04 00:51:45 UTC
805353,mainnet,254,109728000,109943385,215386,196901,18485,0.08582266256859777,2021-12-04 00:53:27 UTC
805354,mainnet,254,109728000,109943553,215554,197041,18513,0.08588567133989626,2021-12-04 00:55:09 UTC
805356,mainnet,254,109728000,109943703,215704,197175,18529,0.08590012238994177,2021-12-04 00:56:53 UTC
805357,mainnet,254,109728000,109943866,215867,197305,18562,0.0859881315810198,2021-12-04 00:58:33 UTC
805358,mainnet,254,109728000,109943997,215998,197407,18591,0.08607024139112399,2021-12-04 01:00:17 UTC
805360,mainnet,254,109728000,109944231,216232,197600,18632,0.0861667098301824,2021-12-04 01:02:36 UTC
805361,mainnet,254,109728000,109944420,216421,197763,18658,0.08621159684134165,2021-12-04 01:04:43 UTC
805363,mainnet,254,109728000,109944594,216595,197932,18663,0.08616542394792123,2021-12-04 01:06:29 UTC
805364,mainnet,254,109728000,109944759,216760,198089,18671,0.0861367410961432,2021-12-04 01:08:12 UTC
805365,mainnet,254,109728000,109944900,216901,198209,18692,0.08617756487982997,2021-12-04 01:09:56 UTC
805366,mainnet,254,109728000,109945076,217077,198347,18730,0.08628274759647499,2021-12-04 01:12:00 UTC
805367,mainnet,254,109728000,109945276,217277,198507,18770,0.08638742250675405,2021-12-04 01:13:54 UTC
805369,mainnet,254,109728000,109945464,217465,198673,18792,0.08641390568597246,2021-12-04 01:15:37 UTC
805370,mainnet,254,109728000,109945644,217645,198831,18814,0.08644352041167958,2021-12-04 01:17:38 UTC
805372,mainnet,254,109728000,109945821,217822,198976,18846,0.08652018620708651,2021-12-04 01:19:22 UTC
805373,mainnet,254,109728000,109945984,217985,199124,18861,0.08652430213088057,2021-12-04 01:21:11 UTC
805375,mainnet,254,109728000,109946161,218162,199274,18888,0.08657786415599417,2021-12-04 01:23:03 UTC
805376,mainnet,254,109728000,109946369,218370,199450,18920,0.08664193799514586,2021-12-04 01:25:07 UTC
805378,mainnet,254,109728000,109946510,218511,199560,18951,0.08672789928195834,2021-12-04 01:26:51 UTC
805379,mainnet,254,109728000,109946707,218708,199710,18998,0.08686467801817949,2021-12-04 01:28:42 UTC
805381,mainnet,254,109728000,109946920,218921,199890,19031,0.08693090201488209,2021-12-04 01:30:33 UTC
805382,mainnet,254,109728000,109947136,219137,200096,19041,0.08689084910352884,2021-12-04 01:32:35 UTC
805384,mainnet,254,109728000,109947355,219356,200305,19051,0.08684968726636152,2021-12-04 01:34:49 UTC
805385,mainnet,254,109728000,109947556,219557,200482,19075,0.0868794891531584,2021-12-04 01:36:45 UTC
805387,mainnet,254,109728000,109947721,219722,200622,19100,0.0869280272344144,2021-12-04 01:38:35 UTC
805388,mainnet,254,109728000,109947883,219884,200772,19112,0.08691855705735752,2021-12-04 01:40:18 UTC
805390,mainnet,254,109728000,109948065,220066,200947,19119,0.08687848190997247,2021-12-04 01:42:06 UTC
805392,mainnet,254,109728000,109948249,220250,201107,19143,0.08691486946651532,2021-12-04 01:43:48 UTC
805393,mainnet,254,109728000,109948410,220411,201254,19157,0.08691489989156621,2021-12-04 01:45:27 UTC
805395,mainnet,254,109728000,109948578,220579,201414,19165,0.08688497091744908,2021-12-04 01:47:10 UTC
805396,mainnet,254,109728000,109948758,220759,201575,19184,0.086900194329563,2021-12-04 01:49:01 UTC
805398,mainnet,254,109728000,109948997,220998,201810,19188,0.08682431515217333,2021-12-04 01:51:07 UTC
805399,mainnet,254,109728000,109949204,221205,201997,19208,0.08683348025587125,2021-12-04 01:53:00 UTC
805401,mainnet,254,109728000,109949336,221337,202124,19213,0.08680428486877477,2021-12-04 01:54:45 UTC
805403,mainnet,254,109728000,109949612,221613,202388,19225,0.08675032601878048,2021-12-04 01:56:48 UTC
805404,mainnet,254,109728000,109949837,221838,202587,19251,0.0867795418278203,2021-12-04 01:58:56 UTC
805406,mainnet,254,109728000,109950037,222038,202776,19262,0.08675091650978661,2021-12-04 02:00:50 UTC
805407,mainnet,254,109728000,109950218,222219,202947,19272,0.08672525751623399,2021-12-04 02:02:36 UTC
805409,mainnet,254,109728000,109950415,222416,203131,19285,0.08670689159053306,2021-12-04 02:04:17 UTC
805410,mainnet,254,109728000,109950587,222588,203288,19300,0.08670727981742053,2021-12-04 02:06:03 UTC
805412,mainnet,254,109728000,109950817,222818,203501,19317,0.0866940731897782,2021-12-04 02:08:07 UTC
805413,mainnet,254,109728000,109951004,223005,203679,19326,0.08666173404183762,2021-12-04 02:09:52 UTC
805415,mainnet,254,109728000,109951176,223177,203842,19335,0.08663527155576067,2021-12-04 02:11:33 UTC
805416,mainnet,254,109728000,109951363,223364,204012,19352,0.08663884959080245,2021-12-04 02:13:29 UTC
805418,mainnet,254,109728000,109951504,223505,204130,19375,0.08668709872262366,2021-12-04 02:15:09 UTC
805419,mainnet,254,109728000,109951727,223728,204305,19423,0.08681523993420583,2021-12-04 02:16:57 UTC
805421,mainnet,254,109728000,109951932,223933,204504,19429,0.08676255844382025,2021-12-04 02:18:54 UTC
805422,mainnet,254,109728000,109952122,224123,204686,19437,0.08672470027618763,2021-12-04 02:20:44 UTC
805424,mainnet,254,109728000,109952336,224337,204893,19444,0.08667317473265668,2021-12-04 02:22:46 UTC
805426,mainnet,254,109728000,109952535,224536,205085,19451,0.08662753411479673,2021-12-04 02:24:37 UTC
805427,mainnet,254,109728000,109952715,224716,205256,19460,0.08659819505509175,2021-12-04 02:26:22 UTC
805429,mainnet,254,109728000,109952898,224899,205416,19483,0.08662999835481705,2021-12-04 02:29:08 UTC
805430,mainnet,254,109728000,109953113,225114,205597,19517,0.08669829508604529,2021-12-04 02:30:49 UTC
805432,mainnet,254,109728000,109953304,225305,205770,19535,0.08670468919908568,2021-12-04 02:32:35 UTC
805434,mainnet,254,109728000,109953503,225504,205951,19553,0.08670799631048673,2021-12-04 02:34:28 UTC
805435,mainnet,254,109728000,109953681,225682,206124,19558,0.08666176301167129,2021-12-04 02:36:12 UTC
805437,mainnet,254,109728000,109953855,225856,206291,19565,0.08662599178237461,2021-12-04 02:37:51 UTC
805438,mainnet,254,109728000,109954056,226057,206484,19573,0.08658435704269277,2021-12-04 02:39:45 UTC
805439,mainnet,254,109728000,109954237,226238,206659,19579,0.08654160662664981,2021-12-04 02:41:24 UTC
805441,mainnet,254,109728000,109954434,226435,206839,19596,0.08654139156932453,2021-12-04 02:43:09 UTC
805442,mainnet,254,109728000,109954615,226616,207013,19603,0.08650315952977725,2021-12-04 02:44:50 UTC
805444,mainnet,254,109728000,109954757,226758,207135,19623,0.0865371894266134,2021-12-04 02:46:37 UTC
805445,mainnet,254,109728000,109954926,226927,207290,19637,0.08653443618432359,2021-12-04 02:48:16 UTC
805446,mainnet,254,109728000,109955120,227121,207468,19653,0.0865309680742864,2021-12-04 02:49:57 UTC
805447,mainnet,254,109728000,109955297,227298,207644,19654,0.08646798476009468,2021-12-04 02:51:46 UTC
805449,mainnet,254,109728000,109955495,227496,207822,19674,0.08648064141787108,2021-12-04 02:53:31 UTC
805450,mainnet,254,109728000,109955669,227670,207988,19682,0.08644968594896121,2021-12-04 02:55:10 UTC
805452,mainnet,254,109728000,109955844,227845,208157,19688,0.08640962057539117,2021-12-04 02:56:56 UTC
805453,mainnet,254,109728000,109956029,228030,208335,19695,0.0863702144454677,2021-12-04 02:58:40 UTC
805455,mainnet,254,109728000,109956271,228272,208559,19713,0.08635750332936146,2021-12-04 03:00:56 UTC
805456,mainnet,254,109728000,109956450,228451,208736,19715,0.08629859357148797,2021-12-04 03:02:51 UTC
805457,mainnet,254,109728000,109956698,228699,208971,19728,0.08626185510212113,2021-12-04 03:04:48 UTC
805458,mainnet,254,109728000,109956882,228883,209155,19728,0.08619250883639239,2021-12-04 03:06:29 UTC
805459,mainnet,254,109728000,109957038,229039,209311,19728,0.08613380254017874,2021-12-04 03:08:13 UTC
805460,mainnet,254,109728000,109957192,229193,209434,19759,0.08621118446025838,2021-12-04 03:09:58 UTC
805461,mainnet,254,109728000,109957420,229421,209640,19781,0.08622140083078707,2021-12-04 03:11:45 UTC
805463,mainnet,254,109728000,109957600,229601,209813,19788,0.08618429362241453,2021-12-04 03:13:29 UTC
805464,mainnet,254,109728000,109957775,229776,209969,19807,0.08620134391755449,2021-12-04 03:15:08 UTC
805466,mainnet,254,109728000,109957947,229948,210140,19808,0.0861412145354602,2021-12-04 03:17:00 UTC
805468,mainnet,254,109728000,109958201,230202,210379,19823,0.08611132831165672,2021-12-04 03:19:01 UTC
805469,mainnet,254,109728000,109958364,230365,210542,19823,0.08605039828098887,2021-12-04 03:20:44 UTC
805471,mainnet,254,109728000,109958547,230548,210697,19851,0.08610354459808803,2021-12-04 03:22:28 UTC
805472,mainnet,254,109728000,109958729,230730,210863,19867,0.08610497117843367,2021-12-04 03:24:22 UTC
805474,mainnet,254,109728000,109958924,230925,211040,19885,0.08611020894229729,2021-12-04 03:26:12 UTC
805476,mainnet,254,109728000,109959059,231060,211142,19918,0.08620271790876828,2021-12-04 03:27:55 UTC
805477,mainnet,254,109728000,109959254,231255,211290,19965,0.08633326846987092,2021-12-04 03:29:36 UTC
805479,mainnet,254,109728000,109959428,231429,211447,19982,0.0863418154163912,2021-12-04 03:31:19 UTC
805480,mainnet,254,109728000,109959601,231602,211602,20000,0.08635504011191614,2021-12-04 03:33:04 UTC
805482,mainnet,254,109728000,109959769,231770,211757,20013,0.0863485351857445,2021-12-04 03:34:48 UTC
805484,mainnet,254,109728000,109959942,231943,211910,20033,0.08637035823456625,2021-12-04 03:36:30 UTC
805485,mainnet,254,109728000,109960102,232103,212059,20044,0.08635821165603202,2021-12-04 03:38:12 UTC
805487,mainnet,254,109728000,109960301,232302,212250,20052,0.08631867138466306,2021-12-04 03:39:53 UTC
805488,mainnet,254,109728000,109960476,232477,212406,20071,0.08633542242888544,2021-12-04 03:41:39 UTC
805490,mainnet,254,109728000,109960646,232647,212567,20080,0.08631102055904438,2021-12-04 03:43:22 UTC
805491,mainnet,254,109728000,109960814,232815,212727,20088,0.08628310031570131,2021-12-04 03:45:00 UTC
805493,mainnet,254,109728000,109960986,232987,212887,20100,0.08627090781889118,2021-12-04 03:46:40 UTC
805495,mainnet,254,109728000,109961124,233125,213010,20115,0.08628418230563002,2021-12-04 03:48:32 UTC
805496,mainnet,254,109728000,109961363,233364,213244,20120,0.0862172400198831,2021-12-04 03:50:22 UTC
805499,mainnet,254,109728000,109961771,233772,213628,20144,0.08616943004294783,2021-12-04 03:54:21 UTC
805500,mainnet,254,109728000,109961937,233938,213776,20162,0.08618522856483342,2021-12-04 03:56:06 UTC
805502,mainnet,254,109728000,109962090,234091,213906,20185,0.08622715097974719,2021-12-04 03:57:56 UTC
805503,mainnet,254,109728000,109962228,234229,214017,20212,0.08629162059352173,2021-12-04 03:59:36 UTC
805505,mainnet,254,109728000,109962430,234431,214170,20261,0.08642628321339754,2021-12-04 04:01:36 UTC
805507,mainnet,254,109728000,109962556,234557,214278,20279,0.08645659690395086,2021-12-04 04:03:18 UTC
805508,mainnet,254,109728000,109962725,234726,214407,20319,0.08656476061450372,2021-12-04 04:05:04 UTC
805510,mainnet,254,109728000,109962884,234885,214540,20345,0.08661685505672989,2021-12-04 04:06:46 UTC
805511,mainnet,254,109728000,109963058,235059,214687,20372,0.08666760260189994,2021-12-04 04:08:30 UTC
805513,mainnet,254,109728000,109963235,235236,214841,20395,0.08670016494074036,2021-12-04 04:10:33 UTC
805515,mainnet,254,109728000,109963415,235416,214984,20432,0.08679104224011962,2021-12-04 04:12:27 UTC
805516,mainnet,254,109728000,109963576,235577,215122,20455,0.08682935940265815,2021-12-04 04:14:13 UTC
805518,mainnet,254,109728000,109963760,235761,215290,20471,0.08682945864668032,2021-12-04 04:15:53 UTC
805519,mainnet,254,109728000,109963898,235899,215402,20497,0.08688888041068424,2021-12-04 04:17:34 UTC
805521,mainnet,254,109728000,109964104,236105,215582,20523,0.08692319095317762,2021-12-04 04:19:17 UTC
805522,mainnet,254,109728000,109964276,236277,215719,20558,0.08700804564134469,2021-12-04 04:20:56 UTC
805524,mainnet,254,109728000,109964440,236441,215867,20574,0.08701536535541636,2021-12-04 04:22:39 UTC
805525,mainnet,254,109728000,109964652,236653,216063,20590,0.08700502423379378,2021-12-04 04:24:28 UTC
805527,mainnet,254,109728000,109964794,236795,216201,20594,0.08696974175974999,2021-12-04 04:26:08 UTC
805529,mainnet,254,109728000,109964981,236982,216363,20619,0.08700660809681748,2021-12-04 04:27:50 UTC
805530,mainnet,254,109728000,109965164,237165,216540,20625,0.0869647713617102,2021-12-04 04:29:35 UTC
805532,mainnet,254,109728000,109965349,237350,216704,20646,0.0869854645038972,2021-12-04 04:31:21 UTC
805533,mainnet,254,109728000,109965508,237509,216851,20658,0.08697775663238025,2021-12-04 04:33:05 UTC
805534,mainnet,254,109728000,109965718,237719,217046,20673,0.08696402054526563,2021-12-04 04:34:50 UTC
805536,mainnet,254,109728000,109965868,237869,217177,20692,0.08698905700196327,2021-12-04 04:36:28 UTC
805537,mainnet,254,109728000,109966007,238008,217300,20708,0.08700547880743505,2021-12-04 04:38:13 UTC
805539,mainnet,254,109728000,109966167,238168,217433,20735,0.08706039434348863,2021-12-04 04:39:50 UTC
805540,mainnet,254,109728000,109966353,238354,217574,20780,0.08718125141596113,2021-12-04 04:41:35 UTC
805541,mainnet,254,109728000,109966527,238528,217742,20786,0.08714280922994365,2021-12-04 04:43:21 UTC
805543,mainnet,254,109728000,109966691,238692,217886,20806,0.08716672531965881,2021-12-04 04:45:04 UTC
805544,mainnet,254,109728000,109966830,238831,218009,20822,0.08718298713316111,2021-12-04 04:46:48 UTC
805546,mainnet,254,109728000,109967008,239009,218151,20858,0.08726868025890239,2021-12-04 04:48:28 UTC
805547,mainnet,254,109728000,109967191,239192,218334,20858,0.08720191310746178,2021-12-04 04:50:11 UTC
805548,mainnet,254,109728000,109967377,239378,218514,20864,0.08715922098104253,2021-12-04 04:51:57 UTC
805550,mainnet,254,109728000,109967524,239525,218651,20874,0.08714747938628535,2021-12-04 04:53:39 UTC
805552,mainnet,254,109728000,109967676,239677,218776,20901,0.08720486321173913,2021-12-04 04:55:18 UTC
805553,mainnet,254,109728000,109967797,239798,218882,20916,0.08722341303930808,2021-12-04 04:56:57 UTC
805555,mainnet,254,109728000,109967932,239933,218989,20944,0.08729103541405309,2021-12-04 04:58:40 UTC
805556,mainnet,254,109728000,109968068,240069,219096,20973,0.087362383314797,2021-12-04 05:00:29 UTC
805558,mainnet,254,109728000,109968186,240187,219191,20996,0.08741522230595328,2021-12-04 05:02:10 UTC
805559,mainnet,254,109728000,109968333,240334,219310,21024,0.08747825942230396,2021-12-04 05:03:53 UTC
805560,mainnet,254,109728000,109968494,240495,219423,21072,0.08761928522422503,2021-12-04 05:05:43 UTC
805562,mainnet,254,109728000,109968647,240648,219547,21101,0.08768408630032246,2021-12-04 05:07:23 UTC
805563,mainnet,254,109728000,109968778,240779,219660,21119,0.08771113759920923,2021-12-04 05:09:05 UTC
805565,mainnet,254,109728000,109968897,240898,219745,21153,0.08780894818553911,2021-12-04 05:10:45 UTC
805566,mainnet,254,109728000,109969067,241068,219875,21193,0.087912954021272,2021-12-04 05:12:36 UTC
805568,mainnet,254,109728000,109969204,241205,219997,21208,0.08792520884724613,2021-12-04 05:14:20 UTC
805569,mainnet,254,109728000,109969329,241330,220093,21237,0.08799983425185431,2021-12-04 05:16:04 UTC
805570,mainnet,254,109728000,109969478,241479,220212,21267,0.08806977004211547,2021-12-04 05:17:52 UTC
805571,mainnet,254,109728000,109969605,241606,220312,21294,0.08813522842975755,2021-12-04 05:19:34 UTC
805573,mainnet,254,109728000,109969765,241766,220424,21342,0.08827543988815631,2021-12-04 05:21:15 UTC
805575,mainnet,254,109728000,109969783,241784,220438,21346,0.08828541177249115,2021-12-04 05:22:53 UTC
805576,mainnet,254,109728000,109970050,242051,220645,21406,0.08843590813506244,2021-12-04 05:24:36 UTC
805578,mainnet,254,109728000,109970208,242209,220769,21440,0.08851859344615601,2021-12-04 05:26:22 UTC
805579,mainnet,254,109728000,109970357,242358,220891,21467,0.08857557827676413,2021-12-04 05:28:06 UTC
805581,mainnet,254,109728000,109970478,242479,220988,21491,0.0886303556184247,2021-12-04 05:29:50 UTC
805582,mainnet,254,109728000,109970656,242657,221125,21532,0.08873430397639466,2021-12-04 05:31:50 UTC
805584,mainnet,254,109728000,109970797,242798,221241,21557,0.0887857395859933,2021-12-04 05:33:47 UTC
805586,mainnet,254,109728000,109970918,242919,221345,21574,0.08881149683639403,2021-12-04 05:35:31 UTC
805587,mainnet,254,109728000,109971085,243086,221472,21614,0.08891503418543231,2021-12-04 05:37:28 UTC
805589,mainnet,254,109728000,109971217,243218,221584,21634,0.08894900870823705,2021-12-04 05:39:22 UTC
805590,mainnet,254,109728000,109971348,243349,221680,21669,0.0890449519003571,2021-12-04 05:41:06 UTC
805592,mainnet,254,109728000,109971530,243531,221816,21715,0.08916729287031219,2021-12-04 05:43:08 UTC
805594,mainnet,254,109728000,109971648,243649,221909,21740,0.08922671548005533,2021-12-04 05:44:53 UTC
805595,mainnet,254,109728000,109971805,243806,222037,21769,0.08928820455608147,2021-12-04 05:46:46 UTC
805597,mainnet,254,109728000,109971931,243932,222135,21797,0.08935686994736237,2021-12-04 05:48:35 UTC
805598,mainnet,254,109728000,109972105,244106,222245,21861,0.0895553570989652,2021-12-04 05:50:32 UTC
805600,mainnet,254,109728000,109972267,244268,222365,21903,0.08966790574287259,2021-12-04 05:52:16 UTC
805602,mainnet,254,109728000,109972444,244445,222511,21934,0.0897297960686453,2021-12-04 05:54:37 UTC
805603,mainnet,254,109728000,109972613,244614,222632,21982,0.0898640306769032,2021-12-04 05:56:29 UTC
805605,mainnet,254,109728000,109972732,244733,222727,22006,0.08991840086951902,2021-12-04 05:58:10 UTC
805607,mainnet,254,109728000,109972887,244888,222833,22055,0.09006157917088628,2021-12-04 06:00:09 UTC
805608,mainnet,254,109728000,109973049,245050,222940,22110,0.09022648439094062,2021-12-04 06:01:57 UTC
805610,mainnet,254,109728000,109973200,245201,223051,22150,0.09033405247123788,2021-12-04 06:04:08 UTC
805611,mainnet,254,109728000,109973359,245360,223170,22190,0.0904385392892077,2021-12-04 06:05:48 UTC
805613,mainnet,254,109728000,109973488,245489,223274,22215,0.09049285304025842,2021-12-04 06:07:33 UTC
805614,mainnet,254,109728000,109973613,245614,223360,22254,0.09060558437222634,2021-12-04 06:09:16 UTC
805616,mainnet,254,109728000,109973776,245777,223480,22297,0.0907204498386749,2021-12-04 06:11:05 UTC
805617,mainnet,254,109728000,109973892,245893,223579,22314,0.09074678823716006,2021-12-04 06:12:52 UTC
805619,mainnet,254,109728000,109974054,246055,223705,22350,0.09083335026721667,2021-12-04 06:14:49 UTC
805620,mainnet,254,109728000,109974144,246145,223783,22362,0.09084888988198013,2021-12-04 06:16:41 UTC
805622,mainnet,254,109728000,109974331,246332,223924,22408,0.09096666287774223,2021-12-04 06:18:40 UTC
805624,mainnet,254,109728000,109974466,246467,224025,22442,0.09105478623913141,2021-12-04 06:20:27 UTC
805625,mainnet,254,109728000,109974651,246652,224148,22504,0.09123785738611485,2021-12-04 06:22:10 UTC
805627,mainnet,254,109728000,109974762,246763,224239,22524,0.09127786580646208,2021-12-04 06:24:03 UTC
805628,mainnet,254,109728000,109974914,246915,224344,22571,0.09141202438085981,2021-12-04 06:25:59 UTC
805630,mainnet,254,109728000,109975107,247108,224497,22611,0.09150250093076712,2021-12-04 06:27:44 UTC
805631,mainnet,254,109728000,109975277,247278,224624,22654,0.09161348765357209,2021-12-04 06:29:46 UTC
805633,mainnet,254,109728000,109975382,247383,224715,22668,0.09163119535295473,2021-12-04 06:31:29 UTC
805635,mainnet,254,109728000,109975564,247565,224858,22707,0.09172136610587119,2021-12-04 06:33:24 UTC
805636,mainnet,254,109728000,109975661,247662,224936,22726,0.09176215971767974,2021-12-04 06:35:09 UTC
805638,mainnet,254,109728000,109975813,247814,225035,22779,0.09191974626130889,2021-12-04 06:36:57 UTC
805639,mainnet,254,109728000,109976003,248004,225157,22847,0.09212351413686876,2021-12-04 06:38:51 UTC
805641,mainnet,254,109728000,109976143,248144,225281,22863,0.09213601779611838,2021-12-04 06:40:42 UTC
805642,mainnet,254,109728000,109976291,248292,225392,22900,0.09223011615356112,2021-12-04 06:42:33 UTC
805644,mainnet,254,109728000,109976419,248420,225487,22933,0.09231543353997262,2021-12-04 06:44:15 UTC
805645,mainnet,254,109728000,109976551,248552,225596,22956,0.09235894299784352,2021-12-04 06:46:02 UTC
805647,mainnet,254,109728000,109976701,248702,225711,22991,0.09244396908750231,2021-12-04 06:47:41 UTC
805649,mainnet,254,109728000,109976856,248857,225831,23026,0.09252703359760826,2021-12-04 06:49:38 UTC
805650,mainnet,254,109728000,109976928,248929,225890,23039,0.09255249488810062,2021-12-04 06:51:24 UTC
805652,mainnet,254,109728000,109977133,249134,226046,23088,0.09267301933899026,2021-12-04 06:53:31 UTC
805653,mainnet,254,109728000,109977316,249317,226198,23119,0.09272933654744762,2021-12-04 06:55:01 UTC
805655,mainnet,254,109728000,109977453,249454,226322,23132,0.09273052346324373,2021-12-04 06:56:46 UTC
805656,mainnet,254,109728000,109977575,249576,226416,23160,0.09279738436388114,2021-12-04 06:58:25 UTC
805658,mainnet,254,109728000,109977727,249728,226534,23194,0.09287705023065095,2021-12-04 07:00:09 UTC
805659,mainnet,254,109728000,109977861,249862,226651,23211,0.09289527819356284,2021-12-04 07:01:55 UTC
805661,mainnet,254,109728000,109978028,250029,226772,23257,0.09301721000363958,2021-12-04 07:03:43 UTC
805663,mainnet,254,109728000,109978139,250140,226858,23282,0.09307587750859518,2021-12-04 07:05:22 UTC
805664,mainnet,254,109728000,109978288,250289,226971,23318,0.09316430206681077,2021-12-04 07:07:16 UTC
805666,mainnet,254,109728000,109978419,250420,227074,23346,0.09322737800495168,2021-12-04 07:09:05 UTC
805667,mainnet,254,109728000,109978580,250581,227184,23397,0.09337100578256133,2021-12-04 07:10:58 UTC
805669,mainnet,254,109728000,109978685,250686,227260,23426,0.09344757984091652,2021-12-04 07:12:36 UTC
805670,mainnet,254,109728000,109978835,250836,227368,23468,0.09355913824171969,2021-12-04 07:14:19 UTC
805672,mainnet,254,109728000,109978983,250984,227485,23499,0.09362748222994294,2021-12-04 07:16:20 UTC
805674,mainnet,254,109728000,109979144,251145,227608,23537,0.09371876804236597,2021-12-04 07:18:09 UTC
805675,mainnet,254,109728000,109979249,251250,227702,23548,0.09372338308457712,2021-12-04 07:19:47 UTC
805677,mainnet,254,109728000,109979404,251405,227828,23577,0.0937809510550705,2021-12-04 07:21:28 UTC
805678,mainnet,254,109728000,109979552,251553,227948,23605,0.09383708403398092,2021-12-04 07:23:19 UTC
805679,mainnet,254,109728000,109979676,251677,228049,23628,0.09388223794784585,2021-12-04 07:24:58 UTC
805680,mainnet,254,109728000,109979831,251832,228174,23658,0.09394358143524255,2021-12-04 07:26:45 UTC
805682,mainnet,254,109728000,109979979,251980,228295,23685,0.09399555520279387,2021-12-04 07:28:30 UTC
805683,mainnet,254,109728000,109980108,252109,228406,23703,0.09401885692299759,2021-12-04 07:30:15 UTC
805685,mainnet,254,109728000,109980280,252281,228524,23757,0.09416880383382023,2021-12-04 07:32:01 UTC
805686,mainnet,254,109728000,109980409,252410,228617,23793,0.09426330177092825,2021-12-04 07:33:43 UTC
805688,mainnet,254,109728000,109980526,252527,228710,23817,0.09431466734250199,2021-12-04 07:35:31 UTC
805689,mainnet,254,109728000,109980670,252671,228820,23851,0.09439547870551032,2021-12-04 07:37:15 UTC
805691,mainnet,254,109728000,109980841,252842,228954,23888,0.0944779743871667,2021-12-04 07:39:04 UTC
805693,mainnet,254,109728000,109981012,253013,229090,23923,0.09455245382648322,2021-12-04 07:41:06 UTC
805694,mainnet,254,109728000,109981182,253183,229221,23962,0.09464300525706702,2021-12-04 07:42:57 UTC
805696,mainnet,254,109728000,109981329,253330,229333,23997,0.09472624639797893,2021-12-04 07:44:46 UTC
805697,mainnet,254,109728000,109981478,253479,229446,24033,0.0948125880250435,2021-12-04 07:46:31 UTC
805699,mainnet,254,109728000,109981627,253628,229566,24062,0.09487122872868926,2021-12-04 07:48:11 UTC
805700,mainnet,254,109728000,109981795,253796,229704,24092,0.09492663398950338,2021-12-04 07:49:57 UTC
805702,mainnet,254,109728000,109981935,253936,229828,24108,0.09493730703799383,2021-12-04 07:51:44 UTC
805704,mainnet,254,109728000,109982096,254097,229949,24148,0.09503457341094149,2021-12-04 07:53:27 UTC
805705,mainnet,254,109728000,109982278,254279,230078,24201,0.09517498495746798,2021-12-04 07:55:20 UTC
805707,mainnet,254,109728000,109982416,254417,230174,24243,0.09528844377537665,2021-12-04 07:57:06 UTC
805708,mainnet,254,109728000,109982593,254594,230303,24291,0.0954107323817529,2021-12-04 07:58:57 UTC
805710,mainnet,254,109728000,109982729,254730,230413,24317,0.09546186157892671,2021-12-04 08:00:43 UTC
805711,mainnet,254,109728000,109982880,254881,230521,24360,0.0955740129707589,2021-12-04 08:02:27 UTC
805713,mainnet,254,109728000,109983000,255001,230612,24389,0.09564276218524634,2021-12-04 08:04:17 UTC
805714,mainnet,254,109728000,109983156,255157,230729,24428,0.09573713439176663,2021-12-04 08:06:01 UTC
805716,mainnet,254,109728000,109983305,255306,230840,24466,0.09583010191691539,2021-12-04 08:07:46 UTC
805718,mainnet,254,109728000,109983447,255448,230952,24496,0.09589427202405186,2021-12-04 08:09:31 UTC
805719,mainnet,254,109728000,109983603,255604,231063,24541,0.09601179950235521,2021-12-04 08:11:11 UTC
805720,mainnet,254,109728000,109983737,255738,231182,24556,0.0960201456177807,2021-12-04 08:12:55 UTC
805721,mainnet,254,109728000,109983914,255915,231316,24599,0.09612175917785203,2021-12-04 08:14:40 UTC
805722,mainnet,254,109728000,109984045,256046,231421,24625,0.0961741249619209,2021-12-04 08:16:27 UTC
805724,mainnet,254,109728000,109984155,256156,231514,24642,0.09619919111791252,2021-12-04 08:18:10 UTC
805726,mainnet,254,109728000,109984335,256336,231654,24682,0.09628768491355097,2021-12-04 08:20:04 UTC
805727,mainnet,254,109728000,109984477,256478,231780,24698,0.09629675839643166,2021-12-04 08:21:45 UTC
805728,mainnet,254,109728000,109984614,256615,231895,24720,0.09633107963291312,2021-12-04 08:23:28 UTC
805730,mainnet,254,109728000,109984809,256810,232057,24753,0.09638643355009541,2021-12-04 08:25:20 UTC
805732,mainnet,254,109728000,109985012,257013,232225,24788,0.09644648325181995,2021-12-04 08:27:41 UTC
805733,mainnet,254,109728000,109985202,257203,232365,24838,0.0965696356574379,2021-12-04 08:29:47 UTC
805735,mainnet,254,109728000,109985353,257354,232487,24867,0.09662565959728622,2021-12-04 08:31:30 UTC
805736,mainnet,254,109728000,109985547,257548,232656,24892,0.09664994486464659,2021-12-04 08:33:41 UTC
805738,mainnet,254,109728000,109985709,257710,232803,24907,0.09664739435799931,2021-12-04 08:35:43 UTC
805740,mainnet,254,109728000,109985866,257867,232941,24926,0.09666223285647252,2021-12-04 08:37:33 UTC
805741,mainnet,254,109728000,109986043,258044,233092,24952,0.09669668738664725,2021-12-04 08:39:32 UTC
805743,mainnet,254,109728000,109986178,258179,233196,24983,0.09676619709581337,2021-12-04 08:41:22 UTC
805744,mainnet,254,109728000,109986318,258319,233304,25015,0.09683763099113886,2021-12-04 08:43:19 UTC
805745,mainnet,254,109728000,109986545,258546,233480,25066,0.09694986578790621,2021-12-04 08:45:00 UTC
805746,mainnet,254,109728000,109986691,258692,233616,25076,0.09693380545204336,2021-12-04 08:46:39 UTC
805747,mainnet,254,109728000,109986863,258864,233757,25107,0.096989152605229,2021-12-04 08:48:22 UTC
805749,mainnet,254,109728000,109987016,259017,233889,25128,0.0970129373747669,2021-12-04 08:50:03 UTC
805750,mainnet,254,109728000,109987179,259180,234019,25161,0.09707924994212516,2021-12-04 08:51:47 UTC
805751,mainnet,254,109728000,109987390,259391,234198,25193,0.09712364731235856,2021-12-04 08:53:51 UTC
805753,mainnet,254,109728000,109987571,259572,234350,25222,0.09716764520056093,2021-12-04 08:55:47 UTC
805754,mainnet,254,109728000,109987711,259712,234473,25239,0.09718072326269098,2021-12-04 08:57:39 UTC
805756,mainnet,254,109728000,109987904,259905,234632,25273,0.09723937592581905,2021-12-04 08:59:21 UTC
805757,mainnet,254,109728000,109988052,260053,234768,25285,0.09723018000176888,2021-12-04 09:01:23 UTC
805758,mainnet,254,109728000,109988227,260228,234909,25319,0.09729544860660651,2021-12-04 09:03:22 UTC
805760,mainnet,254,109728000,109988434,260435,235074,25361,0.09737938449133181,2021-12-04 09:05:07 UTC
805761,mainnet,254,109728000,109988609,260610,235223,25387,0.09741376002455777,2021-12-04 09:07:00 UTC
805763,mainnet,254,109728000,109988800,260801,235379,25422,0.09747662010498426,2021-12-04 09:08:46 UTC
805764,mainnet,254,109728000,109988970,260971,235523,25448,0.09751275045886325,2021-12-04 09:10:39 UTC
805765,mainnet,254,109728000,109989137,261138,235663,25475,0.09755378382311268,2021-12-04 09:12:31 UTC
805767,mainnet,254,109728000,109989310,261311,235820,25491,0.09755042841671419,2021-12-04 09:14:11 UTC
805768,mainnet,254,109728000,109989471,261472,235959,25513,0.09757450128503244,2021-12-04 09:15:55 UTC
805770,mainnet,254,109728000,109989627,261628,236099,25529,0.09757747641689728,2021-12-04 09:17:45 UTC
805771,mainnet,254,109728000,109989772,261773,236227,25546,0.0975883685483224,2021-12-04 09:19:22 UTC
805772,mainnet,254,109728000,109989959,261960,236383,25577,0.0976370438234845,2021-12-04 09:21:06 UTC
805774,mainnet,254,109728000,109990141,262142,236546,25596,0.09764173615826537,2021-12-04 09:22:55 UTC
805775,mainnet,254,109728000,109990310,262311,236707,25604,0.09760932633400811,2021-12-04 09:24:54 UTC
805777,mainnet,254,109728000,109990552,262553,236922,25631,0.09762219437599266,2021-12-04 09:27:03 UTC
805779,mainnet,254,109728000,109990730,262731,237078,25653,0.09763979126939722,2021-12-04 09:28:44 UTC
805780,mainnet,254,109728000,109990881,262882,237217,25665,0.09762935461537876,2021-12-04 09:30:24 UTC
805782,mainnet,254,109728000,109991063,263064,237384,25680,0.09761883039868625,2021-12-04 09:32:05 UTC
805783,mainnet,254,109728000,109991237,263238,237539,25699,0.0976264824987274,2021-12-04 09:33:56 UTC
805785,mainnet,254,109728000,109991415,263416,237704,25712,0.09760986424514836,2021-12-04 09:35:37 UTC
805786,mainnet,254,109728000,109991573,263574,237847,25727,0.09760826181641588,2021-12-04 09:37:30 UTC
805788,mainnet,254,109728000,109991748,263749,237992,25757,0.09765724230234048,2021-12-04 09:39:25 UTC
805789,mainnet,254,109728000,109991902,263903,238126,25777,0.09767604006017362,2021-12-04 09:41:01 UTC
805791,mainnet,254,109728000,109992093,264094,238290,25804,0.09770763440290199,2021-12-04 09:42:51 UTC
805792,mainnet,254,109728000,109992261,264262,238447,25815,0.09768714381939136,2021-12-04 09:44:42 UTC
805794,mainnet,254,109728000,109992423,264424,238582,25842,0.09772940429007956,2021-12-04 09:46:21 UTC
805795,mainnet,254,109728000,109992559,264560,238706,25854,0.09772452373752646,2021-12-04 09:48:02 UTC
805797,mainnet,254,109728000,109992761,264762,238880,25882,0.09775572023175531,2021-12-04 09:50:06 UTC
805799,mainnet,254,109728000,109992947,264948,239045,25903,0.09776635415251295,2021-12-04 09:52:05 UTC
805800,mainnet,254,109728000,109993099,265100,239171,25929,0.09780837419841569,2021-12-04 09:53:57 UTC
805802,mainnet,254,109728000,109993268,265269,239314,25955,0.09784407525945361,2021-12-04 09:55:37 UTC
805803,mainnet,254,109728000,109993407,265408,239443,25965,0.09783051000723414,2021-12-04 09:57:30 UTC
805804,mainnet,254,109728000,109993591,265592,239599,25993,0.0978681586794783,2021-12-04 09:59:16 UTC
805806,mainnet,254,109728000,109993776,265777,239768,26009,0.09786023621306585,2021-12-04 10:01:15 UTC
805807,mainnet,254,109728000,109993956,265957,239931,26026,0.097857924401313,2021-12-04 10:03:08 UTC
805808,mainnet,254,109728000,109994137,266138,240092,26046,0.0978665203766467,2021-12-04 10:04:50 UTC
805809,mainnet,254,109728000,109994320,266321,240258,26063,0.09786310504992096,2021-12-04 10:06:31 UTC
805810,mainnet,254,109728000,109994492,266493,240414,26079,0.09785998131282998,2021-12-04 10:08:13 UTC
805811,mainnet,254,109728000,109994634,266635,240535,26100,0.09788662403660435,2021-12-04 10:09:51 UTC
805813,mainnet,254,109728000,109994788,266789,240668,26121,0.09790883432225467,2021-12-04 10:11:33 UTC
805814,mainnet,254,109728000,109994938,266939,240803,26136,0.09791000940289729,2021-12-04 10:13:20 UTC
805816,mainnet,254,109728000,109995107,267108,240945,26163,0.0979491441664046,2021-12-04 10:15:01 UTC
805817,mainnet,254,109728000,109995271,267272,241096,26176,0.09793768146307881,2021-12-04 10:16:47 UTC
805819,mainnet,254,109728000,109995457,267458,241260,26198,0.09795182795055672,2021-12-04 10:18:54 UTC
805820,mainnet,254,109728000,109995711,267712,241494,26218,0.09793360028687545,2021-12-04 10:21:21 UTC
805822,mainnet,254,109728000,109995884,267885,241649,26236,0.09793754782835919,2021-12-04 10:23:01 UTC
805823,mainnet,254,109728000,109996041,268042,241782,26260,0.0979697211631013,2021-12-04 10:24:54 UTC
805825,mainnet,254,109728000,109996191,268192,241904,26288,0.0980193294356282,2021-12-04 10:26:38 UTC
805827,mainnet,254,109728000,109996394,268395,242058,26337,0.09812775945900631,2021-12-04 10:28:28 UTC
805828,mainnet,254,109728000,109996572,268573,242211,26362,0.09815580866282166,2021-12-04 10:30:32 UTC
805830,mainnet,254,109728000,109996784,268785,242395,26390,0.09818256227096006,2021-12-04 10:32:36 UTC
805831,mainnet,254,109728000,109996937,268938,242523,26415,0.09821966401177967,2021-12-04 10:34:16 UTC
805833,mainnet,254,109728000,109997082,269083,242650,26433,0.0982336305154915,2021-12-04 10:36:16 UTC
805835,mainnet,254,109728000,109997268,269269,242817,26452,0.09823633615455177,2021-12-04 10:38:17 UTC
805836,mainnet,254,109728000,109997459,269460,242970,26490,0.09830772656423958,2021-12-04 10:40:15 UTC
805838,mainnet,254,109728000,109997625,269626,243122,26504,0.09829912545526025,2021-12-04 10:42:16 UTC
805840,mainnet,254,109728000,109997836,269837,243306,26531,0.09832232051201281,2021-12-04 10:44:17 UTC
805841,mainnet,254,109728000,109998021,270022,243458,26564,0.0983771692676893,2021-12-04 10:46:13 UTC
805843,mainnet,254,109728000,109998193,270194,243617,26577,0.09836265794207125,2021-12-04 10:47:57 UTC
805844,mainnet,254,109728000,109998363,270364,243774,26590,0.09834889260404492,2021-12-04 10:49:51 UTC
805846,mainnet,254,109728000,109998579,270580,243967,26613,0.09835538472910045,2021-12-04 10:52:03 UTC
805847,mainnet,254,109728000,109998817,270818,244184,26634,0.09834649100133669,2021-12-04 10:54:37 UTC
805849,mainnet,254,109728000,109999026,271027,244371,26656,0.09835182472594982,2021-12-04 10:57:04 UTC
805851,mainnet,254,109728000,109999271,271272,244575,26697,0.09841413783951164,2021-12-04 10:59:35 UTC
805852,mainnet,254,109728000,109999508,271509,244757,26752,0.09853080376709428,2021-12-04 11:02:03 UTC
805854,mainnet,254,109728000,109999779,271780,245000,26780,0.09853558024873059,2021-12-04 11:04:54 UTC
805855,mainnet,254,109728000,110000010,272011,245202,26809,0.09855851417773547,2021-12-04 11:07:17 UTC
805857,mainnet,254,109728000,110000221,272222,245386,26836,0.09858130496433058,2021-12-04 11:09:35 UTC
805858,mainnet,254,109728000,110000440,272441,245565,26876,0.09864888177623779,2021-12-04 11:11:53 UTC
805859,mainnet,254,109728000,110000657,272658,245752,26906,0.09868039815446457,2021-12-04 11:14:13 UTC
805861,mainnet,254,109728000,110000892,272893,245961,26932,0.09869069562062786,2021-12-04 11:16:34 UTC
805862,mainnet,254,109728000,110001062,273063,246112,26951,0.0986988350673654,2021-12-04 11:18:51 UTC
805864,mainnet,254,109728000,110001409,273410,246389,27021,0.09882959657656999,2021-12-04 11:21:59 UTC
805865,mainnet,254,109728000,110001612,273613,246567,27046,0.0988476424731281,2021-12-04 11:24:31 UTC
805867,mainnet,254,109728000,110001879,273880,246809,27071,0.09884255878486929,2021-12-04 11:27:05 UTC
805868,mainnet,254,109728000,110002078,274079,246979,27100,0.09887660127189606,2021-12-04 11:29:19 UTC
805870,mainnet,254,109728000,110002260,274261,247123,27138,0.09894954076591277,2021-12-04 11:31:36 UTC
805871,mainnet,254,109728000,110002490,274491,247309,27182,0.09902692620158766,2021-12-04 11:33:59 UTC
805873,mainnet,254,109728000,110002697,274698,247473,27225,0.0991088395255881,2021-12-04 11:36:23 UTC
805875,mainnet,254,109728000,110002887,274888,247640,27248,0.09912400686825179,2021-12-04 11:38:40 UTC
805876,mainnet,254,109728000,110003088,275089,247803,27286,0.09918971678256855,2021-12-04 11:40:57 UTC
805878,mainnet,254,109728000,110003287,275288,247970,27318,0.09923425648775101,2021-12-04 11:43:15 UTC
805879,mainnet,254,109728000,110003488,275489,248145,27344,0.09925623164627263,2021-12-04 11:45:38 UTC
805881,mainnet,254,109728000,110003694,275695,248304,27391,0.09935254538529897,2021-12-04 11:48:08 UTC
805882,mainnet,254,109728000,110003838,275839,248429,27410,0.09936955977943655,2021-12-04 11:50:22 UTC
805884,mainnet,254,109728000,110004044,276045,248603,27442,0.0994113278632107,2021-12-04 11:52:42 UTC
805885,mainnet,254,109728000,110004234,276235,248772,27463,0.0994189729759082,2021-12-04 11:54:56 UTC
805886,mainnet,254,109728000,110004432,276433,248925,27508,0.0995105504769691,2021-12-04 11:57:14 UTC
805888,mainnet,254,109728000,110004651,276652,249115,27537,0.09953660194034382,2021-12-04 11:59:35 UTC
805889,mainnet,254,109728000,110004903,276904,249310,27594,0.0996518649062491,2021-12-04 12:02:12 UTC
805891,mainnet,254,109728000,110005126,277127,249514,27613,0.09964023714758938,2021-12-04 12:04:36 UTC
805892,mainnet,254,109728000,110005334,277335,249688,27647,0.09968810283592046,2021-12-04 12:06:59 UTC
805894,mainnet,254,109728000,110005575,277576,249878,27698,0.09978528403031962,2021-12-04 12:09:27 UTC
805895,mainnet,254,109728000,110005776,277777,250065,27712,0.09976347933774214,2021-12-04 12:11:56 UTC
805896,mainnet,254,109728000,110006037,278038,250284,27754,0.09982088779231615,2021-12-04 12:14:39 UTC
805898,mainnet,254,109728000,110006274,278275,250500,27775,0.09981133770550714,2021-12-04 12:17:22 UTC
805900,mainnet,254,109728000,110006503,278504,250681,27823,0.09990161721196104,2021-12-04 12:20:10 UTC
805901,mainnet,254,109728000,110006673,278674,250813,27861,0.09997703409718883,2021-12-04 12:22:31 UTC
805903,mainnet,254,109728000,110006904,278905,251006,27899,0.10003047632706477,2021-12-04 12:25:40 UTC
805904,mainnet,254,109728000,110007127,279128,251191,27937,0.1000866985755639,2021-12-04 12:28:04 UTC
805906,mainnet,254,109728000,110007305,279306,251339,27967,0.10013032301490123,2021-12-04 12:30:28 UTC
805907,mainnet,254,109728000,110007526,279527,251512,28015,0.10022287650209104,2021-12-04 12:33:04 UTC
805908,mainnet,254,109728000,110007700,279701,251672,28029,0.10021058201436533,2021-12-04 12:35:22 UTC
805909,mainnet,254,109728000,110007908,279909,251852,28057,0.10023614817672886,2021-12-04 12:37:47 UTC
805911,mainnet,254,109728000,110008130,280131,252057,28074,0.1002173982886578,2021-12-04 12:40:18 UTC
805913,mainnet,254,109728000,110008351,280352,252247,28105,0.10024897272000913,2021-12-04 12:43:01 UTC
805914,mainnet,254,109728000,110008588,280589,252449,28140,0.10028903485168698,2021-12-04 12:45:13 UTC
805915,mainnet,254,109728000,110008870,280871,252673,28198,0.10039484318423761,2021-12-04 12:48:21 UTC
805917,mainnet,254,109728000,110009155,281156,252911,28245,0.10046024271223093,2021-12-04 12:51:01 UTC
805918,mainnet,254,109728000,110009379,281380,253109,28271,0.10047267041012155,2021-12-04 12:53:36 UTC
805920,mainnet,254,109728000,110009618,281619,253316,28303,0.10050103153551429,2021-12-04 12:56:10 UTC
805921,mainnet,254,109728000,110009843,281844,253507,28337,0.10054143426860249,2021-12-04 12:58:35 UTC
805923,mainnet,254,109728000,110010067,282068,253691,28377,0.10060340059843725,2021-12-04 13:01:19 UTC
805924,mainnet,254,109728000,110010349,282350,253929,28421,0.10065875686205064,2021-12-04 13:04:05 UTC
805926,mainnet,254,109728000,110010577,282578,254102,28476,0.10077217617790486,2021-12-04 13:07:02 UTC
805927,mainnet,254,109728000,110010831,282832,254306,28526,0.10085846014595237,2021-12-04 13:09:46 UTC
805929,mainnet,254,109728000,110011128,283129,254529,28600,0.10101402540891255,2021-12-04 13:12:25 UTC
805931,mainnet,254,109728000,110011369,283370,254744,28626,0.10101986801708014,2021-12-04 13:15:31 UTC
805932,mainnet,254,109728000,110011600,283601,254929,28672,0.10109978455647195,2021-12-04 13:18:07 UTC
805934,mainnet,254,109728000,110011826,283827,255118,28709,0.10114964397326541,2021-12-04 13:20:38 UTC
805935,mainnet,254,109728000,110012095,284096,255344,28752,0.10120522640234288,2021-12-04 13:23:37 UTC
805937,mainnet,254,109728000,110012310,284311,255505,28806,0.10131862643372926,2021-12-04 13:26:06 UTC
805938,mainnet,254,109728000,110012543,284544,255698,28846,0.10137623706702655,2021-12-04 13:28:46 UTC
805940,mainnet,254,109728000,110012780,284781,255900,28881,0.10141477135061679,2021-12-04 13:31:19 UTC
805941,mainnet,254,109728000,110012995,284996,256077,28919,0.10147159960139791,2021-12-04 13:33:45 UTC
805943,mainnet,254,109728000,110013215,285216,256271,28945,0.10148448894872658,2021-12-04 13:36:01 UTC
805944,mainnet,254,109728000,110013413,285414,256444,28970,0.10150167826385531,2021-12-04 13:38:12 UTC
805945,mainnet,254,109728000,110013641,285642,256646,28996,0.10151168245566128,2021-12-04 13:40:43 UTC
805947,mainnet,254,109728000,110013874,285875,256851,29024,0.1015268911237429,2021-12-04 13:43:04 UTC
805948,mainnet,254,109728000,110014111,286112,257056,29056,0.1015546359467621,2021-12-04 13:45:29 UTC
805950,mainnet,254,109728000,110014356,286357,257272,29085,0.10156902048841132,2021-12-04 13:47:52 UTC
805951,mainnet,254,109728000,110014586,286587,257497,29090,0.10150495312069284,2021-12-04 13:50:12 UTC
805953,mainnet,254,109728000,110014810,286811,257717,29094,0.10143962400326348,2021-12-04 13:52:39 UTC
805954,mainnet,254,109728000,110015062,287063,257959,29104,0.10138541017128644,2021-12-04 13:55:05 UTC
805956,mainnet,254,109728000,110015266,287267,258138,29129,0.10140043931255592,2021-12-04 13:57:32 UTC
805957,mainnet,254,109728000,110015536,287537,258376,29161,0.10141651335306413,2021-12-04 14:00:06 UTC
805959,mainnet,254,109728000,110015785,287786,258596,29190,0.10142953444573398,2021-12-04 14:02:38 UTC
805960,mainnet,254,109728000,110016002,288003,258792,29211,0.10142602681222071,2021-12-04 14:05:04 UTC
805962,mainnet,254,109728000,110016243,288244,259012,29232,0.10141407973799975,2021-12-04 14:07:50 UTC
805963,mainnet,254,109728000,110016497,288498,259221,29277,0.10148077283031424,2021-12-04 14:10:22 UTC
805964,mainnet,254,109728000,110016733,288734,259431,29303,0.10148787465279462,2021-12-04 14:12:48 UTC
805966,mainnet,254,109728000,110016951,288952,259619,29333,0.10151513054071265,2021-12-04 14:15:05 UTC
805967,mainnet,254,109728000,110017165,289166,259800,29366,0.10155412462046022,2021-12-04 14:17:32 UTC
805969,mainnet,254,109728000,110017428,289429,260008,29421,0.10165187317096766,2021-12-04 14:19:51 UTC
805970,mainnet,254,109728000,110017660,289661,260209,29452,0.10167747815549902,2021-12-04 14:22:23 UTC
805972,mainnet,254,109728000,110017928,289929,260451,29478,0.10167316825843568,2021-12-04 14:25:21 UTC
805973,mainnet,254,109728000,110018107,290108,260606,29502,0.10169316254636204,2021-12-04 14:27:33 UTC
805975,mainnet,254,109728000,110018377,290378,260834,29544,0.10174324501167444,2021-12-04 14:30:03 UTC
805976,mainnet,254,109728000,110018640,290641,261064,29577,0.10176472004982091,2021-12-04 14:32:27 UTC
805978,mainnet,254,109728000,110018866,290867,261270,29597,0.10175441009121007,2021-12-04 14:34:51 UTC
805979,mainnet,254,109728000,110019070,291071,261452,29619,0.10175867743608948,2021-12-04 14:37:11 UTC
805981,mainnet,254,109728000,110019380,291381,261690,29691,0.10189751562387389,2021-12-04 14:39:38 UTC
805982,mainnet,254,109728000,110019594,291595,261844,29751,0.10202849843104306,2021-12-04 14:41:56 UTC
805984,mainnet,254,109728000,110019790,291791,262010,29781,0.10206277781014493,2021-12-04 14:44:12 UTC
805985,mainnet,254,109728000,110020080,292081,262233,29848,0.10219083062575107,2021-12-04 14:46:44 UTC
805987,mainnet,254,109728000,110020275,292276,262412,29864,0.10217739397008307,2021-12-04 14:48:59 UTC
805988,mainnet,254,109728000,110020481,292482,262585,29897,0.10221825616619143,2021-12-04 14:51:13 UTC
805990,mainnet,254,109728000,110020644,292645,262726,29919,0.10223649814621812,2021-12-04 14:53:38 UTC
805991,mainnet,254,109728000,110020878,292879,262888,29991,0.10240065009782197,2021-12-04 14:55:58 UTC
805993,mainnet,254,109728000,110021103,293104,263031,30073,0.10260180686718708,2021-12-04 14:58:20 UTC
805994,mainnet,254,109728000,110021302,293303,263178,30125,0.10270948473080739,2021-12-04 15:00:42 UTC
805996,mainnet,254,109728000,110021486,293487,263337,30150,0.10273027425405555,2021-12-04 15:02:57 UTC
805997,mainnet,254,109728000,110021663,293664,263468,30196,0.10282499727579819,2021-12-04 15:05:17 UTC
805999,mainnet,254,109728000,110021820,293821,263586,30235,0.10290278775172639,2021-12-04 15:07:35 UTC
806000,mainnet,254,109728000,110021997,293998,263715,30283,0.10300410206872156,2021-12-04 15:09:44 UTC
806001,mainnet,254,109728000,110022196,294197,263868,30329,0.10309078610590863,2021-12-04 15:12:03 UTC
806003,mainnet,254,109728000,110022371,294372,263998,30374,0.10318236788825023,2021-12-04 15:14:18 UTC
806004,mainnet,254,109728000,110022555,294556,264134,30422,0.10328087019106723,2021-12-04 15:16:26 UTC
806006,mainnet,254,109728000,110022754,294755,264285,30470,0.10337398856677579,2021-12-04 15:18:46 UTC
806007,mainnet,254,109728000,110022964,294965,264447,30518,0.10346312274337634,2021-12-04 15:21:02 UTC
806009,mainnet,254,109728000,110023120,295121,264586,30535,0.1034660359649093,2021-12-04 15:23:16 UTC
806010,mainnet,254,109728000,110023303,295304,264728,30576,0.1035407579985371,2021-12-04 15:25:34 UTC
806011,mainnet,254,109728000,110023503,295504,264887,30617,0.10360942660674644,2021-12-04 15:27:49 UTC
806013,mainnet,254,109728000,110023649,295650,265011,30639,0.10363267376966007,2021-12-04 15:29:57 UTC
806014,mainnet,254,109728000,110023836,295837,265158,30679,0.10370237664659931,2021-12-04 15:32:18 UTC
806016,mainnet,254,109728000,110024022,296023,265295,30728,0.10380274505697193,2021-12-04 15:34:41 UTC
806017,mainnet,254,109728000,110024165,296166,265413,30753,0.10383703733716902,2021-12-04 15:36:59 UTC
806019,mainnet,254,109728000,110024343,296344,265556,30788,0.10389277326350457,2021-12-04 15:39:25 UTC
806020,mainnet,254,109728000,110024551,296552,265717,30835,0.10397839164800778,2021-12-04 15:41:41 UTC
806022,mainnet,254,109728000,110024704,296705,265836,30869,0.10403936569993764,2021-12-04 15:43:58 UTC
806023,mainnet,254,109728000,110024946,296947,265997,30950,0.10422735370284933,2021-12-04 15:46:13 UTC
806024,mainnet,254,109728000,110025124,297125,266152,30973,0.1042423222549432,2021-12-04 15:48:35 UTC
806026,mainnet,254,109728000,110025322,297323,266307,31016,0.10431752673018906,2021-12-04 15:50:59 UTC
806028,mainnet,254,109728000,110025497,297498,266452,31046,0.1043570040806997,2021-12-04 15:53:17 UTC
806029,mainnet,254,109728000,110025659,297660,266587,31073,0.10439091580998455,2021-12-04 15:55:55 UTC
806031,mainnet,254,109728000,110025879,297880,266759,31121,0.10447495635826508,2021-12-04 15:58:22 UTC
806032,mainnet,254,109728000,110026069,298070,266913,31157,0.10452913745093434,2021-12-04 16:00:49 UTC
806034,mainnet,254,109728000,110026314,298315,267107,31208,0.10461425003771181,2021-12-04 16:03:35 UTC
806035,mainnet,254,109728000,110026524,298525,267282,31243,0.10465790134829579,2021-12-04 16:06:34 UTC
806037,mainnet,254,109728000,110026758,298759,267458,31301,0.1047700655043028,2021-12-04 16:09:02 UTC
806038,mainnet,254,109728000,110027004,299005,267672,31333,0.10479088978445177,2021-12-04 16:11:55 UTC
806039,mainnet,254,109728000,110027189,299190,267815,31375,0.10486647280992012,2021-12-04 16:14:25 UTC
806041,mainnet,254,109728000,110027383,299384,267977,31407,0.10490540576650723,2021-12-04 16:17:04 UTC
806042,mainnet,254,109728000,110027578,299579,268139,31440,0.1049472760106683,2021-12-04 16:19:40 UTC
806044,mainnet,254,109728000,110027770,299771,268307,31464,0.10496011955792922,2021-12-04 16:22:14 UTC
806045,mainnet,254,109728000,110028000,300001,268484,31517,0.10505631647894507,2021-12-04 16:24:50 UTC
806046,mainnet,254,109728000,110028232,300233,268672,31561,0.10512168882168182,2021-12-04 16:27:19 UTC
806048,mainnet,254,109728000,110028485,300486,268872,31614,0.10520956051197061,2021-12-04 16:30:00 UTC
806050,mainnet,254,109728000,110028724,300725,269074,31651,0.10524898162773298,2021-12-04 16:32:37 UTC
806051,mainnet,254,109728000,110028886,300887,269208,31679,0.10528537291408402,2021-12-04 16:34:55 UTC
806053,mainnet,254,109728000,110029139,301140,269422,31718,0.10532642624692834,2021-12-04 16:37:29 UTC
806054,mainnet,254,109728000,110029388,301389,269614,31775,0.10542853256090966,2021-12-04 16:39:58 UTC
806056,mainnet,254,109728000,110029591,301592,269780,31812,0.10548025146555612,2021-12-04 16:42:14 UTC
806057,mainnet,254,109728000,110029808,301809,269962,31847,0.10552037878260755,2021-12-04 16:44:49 UTC
806059,mainnet,254,109728000,110030033,302034,270149,31885,0.10556758510631253,2021-12-04 16:47:15 UTC
806060,mainnet,254,109728000,110030306,302307,270332,31975,0.10576996232306893,2021-12-04 16:50:02 UTC
806062,mainnet,254,109728000,110030520,302521,270497,32024,0.1058571140515865,2021-12-04 16:52:18 UTC
806063,mainnet,254,109728000,110030726,302727,270671,32056,0.10589078608779527,2021-12-04 16:54:33 UTC
806065,mainnet,254,109728000,110030920,302921,270837,32084,0.10591540368610958,2021-12-04 16:56:57 UTC
806066,mainnet,254,109728000,110031084,303085,270977,32108,0.10593727832126301,2021-12-04 16:59:11 UTC
806067,mainnet,254,109728000,110031347,303348,271184,32164,0.10603003810804752,2021-12-04 17:01:52 UTC
806068,mainnet,254,109728000,110031533,303534,271334,32200,0.10608366772750334,2021-12-04 17:04:22 UTC
806070,mainnet,254,109728000,110031737,303738,271497,32241,0.10614740335420658,2021-12-04 17:06:37 UTC
806071,mainnet,254,109728000,110031973,303974,271659,32315,0.10630843427398395,2021-12-04 17:08:49 UTC
806073,mainnet,254,109728000,110032192,304193,271852,32341,0.10631737087967179,2021-12-04 17:11:39 UTC
806075,mainnet,254,109728000,110032430,304431,272035,32396,0.10641491832303543,2021-12-04 17:14:02 UTC
806076,mainnet,254,109728000,110032646,304647,272218,32429,0.10644779039347178,2021-12-04 17:16:17 UTC
806078,mainnet,254,109728000,110032837,304838,272376,32462,0.10648934844081119,2021-12-04 17:18:34 UTC
806079,mainnet,254,109728000,110033063,305064,272532,32532,0.10663991818110298,2021-12-04 17:20:53 UTC
806081,mainnet,254,109728000,110033309,305310,272724,32586,0.10673086371229243,2021-12-04 17:23:20 UTC
806082,mainnet,254,109728000,110033523,305524,272900,32624,0.10678048205705608,2021-12-04 17:25:44 UTC
806084,mainnet,254,109728000,110033750,305751,273086,32665,0.10683530062043951,2021-12-04 17:28:09 UTC
806085,mainnet,254,109728000,110033963,305964,273262,32702,0.1068818553816789,2021-12-04 17:30:29 UTC
806087,mainnet,254,109728000,110034192,306193,273457,32736,0.1069129601264562,2021-12-04 17:32:45 UTC
806088,mainnet,254,109728000,110034412,306413,273652,32761,0.10691778743068996,2021-12-04 17:35:16 UTC
806089,mainnet,254,109728000,110034600,306601,273819,32782,0.10692072106744596,2021-12-04 17:37:42 UTC
806090,mainnet,254,109728000,110034900,306901,274066,32835,0.10698889870023233,2021-12-04 17:40:31 UTC
806092,mainnet,254,109728000,110035128,307129,274263,32866,0.1070104093068385,2021-12-04 17:42:56 UTC
806093,mainnet,254,109728000,110035366,307367,274479,32888,0.10699912482472093,2021-12-04 17:45:17 UTC
806095,mainnet,254,109728000,110035589,307590,274682,32908,0.10698657303553431,2021-12-04 17:47:29 UTC
806096,mainnet,254,109728000,110035798,307799,274867,32932,0.10699190055848135,2021-12-04 17:49:49 UTC
806098,mainnet,254,109728000,110036035,308036,275084,32952,0.10697450947291876,2021-12-04 17:52:02 UTC
806099,mainnet,254,109728000,110036212,308213,275244,32969,0.10696823300769273,2021-12-04 17:54:15 UTC
806101,mainnet,254,109728000,110036451,308452,275442,33010,0.1070182718867117,2021-12-04 17:56:37 UTC
806102,mainnet,254,109728000,110036626,308627,275605,33022,0.10699647146879566,2021-12-04 17:58:54 UTC
806104,mainnet,254,109728000,110036915,308916,275828,33088,0.10711002343679188,2021-12-04 18:01:20 UTC
806106,mainnet,254,109728000,110037117,309118,276010,33108,0.10710473023246786,2021-12-04 18:03:55 UTC
806107,mainnet,254,109728000,110037320,309321,276169,33152,0.10717668700152916,2021-12-04 18:06:08 UTC
806109,mainnet,254,109728000,110037516,309517,276306,33211,0.10729943751070216,2021-12-04 18:08:22 UTC
806110,mainnet,254,109728000,110037750,309751,276480,33271,0.10741208260828859,2021-12-04 18:10:55 UTC
806112,mainnet,254,109728000,110037984,309985,276674,33311,0.10746003838895431,2021-12-04 18:13:30 UTC
806113,mainnet,254,109728000,110038213,310214,276873,33341,0.10747741881410897,2021-12-04 18:15:45 UTC
806115,mainnet,254,109728000,110038409,310410,277036,33374,0.10751586611256081,2021-12-04 18:18:09 UTC
806116,mainnet,254,109728000,110038643,310644,277232,33412,0.1075572037444792,2021-12-04 18:20:41 UTC
806118,mainnet,254,109728000,110038878,310879,277427,33452,0.10760456640686569,2021-12-04 18:23:26 UTC
806119,mainnet,254,109728000,110039148,311149,277672,33477,0.10759153974462396,2021-12-04 18:25:50 UTC
806121,mainnet,254,109728000,110039367,311368,277862,33506,0.10760900285193084,2021-12-04 18:28:07 UTC
806122,mainnet,254,109728000,110039575,311576,278051,33525,0.10759814619868026,2021-12-04 18:30:19 UTC
806124,mainnet,254,109728000,110039855,311856,278294,33562,0.10762018367451644,2021-12-04 18:33:00 UTC
806126,mainnet,254,109728000,110040100,312101,278518,33583,0.1076029874944329,2021-12-04 18:35:54 UTC
806127,mainnet,254,109728000,110040360,312361,278761,33600,0.10756784617797996,2021-12-04 18:38:13 UTC
806129,mainnet,254,109728000,110040627,312628,279007,33621,0.10754315032562663,2021-12-04 18:40:55 UTC
806130,mainnet,254,109728000,110040867,312868,279244,33624,0.10747024304179398,2021-12-04 18:43:22 UTC
806132,mainnet,254,109728000,110041133,313134,279492,33642,0.10743643296480102,2021-12-04 18:45:48 UTC
806134,mainnet,254,109728000,110041355,313356,279703,33653,0.10739542245880085,2021-12-04 18:48:29 UTC
806135,mainnet,254,109728000,110041684,313685,279992,33693,0.10741030014186206,2021-12-04 18:51:00 UTC
806137,mainnet,254,109728000,110041949,313950,280246,33704,0.10735467431119605,2021-12-04 18:53:21 UTC
806138,mainnet,254,109728000,110042225,314226,280511,33715,0.10729538612336344,2021-12-04 18:55:58 UTC
806140,mainnet,254,109728000,110042463,314464,280736,33728,0.10725552050473186,2021-12-04 18:58:24 UTC
806141,mainnet,254,109728000,110042704,314705,280956,33749,0.1072401137573283,2021-12-04 19:00:40 UTC
806143,mainnet,254,109728000,110042968,314969,281214,33755,0.10716927697646435,2021-12-04 19:03:05 UTC
806144,mainnet,254,109728000,110043216,315217,281454,33763,0.10711033986111156,2021-12-04 19:05:15 UTC
806146,mainnet,254,109728000,110043460,315461,281683,33778,0.10707504255676613,2021-12-04 19:07:28 UTC
806147,mainnet,254,109728000,110043685,315686,281896,33790,0.10703673903815816,2021-12-04 19:09:39 UTC
806149,mainnet,254,109728000,110043942,315943,282149,33794,0.10696233181301691,2021-12-04 19:11:55 UTC
806150,mainnet,254,109728000,110044205,316206,282396,33810,0.10692396728714826,2021-12-04 19:14:09 UTC
806152,mainnet,254,109728000,110044441,316442,282617,33825,0.10689162626958494,2021-12-04 19:16:19 UTC
806153,mainnet,254,109728000,110044678,316679,282825,33854,0.10690320482254902,2021-12-04 19:18:39 UTC
806154,mainnet,254,109728000,110044883,316884,283017,33867,0.10687507100390048,2021-12-04 19:20:54 UTC
806156,mainnet,254,109728000,110045164,317165,283275,33890,0.10685289991014141,2021-12-04 19:23:11 UTC
806157,mainnet,254,109728000,110045424,317425,283520,33905,0.10681263290541072,2021-12-04 19:25:38 UTC
806159,mainnet,254,109728000,110045734,317735,283824,33911,0.10672730420004091,2021-12-04 19:28:36 UTC
806161,mainnet,254,109728000,110046037,318038,284093,33945,0.10673252881731114,2021-12-04 19:31:10 UTC
806162,mainnet,254,109728000,110046282,318283,284324,33959,0.10669435690878872,2021-12-04 19:33:35 UTC
806164,mainnet,254,109728000,110046570,318571,284589,33982,0.10667009865932556,2021-12-04 19:36:05 UTC
806165,mainnet,254,109728000,110046878,318879,284877,34002,0.10662978747424572,2021-12-04 19:38:43 UTC
806166,mainnet,254,109728000,110047109,319110,285103,34007,0.1065682679953621,2021-12-04 19:40:59 UTC
806167,mainnet,254,109728000,110047411,319412,285389,34023,0.10651760109200656,2021-12-04 19:43:37 UTC
806169,mainnet,254,109728000,110047667,319668,285631,34037,0.1064760939474705,2021-12-04 19:45:59 UTC
806170,mainnet,254,109728000,110047893,319894,285837,34057,0.10646339099826818,2021-12-04 19:48:34 UTC
806172,mainnet,254,109728000,110048197,320198,286113,34085,0.10644975921148789,2021-12-04 19:51:00 UTC
806173,mainnet,254,109728000,110048422,320423,286325,34098,0.1064155819026724,2021-12-04 19:53:11 UTC
806175,mainnet,254,109728000,110048652,320653,286540,34113,0.10638603100547944,2021-12-04 19:55:29 UTC
806176,mainnet,254,109728000,110048945,320946,286814,34132,0.10634810840452912,2021-12-04 19:57:56 UTC
806178,mainnet,254,109728000,110049210,321211,287075,34136,0.10627282378249811,2021-12-04 20:00:15 UTC
806179,mainnet,254,109728000,110049441,321442,287294,34148,0.10623378401080133,2021-12-04 20:02:35 UTC
806181,mainnet,254,109728000,110049661,321662,287480,34182,0.10626682666898794,2021-12-04 20:05:00 UTC
806182,mainnet,254,109728000,110049878,321879,287681,34198,0.1062448932673458,2021-12-04 20:07:30 UTC
806183,mainnet,254,109728000,110050170,322171,287964,34207,0.10617653357999324,2021-12-04 20:10:00 UTC
806185,mainnet,254,109728000,110050393,322394,288172,34222,0.10614961816907263,2021-12-04 20:12:17 UTC
806186,mainnet,254,109728000,110050676,322677,288433,34244,0.10612470055194513,2021-12-04 20:14:50 UTC
806188,mainnet,254,109728000,110050945,322946,288695,34251,0.10605797873328668,2021-12-04 20:17:07 UTC
806189,mainnet,254,109728000,110051193,323194,288930,34264,0.1060168196191761,2021-12-04 20:19:30 UTC
806191,mainnet,254,109728000,110051491,323492,289205,34287,0.10599025632782264,2021-12-04 20:22:02 UTC
806192,mainnet,254,109728000,110051760,323761,289467,34294,0.10592381417156482,2021-12-04 20:24:27 UTC
806194,mainnet,254,109728000,110052006,324007,289697,34310,0.10589277392155108,2021-12-04 20:26:47 UTC
806195,mainnet,254,109728000,110052296,324297,289968,34329,0.10585666842431475,2021-12-04 20:29:30 UTC
806197,mainnet,254,109728000,110052585,324586,290243,34343,0.10580554922270215,2021-12-04 20:32:02 UTC
806199,mainnet,254,109728000,110052834,324835,290481,34354,0.10575830806409407,2021-12-04 20:34:38 UTC
806200,mainnet,254,109728000,110053109,325110,290740,34370,0.10571806465503983,2021-12-04 20:37:01 UTC
806202,mainnet,254,109728000,110053354,325355,290972,34383,0.10567841281062225,2021-12-04 20:39:17 UTC
806203,mainnet,254,109728000,110053659,325660,291268,34392,0.10560707486335442,2021-12-04 20:41:57 UTC
806205,mainnet,254,109728000,110053891,325892,291463,34429,0.10564542854688057,2021-12-04 20:44:25 UTC
806206,mainnet,254,109728000,110054186,326187,291748,34439,0.10558054122328603,2021-12-04 20:47:00 UTC
806208,mainnet,254,109728000,110054442,326443,291995,34448,0.10552531376074843,2021-12-04 20:49:16 UTC
806209,mainnet,254,109728000,110054671,326672,292206,34466,0.10550644071117206,2021-12-04 20:51:37 UTC
806211,mainnet,254,109728000,110054892,326893,292416,34477,0.10546876194962877,2021-12-04 20:53:50 UTC
806212,mainnet,254,109728000,110055193,327194,292705,34489,0.10540841213469684,2021-12-04 20:56:20 UTC
806214,mainnet,254,109728000,110055403,327404,292881,34523,0.10544464942395328,2021-12-04 20:58:38 UTC
806215,mainnet,254,109728000,110055619,327620,293067,34553,0.10546669922471155,2021-12-04 21:01:03 UTC
806217,mainnet,254,109728000,110055836,327837,293234,34603,0.10554940412461071,2021-12-04 21:03:27 UTC
806218,mainnet,254,109728000,110056077,328078,293442,34636,0.10557245533074452,2021-12-04 21:05:41 UTC
806220,mainnet,254,109728000,110056329,328330,293670,34660,0.10556452349770049,2021-12-04 21:08:05 UTC
806221,mainnet,254,109728000,110056562,328563,293882,34681,0.10555357724393799,2021-12-04 21:10:25 UTC
806222,mainnet,254,109728000,110056785,328786,294086,34700,0.10553977359133296,2021-12-04 21:12:38 UTC
806223,mainnet,254,109728000,110057033,329034,294310,34724,0.10553316678519545,2021-12-04 21:15:10 UTC
806225,mainnet,254,109728000,110057269,329270,294539,34731,0.10547878640629271,2021-12-04 21:17:20 UTC
806226,mainnet,254,109728000,110057455,329456,294716,34740,0.10544655431984848,2021-12-04 21:19:21 UTC
806228,mainnet,254,109728000,110057713,329714,294948,34766,0.10544289899731282,2021-12-04 21:21:40 UTC
806229,mainnet,254,109728000,110057954,329955,295181,34774,0.10539012895697898,2021-12-04 21:24:02 UTC
806230,mainnet,254,109728000,110058224,330225,295431,34794,0.1053645241880536,2021-12-04 21:26:22 UTC
806231,mainnet,254,109728000,110058485,330486,295677,34809,0.10532670067718451,2021-12-04 21:28:42 UTC
806233,mainnet,254,109728000,110058745,330746,295924,34822,0.10528320826253379,2021-12-04 21:30:59 UTC
806234,mainnet,254,109728000,110058977,330978,296146,34832,0.1052396231773713,2021-12-04 21:33:16 UTC
806236,mainnet,254,109728000,110059238,331239,296397,34842,0.10518688922500068,2021-12-04 21:35:36 UTC
806238,mainnet,254,109728000,110059485,331486,296639,34847,0.10512359496328653,2021-12-04 21:38:05 UTC
806239,mainnet,254,109728000,110059758,331759,296885,34874,0.1051184745553248,2021-12-04 21:40:33 UTC
806241,mainnet,254,109728000,110060025,332026,297131,34895,0.10509719118382295,2021-12-04 21:43:00 UTC
806242,mainnet,254,109728000,110060238,332239,297340,34899,0.1050418524014339,2021-12-04 21:45:04 UTC
806244,mainnet,254,109728000,110060508,332509,297602,34907,0.10498061706600423,2021-12-04 21:47:35 UTC
806245,mainnet,254,109728000,110060744,332745,297809,34936,0.1049933131977941,2021-12-04 21:50:03 UTC
806247,mainnet,254,109728000,110060958,332959,298003,34956,0.10498589916476203,2021-12-04 21:52:14 UTC
806248,mainnet,254,109728000,110061195,333196,298217,34979,0.10498025186376787,2021-12-04 21:54:43 UTC
806250,mainnet,254,109728000,110061447,333448,298448,35000,0.10496389242100718,2021-12-04 21:57:15 UTC
806251,mainnet,254,109728000,110061753,333754,298739,35015,0.10491260029842339,2021-12-04 21:59:39 UTC
806253,mainnet,254,109728000,110061998,333999,298961,35038,0.10490450570211288,2021-12-04 22:01:59 UTC
806254,mainnet,254,109728000,110062248,334249,299204,35045,0.10484698533129494,2021-12-04 22:04:15 UTC
806255,mainnet,254,109728000,110062517,334518,299460,35058,0.1048015353433896,2021-12-04 22:06:33 UTC
806257,mainnet,254,109728000,110062758,334759,299698,35061,0.1047350481988535,2021-12-04 22:08:38 UTC
806258,mainnet,254,109728000,110063022,335023,299956,35067,0.10467042561256988,2021-12-04 22:11:02 UTC
806260,mainnet,254,109728000,110063192,335193,300110,35083,0.10466507355463867,2021-12-04 22:13:26 UTC
806261,mainnet,254,109728000,110063541,335542,300408,35134,0.10470820344398019,2021-12-04 22:15:38 UTC
806263,mainnet,254,109728000,110063798,335799,300656,35143,0.10465486794183425,2021-12-04 22:18:03 UTC
806265,mainnet,254,109728000,110064088,336089,300932,35157,0.10460622037615036,2021-12-04 22:20:19 UTC
806266,mainnet,254,109728000,110064372,336373,301205,35168,0.10455060305077994,2021-12-04 22:22:51 UTC
806267,mainnet,254,109728000,110064670,336671,301497,35174,0.10447588298368436,2021-12-04 22:25:20 UTC
806268,mainnet,254,109728000,110064968,336969,301785,35184,0.10441316560277059,2021-12-04 22:27:54 UTC
806270,mainnet,254,109728000,110065224,337225,302034,35191,0.10435465935206464,2021-12-04 22:30:30 UTC
806271,mainnet,254,109728000,110065539,337540,302345,35195,0.10426912365941814,2021-12-04 22:32:52 UTC
806273,mainnet,254,109728000,110065848,337849,302649,35200,0.10418855761005656,2021-12-04 22:35:38 UTC
806275,mainnet,254,109728000,110066204,338205,302996,35209,0.10410549814461643,2021-12-04 22:38:14 UTC
806276,mainnet,254,109728000,110066444,338445,303228,35217,0.10405531179364447,2021-12-04 22:40:28 UTC
806278,mainnet,254,109728000,110066765,338766,303536,35230,0.10399508805488154,2021-12-04 22:43:11 UTC
806279,mainnet,254,109728000,110067049,339050,303815,35235,0.1039227252617608,2021-12-04 22:45:31 UTC
806281,mainnet,254,109728000,110067287,339288,304039,35249,0.1038910895758176,2021-12-04 22:47:47 UTC
806282,mainnet,254,109728000,110067566,339567,304296,35271,0.1038705174531094,2021-12-04 22:50:01 UTC
806283,mainnet,254,109728000,110067826,339827,304554,35273,0.10379693196832505,2021-12-04 22:52:20 UTC
806284,mainnet,254,109728000,110068107,340108,304814,35294,0.10377291919037482,2021-12-04 22:54:36 UTC
806286,mainnet,254,109728000,110068387,340388,305091,35297,0.10369637002479523,2021-12-04 22:56:57 UTC
806287,mainnet,254,109728000,110068648,340649,305335,35314,0.10366682420908326,2021-12-04 22:59:05 UTC
806289,mainnet,254,109728000,110068872,340873,305552,35321,0.1036192364898364,2021-12-04 23:01:17 UTC
806290,mainnet,254,109728000,110069060,341061,305734,35327,0.10357971154720123,2021-12-04 23:03:34 UTC
806291,mainnet,254,109728000,110069338,341339,305961,35378,0.10364476370997747,2021-12-04 23:06:04 UTC
806293,mainnet,254,109728000,110069598,341599,306200,35399,0.10362735253908822,2021-12-04 23:08:21 UTC
806294,mainnet,254,109728000,110069832,341833,306421,35412,0.10359444524080472,2021-12-04 23:10:26 UTC
806296,mainnet,254,109728000,110070047,342048,306592,35456,0.10365796613340818,2021-12-04 23:12:37 UTC
806297,mainnet,254,109728000,110070328,342329,306852,35477,0.10363422321801542,2021-12-04 23:15:11 UTC
806299,mainnet,254,109728000,110070578,342579,307080,35499,0.10362281400786388,2021-12-04 23:17:36 UTC
806300,mainnet,254,109728000,110070828,342829,307305,35524,0.10362017215579779,2021-12-04 23:19:52 UTC
806302,mainnet,254,109728000,110071102,343103,307555,35548,0.10360737154731961,2021-12-04 23:22:26 UTC
806303,mainnet,254,109728000,110071354,343355,307789,35566,0.10358375442326455,2021-12-04 23:24:42 UTC
806305,mainnet,254,109728000,110071629,343630,308051,35579,0.10353868986991822,2021-12-04 23:27:24 UTC
806307,mainnet,254,109728000,110071863,343864,308239,35625,0.10360200544401275,2021-12-04 23:29:41 UTC
806308,mainnet,254,109728000,110072111,344112,308479,35633,0.10355058818059236,2021-12-04 23:32:01 UTC
806310,mainnet,254,109728000,110072355,344356,308711,35645,0.10351206309749213,2021-12-04 23:34:21 UTC
806311,mainnet,254,109728000,110072570,344571,308915,35656,0.10347939902081138,2021-12-04 23:36:34 UTC
806313,mainnet,254,109728000,110072848,344849,309175,35674,0.10344817586827858,2021-12-04 23:38:52 UTC
806314,mainnet,254,109728000,110073088,345089,309393,35696,0.10343998214953244,2021-12-04 23:41:02 UTC
806315,mainnet,254,109728000,110073370,345371,309657,35714,0.10340763990028115,2021-12-04 23:43:29 UTC
806317,mainnet,254,109728000,110073594,345595,309858,35737,0.10340716734906466,2021-12-04 23:45:36 UTC
806318,mainnet,254,109728000,110073828,345829,310072,35757,0.10339503049194833,2021-12-04 23:47:48 UTC
806320,mainnet,254,109728000,110074079,346080,310319,35761,0.10333159963014332,2021-12-04 23:50:08 UTC
806321,mainnet,254,109728000,110074317,346318,310544,35774,0.10329812484479582,2021-12-04 23:52:21 UTC
806323,mainnet,254,109728000,110074579,346580,310801,35779,0.10323446246176929,2021-12-04 23:54:37 UTC
806324,mainnet,254,109728000,110074822,346823,311035,35788,0.10318808152861834,2021-12-04 23:57:07 UTC
806326,mainnet,254,109728000,110075115,347116,311307,35809,0.10316147915970454,2021-12-04 23:59:33 UTC
806328,mainnet,254,109728000,110075415,347416,311564,35852,0.10319616828240495,2021-12-05 00:02:39 UTC
806329,mainnet,254,109728000,110075653,347654,311775,35879,0.10320318477566776,2021-12-05 00:04:54 UTC
806331,mainnet,254,109728000,110075956,347957,312024,35933,0.1032685073155591,2021-12-05 00:07:53 UTC
806332,mainnet,254,109728000,110076206,348207,312252,35955,0.10325754508094323,2021-12-05 00:10:25 UTC
806334,mainnet,254,109728000,110076460,348461,312472,35989,0.10327985054281541,2021-12-05 00:12:57 UTC
806335,mainnet,254,109728000,110076710,348711,312704,36007,0.10325742520310514,2021-12-05 00:15:24 UTC
806337,mainnet,254,109728000,110076932,348933,312909,36024,0.10324045017238266,2021-12-05 00:17:38 UTC
806338,mainnet,254,109728000,110077162,349163,313113,36050,0.10324690760475766,2021-12-05 00:19:36 UTC
806340,mainnet,254,109728000,110077437,349438,313375,36063,0.10320285715920993,2021-12-05 00:22:08 UTC
806342,mainnet,254,109728000,110077677,349678,313607,36071,0.10315490251030948,2021-12-05 00:24:34 UTC
806343,mainnet,254,109728000,110077934,349935,313847,36088,0.10312772372011945,2021-12-05 00:26:45 UTC
806344,mainnet,254,109728000,110078156,350157,314046,36111,0.10312802542859346,2021-12-05 00:28:58 UTC
806346,mainnet,254,109728000,110078371,350372,314237,36135,0.10313324124073842,2021-12-05 00:31:08 UTC
806347,mainnet,254,109728000,110078609,350610,314455,36155,0.10312027609024271,2021-12-05 00:33:35 UTC
806349,mainnet,254,109728000,110078806,350807,314629,36178,0.10312793074254505,2021-12-05 00:35:53 UTC
806350,mainnet,254,109728000,110079021,351022,314809,36213,0.10316447402157129,2021-12-05 00:37:57 UTC
806351,mainnet,254,109728000,110079229,351230,314971,36259,0.10323434786322352,2021-12-05 00:40:08 UTC
806353,mainnet,254,109728000,110079417,351418,315145,36273,0.10321895861908041,2021-12-05 00:42:24 UTC
806354,mainnet,254,109728000,110079628,351629,315325,36304,0.10324518171140605,2021-12-05 00:44:38 UTC
806356,mainnet,254,109728000,110079852,351853,315516,36337,0.10327324195047363,2021-12-05 00:47:05 UTC
806357,mainnet,254,109728000,110080063,352064,315703,36361,0.10327951736047991,2021-12-05 00:49:16 UTC
806359,mainnet,254,109728000,110080266,352267,315881,36386,0.10329096963382889,2021-12-05 00:51:27 UTC
806360,mainnet,254,109728000,110080497,352498,316089,36409,0.10328852929662012,2021-12-05 00:53:45 UTC
806362,mainnet,254,109728000,110080724,352725,316291,36434,0.10329293358848962,2021-12-05 00:55:56 UTC
806363,mainnet,254,109728000,110080978,352979,316518,36461,0.10329509687545152,2021-12-05 00:58:31 UTC
806364,mainnet,254,109728000,110081254,353255,316771,36484,0.1032795006440107,2021-12-05 01:01:22 UTC
806366,mainnet,254,109728000,110081729,353730,317220,36510,0.10321431600373165,2021-12-05 01:06:37 UTC
806368,mainnet,254,109728000,110081997,353998,317434,36564,0.10328871914530591,2021-12-05 01:08:58 UTC
806369,mainnet,254,109728000,110082197,354198,317612,36586,0.10329250870981767,2021-12-05 01:11:32 UTC
806371,mainnet,254,109728000,110082524,354525,317868,36657,0.10339750370213666,2021-12-05 01:14:01 UTC
806372,mainnet,254,109728000,110082781,354782,318109,36673,0.10336770185635122,2021-12-05 01:16:31 UTC
806374,mainnet,254,109728000,110083016,355017,318322,36695,0.10336124748955684,2021-12-05 01:19:02 UTC
806375,mainnet,254,109728000,110083250,355251,318544,36707,0.1033269434850289,2021-12-05 01:21:24 UTC
806376,mainnet,254,109728000,110083520,355521,318795,36726,0.10330191465483052,2021-12-05 01:24:07 UTC
806378,mainnet,254,109728000,110083773,355774,319032,36742,0.10327342638866246,2021-12-05 01:26:34 UTC
806379,mainnet,254,109728000,110084004,356005,319244,36761,0.10325978567716745,2021-12-05 01:28:53 UTC
806381,mainnet,254,109728000,110084270,356271,319483,36788,0.10325847458816463,2021-12-05 01:31:26 UTC
806382,mainnet,254,109728000,110084491,356492,319693,36799,0.1032253178191937,2021-12-05 01:33:47 UTC
806384,mainnet,254,109728000,110084731,356732,319923,36809,0.1031839027617371,2021-12-05 01:35:57 UTC
806386,mainnet,254,109728000,110084954,356955,320126,36829,0.10317547029737642,2021-12-05 01:38:34 UTC
806387,mainnet,254,109728000,110085219,357220,320345,36875,0.1032277028161917,2021-12-05 01:40:49 UTC
806389,mainnet,254,109728000,110085431,357432,320528,36904,0.10324761073434947,2021-12-05 01:42:59 UTC
806390,mainnet,254,109728000,110085642,357643,320729,36914,0.103214658192667,2021-12-05 01:45:12 UTC
806391,mainnet,254,109728000,110085913,357914,320977,36937,0.10320076889979157,2021-12-05 01:47:29 UTC
806392,mainnet,254,109728000,110086074,358075,321117,36958,0.1032130140333729,2021-12-05 01:49:49 UTC
806394,mainnet,254,109728000,110086391,358392,321395,36997,0.10323054086028706,2021-12-05 01:52:06 UTC
806395,mainnet,254,109728000,110086604,358605,321591,37014,0.10321663111222655,2021-12-05 01:54:10 UTC
806397,mainnet,254,109728000,110086836,358837,321801,37036,0.10321120731697121,2021-12-05 01:56:25 UTC
806398,mainnet,254,109728000,110087068,359069,322018,37051,0.10318629567019152,2021-12-05 01:58:45 UTC
806400,mainnet,254,109728000,110087288,359289,322209,37080,0.10320382755942988,2021-12-05 02:00:56 UTC
806401,mainnet,254,109728000,110087512,359513,322367,37146,0.10332310653578591,2021-12-05 02:03:06 UTC
806403,mainnet,254,109728000,110087736,359737,322574,37163,0.10330602634702575,2021-12-05 02:05:16 UTC
806404,mainnet,254,109728000,110087945,359946,322758,37188,0.10331549732459869,2021-12-05 02:07:29 UTC
806406,mainnet,254,109728000,110088154,360155,322946,37209,0.1033138509808277,2021-12-05 02:09:44 UTC
806407,mainnet,254,109728000,110088416,360417,323168,37249,0.10334973100602912,2021-12-05 02:11:53 UTC
806409,mainnet,254,109728000,110088637,360638,323380,37258,0.10331135376748984,2021-12-05 02:13:56 UTC
806410,mainnet,254,109728000,110088859,360860,323587,37273,0.10328936429640304,2021-12-05 02:16:15 UTC
806412,mainnet,254,109728000,110089072,361073,323770,37303,0.10331151872336065,2021-12-05 02:18:13 UTC
806413,mainnet,254,109728000,110089307,361308,323965,37343,0.10335503227163528,2021-12-05 02:20:25 UTC
806414,mainnet,254,109728000,110089567,361568,324195,37373,0.10336368262678113,2021-12-05 02:22:58 UTC
806416,mainnet,254,109728000,110089792,361793,324406,37387,0.10333809664642489,2021-12-05 02:25:13 UTC
806418,mainnet,254,109728000,110090043,362044,324624,37420,0.10335760294328866,2021-12-05 02:27:36 UTC
806419,mainnet,254,109728000,110090276,362277,324845,37432,0.10332425188460763,2021-12-05 02:29:39 UTC
806421,mainnet,254,109728000,110090537,362538,325091,37447,0.10329124119402655,2021-12-05 02:32:04 UTC
806422,mainnet,254,109728000,110090735,362736,325276,37460,0.10327069824886419,2021-12-05 02:34:13 UTC
806424,mainnet,254,109728000,110090972,362973,325491,37482,0.10326387913150564,2021-12-05 02:36:35 UTC
806425,mainnet,254,109728000,110091202,363203,325707,37496,0.10323703273376046,2021-12-05 02:38:45 UTC
806427,mainnet,254,109728000,110091425,363426,325902,37524,0.1032507305476218,2021-12-05 02:40:52 UTC
806428,mainnet,254,109728000,110091687,363688,326146,37542,0.10322584193044587,2021-12-05 02:43:20 UTC
806430,mainnet,254,109728000,110091883,363884,326325,37559,0.10321695925075024,2021-12-05 02:45:20 UTC
806431,mainnet,254,109728000,110092143,364144,326569,37575,0.10318720066786766,2021-12-05 02:47:52 UTC
806433,mainnet,254,109728000,110092388,364389,326807,37582,0.10313703212775358,2021-12-05 02:50:01 UTC
806434,mainnet,254,109728000,110092596,364597,327007,37590,0.10310013521778841,2021-12-05 02:52:05 UTC
806436,mainnet,254,109728000,110092820,364821,327223,37598,0.10305876032355593,2021-12-05 02:54:23 UTC
806437,mainnet,254,109728000,110093044,365045,327428,37617,0.10304756947773562,2021-12-05 02:56:27 UTC
806439,mainnet,254,109728000,110093286,365287,327652,37635,0.10302857752944945,2021-12-05 02:58:40 UTC
806440,mainnet,254,109728000,110093545,365546,327895,37651,0.10299934891915108,2021-12-05 03:01:00 UTC
806442,mainnet,254,109728000,110093746,365747,328075,37672,0.10300016131369498,2021-12-05 03:03:14 UTC
806443,mainnet,254,109728000,110093927,365928,328219,37709,0.10305032684025273,2021-12-05 03:05:21 UTC
806444,mainnet,254,109728000,110094157,366158,328407,37751,0.10310030096297226,2021-12-05 03:07:36 UTC
806446,mainnet,254,109728000,110094361,366362,328577,37785,0.1031356963877258,2021-12-05 03:09:43 UTC
806447,mainnet,254,109728000,110094567,366568,328742,37826,0.10318958556120555,2021-12-05 03:11:55 UTC
806449,mainnet,254,109728000,110094813,366814,328967,37847,0.10317763226049169,2021-12-05 03:14:14 UTC
806451,mainnet,254,109728000,110095122,367123,329244,37879,0.10317795398272514,2021-12-05 03:17:06 UTC
806452,mainnet,254,109728000,110095340,367341,329447,37894,0.10315755660272063,2021-12-05 03:19:16 UTC
806454,mainnet,254,109728000,110095571,367572,329651,37921,0.10316618240780037,2021-12-05 03:21:31 UTC
806455,mainnet,254,109728000,110095817,367818,329872,37946,0.10316515233077228,2021-12-05 03:23:44 UTC
806457,mainnet,254,109728000,110096037,368038,330082,37956,0.10313065498671332,2021-12-05 03:26:14 UTC
806458,mainnet,254,109728000,110096302,368303,330337,37966,0.10308360236001336,2021-12-05 03:28:28 UTC
806460,mainnet,254,109728000,110096524,368525,330546,37979,0.10305678040838477,2021-12-05 03:30:59 UTC
806461,mainnet,254,109728000,110096758,368759,330762,37997,0.10304019698502274,2021-12-05 03:33:21 UTC
806463,mainnet,254,109728000,110097037,369038,331030,38008,0.10299210379418922,2021-12-05 03:35:19 UTC
806464,mainnet,254,109728000,110097297,369298,331279,38019,0.10294937963379168,2021-12-05 03:37:39 UTC
806466,mainnet,254,109728000,110097515,369516,331476,38040,0.10294547462085539,2021-12-05 03:39:55 UTC
806467,mainnet,254,109728000,110097774,369775,331707,38068,0.10294909066324116,2021-12-05 03:42:20 UTC
806469,mainnet,254,109728000,110098028,370029,331943,38086,0.10292706787846358,2021-12-05 03:44:36 UTC
806471,mainnet,254,109728000,110098259,370260,332161,38099,0.10289796359315076,2021-12-05 03:47:02 UTC
806472,mainnet,254,109728000,110098520,370521,332401,38120,0.102882157826412,2021-12-05 03:49:24 UTC
806474,mainnet,254,109728000,110098731,370732,332610,38122,0.10282899776658071,2021-12-05 03:51:27 UTC
806475,mainnet,254,109728000,110098985,370986,332846,38140,0.10280711401508413,2021-12-05 03:53:36 UTC
806477,mainnet,254,109728000,110099215,371216,333057,38159,0.10279459937071678,2021-12-05 03:55:48 UTC
806478,mainnet,254,109728000,110099457,371458,333283,38175,0.10277070355194935,2021-12-05 03:58:06 UTC
806479,mainnet,254,109728000,110099681,371682,333486,38196,0.10276526708315173,2021-12-05 04:00:17 UTC
806480,mainnet,254,109728000,110099949,371950,333741,38209,0.10272617287269795,2021-12-05 04:02:35 UTC
806482,mainnet,254,109728000,110100224,372225,333999,38226,0.10269595003022365,2021-12-05 04:04:50 UTC
806483,mainnet,254,109728000,110100474,372475,334229,38246,0.10268071682663266,2021-12-05 04:07:21 UTC
806485,mainnet,254,109728000,110100734,372735,334478,38257,0.10263860383382296,2021-12-05 04:09:41 UTC
806486,mainnet,254,109728000,110100967,372968,334705,38263,0.1025905707728277,2021-12-05 04:11:56 UTC
806488,mainnet,254,109728000,110101182,373183,334908,38275,0.10256362160119833,2021-12-05 04:14:07 UTC
806490,mainnet,254,109728000,110101460,373461,335142,38319,0.10260509129467334,2021-12-05 04:16:35 UTC
806491,mainnet,254,109728000,110101681,373682,335336,38346,0.10261666336617765,2021-12-05 04:18:36 UTC
806493,mainnet,254,109728000,110101916,373917,335557,38360,0.10258961213317394,2021-12-05 04:21:01 UTC
806494,mainnet,254,109728000,110102092,374093,335703,38390,0.10262154063294421,2021-12-05 04:23:13 UTC
806496,mainnet,254,109728000,110102343,374344,335895,38449,0.10271034129036394,2021-12-05 04:25:36 UTC
806497,mainnet,254,109728000,110102552,374553,336071,38482,0.1027411340985121,2021-12-05 04:28:09 UTC
806499,mainnet,254,109728000,110102821,374822,336306,38516,0.10275810918249195,2021-12-05 04:30:24 UTC
806500,mainnet,254,109728000,110103034,375035,336499,38536,0.10275307637953791,2021-12-05 04:32:43 UTC
806502,mainnet,254,109728000,110103255,375256,336711,38545,0.1027165455049353,2021-12-05 04:34:59 UTC
806503,mainnet,254,109728000,110103534,375535,336970,38565,0.10269349062004873,2021-12-05 04:37:23 UTC
806505,mainnet,254,109728000,110103790,375791,337200,38591,0.10269272015561842,2021-12-05 04:39:37 UTC
806507,mainnet,254,109728000,110104041,376042,337443,38599,0.1026454491785492,2021-12-05 04:42:01 UTC
806508,mainnet,254,109728000,110104295,376296,337685,38611,0.10260805323468758,2021-12-05 04:44:30 UTC
806509,mainnet,254,109728000,110104561,376562,337940,38622,0.1025647834885092,2021-12-05 04:46:41 UTC
806510,mainnet,254,109728000,110104787,376788,338146,38642,0.10255634468189008,2021-12-05 04:48:51 UTC
806512,mainnet,254,109728000,110105051,377052,338398,38654,0.10251636379067078,2021-12-05 04:51:11 UTC
806513,mainnet,254,109728000,110105277,377278,338617,38661,0.1024735075991709,2021-12-05 04:53:29 UTC
806515,mainnet,254,109728000,110105519,377520,338858,38662,0.10241046831955923,2021-12-05 04:55:48 UTC
806517,mainnet,254,109728000,110105783,377784,339095,38689,0.10241037206446012,2021-12-05 04:58:22 UTC
806518,mainnet,254,109728000,110106003,378004,339294,38710,0.1024063237426059,2021-12-05 05:00:43 UTC
806520,mainnet,254,109728000,110106272,378273,339540,38733,0.10239430252753963,2021-12-05 05:03:09 UTC
806521,mainnet,254,109728000,110106542,378543,339790,38753,0.1023741028099846,2021-12-05 05:05:29 UTC
806523,mainnet,254,109728000,110106808,378809,340041,38768,0.10234181342048368,2021-12-05 05:08:12 UTC
806524,mainnet,254,109728000,110107091,379092,340315,38777,0.10228915408396906,2021-12-05 05:10:32 UTC
806526,mainnet,254,109728000,110107356,379357,340563,38794,0.10226251262003865,2021-12-05 05:12:55 UTC
806528,mainnet,254,109728000,110107592,379593,340773,38820,0.10226742853529965,2021-12-05 05:15:04 UTC
806529,mainnet,254,109728000,110107752,379753,340917,38836,0.10226647320758493,2021-12-05 05:16:56 UTC
806530,mainnet,254,109728000,110107977,379978,341130,38848,0.10223749796040824,2021-12-05 05:19:08 UTC
806531,mainnet,254,109728000,110108221,380222,341349,38873,0.10223764011551147,2021-12-05 05:21:27 UTC
806533,mainnet,254,109728000,110108486,380487,341597,38890,0.10221111365171477,2021-12-05 05:23:45 UTC
806534,mainnet,254,109728000,110108722,380723,341827,38896,0.10216351520659377,2021-12-05 05:26:02 UTC
806536,mainnet,254,109728000,110108938,380939,342036,38903,0.10212396210416891,2021-12-05 05:28:15 UTC
806537,mainnet,254,109728000,110109179,381180,342263,38917,0.10209612256676635,2021-12-05 05:30:45 UTC
806539,mainnet,254,109728000,110109478,381479,342546,38933,0.10205804251348043,2021-12-05 05:33:14 UTC
806540,mainnet,254,109728000,110109731,381732,342791,38941,0.1020113587543093,2021-12-05 05:35:36 UTC
806542,mainnet,254,109728000,110109984,381985,343038,38947,0.10195950102752725,2021-12-05 05:37:54 UTC
806543,mainnet,254,109728000,110110262,382263,343299,38964,0.10192982318456141,2021-12-05 05:40:19 UTC
806545,mainnet,254,109728000,110110492,382493,343516,38977,0.10190251847746233,2021-12-05 05:42:27 UTC
806546,mainnet,254,109728000,110110742,382743,343754,38989,0.10186731044068735,2021-12-05 05:44:37 UTC
806548,mainnet,254,109728000,110111044,383045,344052,38993,0.1017974389432051,2021-12-05 05:47:28 UTC
806550,mainnet,254,109728000,110111264,383265,344257,39008,0.10177814306028465,2021-12-05 05:49:42 UTC
806551,mainnet,254,109728000,110111505,383506,344471,39035,0.1017845874640814,2021-12-05 05:51:55 UTC
806552,mainnet,254,109728000,110111737,383738,344696,39042,0.10174129223584842,2021-12-05 05:54:06 UTC
806553,mainnet,254,109728000,110111963,383964,344904,39060,0.10172828702690877,2021-12-05 05:56:15 UTC
806555,mainnet,254,109728000,110112168,384169,345074,39095,0.10176510858502377,2021-12-05 05:58:23 UTC
806556,mainnet,254,109728000,110112396,384397,345282,39115,0.10175677749826352,2021-12-05 06:00:37 UTC
806558,mainnet,254,109728000,110112644,384645,345505,39140,0.1017561647753123,2021-12-05 06:03:00 UTC
806559,mainnet,254,109728000,110112902,384903,345753,39150,0.1017139383169266,2021-12-05 06:05:14 UTC
806561,mainnet,254,109728000,110113168,385169,346018,39151,0.10164629032969943,2021-12-05 06:07:43 UTC
806562,mainnet,254,109728000,110113439,385440,346274,39166,0.1016137401411374,2021-12-05 06:10:05 UTC
806564,mainnet,254,109728000,110113684,385685,346504,39181,0.10158808353967616,2021-12-05 06:12:21 UTC
806565,mainnet,254,109728000,110113922,385923,346741,39182,0.10152802502053518,2021-12-05 06:14:32 UTC
806567,mainnet,254,109728000,110114183,386184,346999,39185,0.10146717626830734,2021-12-05 06:16:55 UTC
806568,mainnet,254,109728000,110114438,386439,347239,39200,0.1014390369502043,2021-12-05 06:19:16 UTC
806570,mainnet,254,109728000,110114703,386704,347504,39200,0.10136952294261244,2021-12-05 06:21:38 UTC
806572,mainnet,254,109728000,110114977,386978,347776,39202,0.1013029164448625,2021-12-05 06:23:53 UTC
806573,mainnet,254,109728000,110115220,387221,348011,39210,0.10126000397705703,2021-12-05 06:26:02 UTC
806574,mainnet,254,109728000,110115492,387493,348257,39236,0.10125602268944213,2021-12-05 06:28:26 UTC
806575,mainnet,254,109728000,110115744,387745,348480,39265,0.10126500664096248,2021-12-05 06:30:52 UTC
806577,mainnet,254,109728000,110115970,387971,348687,39284,0.10125499070806838,2021-12-05 06:32:58 UTC
806578,mainnet,254,109728000,110116212,388213,348916,39297,0.10122535824405675,2021-12-05 06:35:22 UTC
806580,mainnet,254,109728000,110116407,388408,349089,39319,0.1012311795843546,2021-12-05 06:37:35 UTC
806581,mainnet,254,109728000,110116670,388671,349331,39340,0.1012167102768151,2021-12-05 06:39:47 UTC
806583,mainnet,254,109728000,110116920,388921,349571,39350,0.10117735992656607,2021-12-05 06:42:06 UTC
806584,mainnet,254,109728000,110117144,389145,349776,39369,0.10116794511043442,2021-12-05 06:44:11 UTC
806586,mainnet,254,109728000,110117345,389346,349964,39382,0.10114910645030384,2021-12-05 06:46:06 UTC
806587,mainnet,254,109728000,110117526,389527,350139,39388,0.10111750918421573,2021-12-05 06:48:06 UTC
806588,mainnet,254,109728000,110117800,389801,350393,39408,0.10109773961585528,2021-12-05 06:50:25 UTC
806589,mainnet,254,109728000,110118003,390004,350594,39410,0.10105024563850627,2021-12-05 06:52:39 UTC
806591,mainnet,254,109728000,110118273,390274,350854,39420,0.10100595991534153,2021-12-05 06:54:48 UTC
806592,mainnet,254,109728000,110118493,390494,351064,39430,0.10097466286293771,2021-12-05 06:56:51 UTC
806594,mainnet,254,109728000,110118708,390709,351257,39452,0.10097540624864029,2021-12-05 06:58:56 UTC
806595,mainnet,254,109728000,110118973,390974,351499,39475,0.10096579312179327,2021-12-05 07:01:20 UTC
806597,mainnet,254,109728000,110119183,391184,351684,39500,0.10097550002045073,2021-12-05 07:03:33 UTC
806598,mainnet,254,109728000,110119409,391410,351900,39510,0.10094274545872614,2021-12-05 07:05:45 UTC
806600,mainnet,254,109728000,110119665,391666,352136,39530,0.10092783136652148,2021-12-05 07:07:55 UTC
806601,mainnet,254,109728000,110119911,391912,352367,39545,0.10090275367939741,2021-12-05 07:10:05 UTC
806603,mainnet,254,109728000,110120173,392174,352617,39557,0.10086594215832768,2021-12-05 07:12:21 UTC
806604,mainnet,254,109728000,110120428,392429,352866,39563,0.1008156889526513,2021-12-05 07:14:33 UTC
806606,mainnet,254,109728000,110120663,392664,353094,39570,0.10077318012346434,2021-12-05 07:16:40 UTC
806607,mainnet,254,109728000,110120897,392898,353314,39584,0.10074879485260806,2021-12-05 07:18:47 UTC
806609,mainnet,254,109728000,110121149,393150,353555,39595,0.10071219636271143,2021-12-05 07:20:59 UTC
806610,mainnet,254,109728000,110121410,393411,353807,39604,0.1006682578778936,2021-12-05 07:23:14 UTC
806612,mainnet,254,109728000,110121682,393683,354070,39613,0.1006215660823556,2021-12-05 07:25:37 UTC
806613,mainnet,254,109728000,110121894,393895,354272,39623,0.10059279757295726,2021-12-05 07:27:50 UTC
806615,mainnet,254,109728000,110122178,394179,354535,39644,0.10057359727433475,2021-12-05 07:30:15 UTC
806616,mainnet,254,109728000,110122412,394413,354762,39651,0.10053167618714394,2021-12-05 07:32:19 UTC
806618,mainnet,254,109728000,110122694,394695,355039,39656,0.10047251675344253,2021-12-05 07:34:52 UTC
806620,mainnet,254,109728000,110122948,394949,355275,39674,0.10045347627161988,2021-12-05 07:37:03 UTC
806621,mainnet,254,109728000,110123229,395230,355530,39700,0.10044784049793791,2021-12-05 07:39:37 UTC
806623,mainnet,254,109728000,110123516,395517,355806,39711,0.10040276397727531,2021-12-05 07:42:01 UTC
806624,mainnet,254,109728000,110123764,395765,356041,39724,0.10037269591803216,2021-12-05 07:44:18 UTC
806626,mainnet,254,109728000,110124031,396032,356287,39745,0.100358051874596,2021-12-05 07:46:37 UTC
806627,mainnet,254,109728000,110124268,396269,356504,39765,0.10034850063971695,2021-12-05 07:48:45 UTC
806628,mainnet,254,109728000,110124507,396508,356724,39784,0.10033593269240469,2021-12-05 07:51:09 UTC
806630,mainnet,254,109728000,110124717,396718,356898,39820,0.10037356510165911,2021-12-05 07:53:25 UTC
806631,mainnet,254,109728000,110124929,396930,357078,39852,0.1004005744085859,2021-12-05 07:55:40 UTC
806633,mainnet,254,109728000,110125196,397197,357316,39881,0.10040609571572796,2021-12-05 07:58:17 UTC
806634,mainnet,254,109728000,110125441,397442,357550,39892,0.10037187816083856,2021-12-05 08:00:29 UTC
806636,mainnet,254,109728000,110125697,397698,357799,39899,0.10032486962469009,2021-12-05 08:03:04 UTC
806637,mainnet,254,109728000,110125934,397935,358017,39918,0.10031286516642166,2021-12-05 08:05:15 UTC
806639,mainnet,254,109728000,110126162,398163,358210,39953,0.10034332672799834,2021-12-05 08:07:34 UTC
806640,mainnet,254,109728000,110126415,398416,358428,39988,0.10036745512228425,2021-12-05 08:09:58 UTC
806642,mainnet,254,109728000,110126635,398636,358631,40005,0.10035470955959823,2021-12-05 08:12:12 UTC
806643,mainnet,254,109728000,110126882,398883,358870,40013,0.10031262299972674,2021-12-05 08:14:23 UTC
806644,mainnet,254,109728000,110127120,399121,359094,40027,0.10028788262206198,2021-12-05 08:16:36 UTC
806646,mainnet,254,109728000,110127364,399365,359314,40051,0.10028670514441676,2021-12-05 08:18:43 UTC
806647,mainnet,254,109728000,110127597,399598,359534,40064,0.10026076206587621,2021-12-05 08:20:55 UTC
806649,mainnet,254,109728000,110127837,399838,359772,40066,0.1002055832612208,2021-12-05 08:23:06 UTC
806650,mainnet,254,109728000,110128074,400075,359988,40087,0.100198712741361,2021-12-05 08:25:16 UTC
806651,mainnet,254,109728000,110128274,400275,360170,40105,0.10019361688838924,2021-12-05 08:27:13 UTC
806653,mainnet,254,109728000,110128512,400513,360403,40110,0.10014656203419114,2021-12-05 08:29:22 UTC
806654,mainnet,254,109728000,110128761,400762,360634,40128,0.10012925377156517,2021-12-05 08:31:33 UTC
806656,mainnet,254,109728000,110128957,400958,360826,40132,0.10009028377036996,2021-12-05 08:33:48 UTC
806657,mainnet,254,109728000,110129225,401226,361065,40161,0.10009570665908989,2021-12-05 08:36:13 UTC
806659,mainnet,254,109728000,110129471,401472,361303,40169,0.10005430017535469,2021-12-05 08:38:34 UTC
806660,mainnet,254,109728000,110129677,401678,361496,40182,0.10003535169962009,2021-12-05 08:40:41 UTC
806662,mainnet,254,109728000,110129908,401909,361687,40222,0.10007738070060636,2021-12-05 08:42:54 UTC
806663,mainnet,254,109728000,110130176,402177,361931,40246,0.10007036702745309,2021-12-05 08:45:19 UTC
806665,mainnet,254,109728000,110130411,402412,362147,40265,0.100059143365506,2021-12-05 08:47:35 UTC
806666,mainnet,254,109728000,110130673,402674,362402,40272,0.10001142363301331,2021-12-05 08:49:54 UTC
806668,mainnet,254,109728000,110130891,402892,362611,40281,0.09997964715109757,2021-12-05 08:52:13 UTC
806669,mainnet,254,109728000,110131117,403118,362819,40299,0.09996824751065445,2021-12-05 08:54:20 UTC
806671,mainnet,254,109728000,110131343,403344,363026,40318,0.09995933991828315,2021-12-05 08:56:27 UTC
806672,mainnet,254,109728000,110131547,403548,363204,40344,0.09997323738440037,2021-12-05 08:58:41 UTC
806673,mainnet,254,109728000,110131846,403847,363479,40368,0.09995864770569052,2021-12-05 09:01:29 UTC
806675,mainnet,254,109728000,110132193,404194,363813,40381,0.0999049961157266,2021-12-05 09:04:42 UTC
806676,mainnet,254,109728000,110132415,404416,364015,40401,0.09989960832410191,2021-12-05 09:06:53 UTC
806678,mainnet,254,109728000,110132676,404677,364253,40424,0.0998920126421813,2021-12-05 09:09:26 UTC
806679,mainnet,254,109728000,110132936,404937,364494,40443,0.09987479533853415,2021-12-05 09:11:53 UTC
806681,mainnet,254,109728000,110133162,405163,364705,40458,0.09985610729508865,2021-12-05 09:14:02 UTC
806682,mainnet,254,109728000,110133376,405377,364904,40473,0.09984039548371022,2021-12-05 09:16:05 UTC
806684,mainnet,254,109728000,110133597,405598,365114,40484,0.09981311544928723,2021-12-05 09:18:24 UTC
806686,mainnet,254,109728000,110133847,405848,365339,40509,0.09981323056908005,2021-12-05 09:20:47 UTC
806687,mainnet,254,109728000,110134099,406100,365567,40533,0.09981039152918,2021-12-05 09:23:01 UTC
806689,mainnet,254,109728000,110134344,406345,365811,40534,0.09975267322103139,2021-12-05 09:25:23 UTC
806690,mainnet,254,109728000,110134584,406585,366045,40540,0.09970854802808761,2021-12-05 09:27:38 UTC
806692,mainnet,254,109728000,110134864,406865,366306,40559,0.09968662824278324,2021-12-05 09:30:05 UTC
806693,mainnet,254,109728000,110135133,407134,366554,40580,0.09967234374923244,2021-12-05 09:32:37 UTC
806695,mainnet,254,109728000,110135420,407421,366828,40593,0.09963403948250091,2021-12-05 09:35:11 UTC
806696,mainnet,254,109728000,110135766,407767,367156,40611,0.0995936404858657,2021-12-05 09:38:16 UTC
806698,mainnet,254,109728000,110136031,408032,367406,40626,0.09956572033565995,2021-12-05 09:40:47 UTC
806700,mainnet,254,109728000,110136259,408260,367607,40653,0.09957625042864841,2021-12-05 09:42:54 UTC
806701,mainnet,254,109728000,110136564,408565,367909,40656,0.0995092580128009,2021-12-05 09:45:36 UTC
806703,mainnet,254,109728000,110136818,408819,368145,40674,0.09949146199173717,2021-12-05 09:47:54 UTC
806704,mainnet,254,109728000,110137066,409067,368382,40685,0.09945803499182286,2021-12-05 09:50:10 UTC
806705,mainnet,254,109728000,110137289,409290,368602,40688,0.09941117545016981,2021-12-05 09:52:16 UTC
806707,mainnet,254,109728000,110137520,409521,368817,40704,0.09939417026233087,2021-12-05 09:54:23 UTC
806708,mainnet,254,109728000,110137759,409760,369037,40723,0.099382565404139,2021-12-05 09:56:33 UTC
806709,mainnet,254,109728000,110138016,410017,369262,40755,0.09939831763073238,2021-12-05 09:58:57 UTC
806710,mainnet,254,109728000,110138283,410284,369515,40769,0.099367755018475,2021-12-05 10:01:23 UTC
806712,mainnet,254,109728000,110138500,410501,369720,40781,0.09934445957500712,2021-12-05 10:03:46 UTC
806713,mainnet,254,109728000,110138752,410753,369953,40800,0.09932976752452204,2021-12-05 10:06:05 UTC
806715,mainnet,254,109728000,110139006,411007,370196,40811,0.09929514582476698,2021-12-05 10:08:22 UTC
806716,mainnet,254,109728000,110139235,411236,370420,40816,0.09925201101070918,2021-12-05 10:10:32 UTC
806717,mainnet,254,109728000,110139499,411500,370656,40844,0.09925637910085054,2021-12-05 10:12:53 UTC
806719,mainnet,254,109728000,110139741,411742,370875,40867,0.09925390171515172,2021-12-05 10:15:05 UTC
806720,mainnet,254,109728000,110139913,411914,371034,40880,0.09924401695499546,2021-12-05 10:17:12 UTC
806722,mainnet,254,109728000,110140155,412156,371258,40898,0.09922941798736401,2021-12-05 10:19:37 UTC
806723,mainnet,254,109728000,110140418,412419,371517,40902,0.09917583816458504,2021-12-05 10:21:51 UTC
806725,mainnet,254,109728000,110140694,412695,371778,40917,0.09914585832152073,2021-12-05 10:24:11 UTC
806726,mainnet,254,109728000,110140922,412923,372005,40918,0.09909353559864673,2021-12-05 10:26:18 UTC
806728,mainnet,254,109728000,110141209,413210,372274,40936,0.0990682703709978,2021-12-05 10:28:48 UTC
806729,mainnet,254,109728000,110141469,413470,372525,40945,0.09902774082762958,2021-12-05 10:31:06 UTC
806731,mainnet,254,109728000,110141684,413685,372727,40958,0.09900769909472183,2021-12-05 10:33:29 UTC
806732,mainnet,254,109728000,110141966,413967,372962,41005,0.09905378931170843,2021-12-05 10:35:43 UTC
806734,mainnet,254,109728000,110142150,414151,373131,41020,0.09904600013038722,2021-12-05 10:37:58 UTC
806735,mainnet,254,109728000,110142483,414484,373439,41045,0.09902674168363555,2021-12-05 10:40:28 UTC
806737,mainnet,254,109728000,110142773,414774,373714,41060,0.09899366884134493,2021-12-05 10:42:51 UTC
806738,mainnet,254,109728000,110142993,414994,373920,41074,0.09897492493867381,2021-12-05 10:45:00 UTC
806740,mainnet,254,109728000,110143224,415225,374131,41094,0.09896802938166055,2021-12-05 10:47:18 UTC
806742,mainnet,254,109728000,110143471,415472,374362,41110,0.09894770285362191,2021-12-05 10:49:43 UTC
806743,mainnet,254,109728000,110143764,415765,374641,41124,0.09891164479934579,2021-12-05 10:52:25 UTC
806745,mainnet,254,109728000,110143985,415986,374837,41149,0.09891919439596525,2021-12-05 10:54:40 UTC
806746,mainnet,254,109728000,110144264,416265,375109,41156,0.0988697104008264,2021-12-05 10:57:12 UTC
806748,mainnet,254,109728000,110144498,416499,375335,41164,0.09883337054830864,2021-12-05 10:59:25 UTC
806749,mainnet,254,109728000,110144773,416774,375585,41189,0.09882814187065411,2021-12-05 11:01:59 UTC
806751,mainnet,254,109728000,110145040,417041,375850,41191,0.09876966533266514,2021-12-05 11:04:16 UTC
806752,mainnet,254,109728000,110145300,417301,376110,41191,0.09870812674783909,2021-12-05 11:06:28 UTC
806754,mainnet,254,109728000,110145564,417565,376355,41210,0.09869122172595883,2021-12-05 11:08:48 UTC
806756,mainnet,254,109728000,110145874,417875,376655,41220,0.09864193837870176,2021-12-05 11:11:35 UTC
806757,mainnet,254,109728000,110146112,418113,376888,41225,0.09859774749888188,2021-12-05 11:13:53 UTC
806759,mainnet,254,109728000,110146257,418258,377027,41231,0.0985779112413869,2021-12-05 11:16:09 UTC
806760,mainnet,254,109728000,110146601,418602,377334,41268,0.09858529104017659,2021-12-05 11:18:28 UTC
806762,mainnet,254,109728000,110146859,418860,377588,41272,0.09853411641121139,2021-12-05 11:20:37 UTC
806763,mainnet,254,109728000,110146982,418983,377707,41276,0.09851473687476581,2021-12-05 11:22:45 UTC
806764,mainnet,254,109728000,110147309,419310,377991,41319,0.09854045932603563,2021-12-05 11:25:05 UTC
806765,mainnet,254,109728000,110147570,419571,378233,41338,0.09852444520712823,2021-12-05 11:27:28 UTC
806767,mainnet,254,109728000,110147812,419813,378463,41350,0.09849623522854223,2021-12-05 11:29:36 UTC
806768,mainnet,254,109728000,110148062,420063,378700,41363,0.098468563048876,2021-12-05 11:31:46 UTC
806770,mainnet,254,109728000,110148339,420340,378949,41391,0.09847028595898559,2021-12-05 11:34:31 UTC
806771,mainnet,254,109728000,110148646,420647,379253,41394,0.09840555144812634,2021-12-05 11:37:21 UTC
806772,mainnet,254,109728000,110148839,420840,379415,41425,0.09843408421252732,2021-12-05 11:39:38 UTC
806774,mainnet,254,109728000,110149178,421179,379729,41450,0.09841421343419306,2021-12-05 11:42:02 UTC
806776,mainnet,254,109728000,110149440,421441,379947,41494,0.09845743532309387,2021-12-05 11:44:31 UTC
806777,mainnet,254,109728000,110149700,421701,380197,41504,0.09842044481753659,2021-12-05 11:46:48 UTC
806779,mainnet,254,109728000,110149920,421921,380405,41516,0.09839756731710439,2021-12-05 11:49:01 UTC
806780,mainnet,254,109728000,110150160,422161,380610,41551,0.09842453471542847,2021-12-05 11:51:16 UTC
806782,mainnet,254,109728000,110150376,422377,380812,41565,0.09840734699095831,2021-12-05 11:53:23 UTC
806783,mainnet,254,109728000,110150568,422569,380981,41588,0.0984170632488422,2021-12-05 11:55:23 UTC
806785,mainnet,254,109728000,110150795,422796,381192,41604,0.09840206624471376,2021-12-05 11:57:31 UTC
806786,mainnet,254,109728000,110151044,423045,381432,41613,0.09836542211821438,2021-12-05 11:59:52 UTC
806787,mainnet,254,109728000,110151329,423330,381692,41638,0.0983582547894078,2021-12-05 12:02:33 UTC
806789,mainnet,254,109728000,110151580,423581,381936,41645,0.09831649672671815,2021-12-05 12:04:50 UTC
806790,mainnet,254,109728000,110151782,423783,382134,41649,0.0982790720722634,2021-12-05 12:06:58 UTC
806792,mainnet,254,109728000,110152009,424010,382329,41681,0.09830192684134809,2021-12-05 12:09:05 UTC
806793,mainnet,254,109728000,110152265,424266,382557,41709,0.09830860827876851,2021-12-05 12:11:25 UTC
806795,mainnet,254,109728000,110152498,424499,382775,41724,0.0982899841931312,2021-12-05 12:13:32 UTC
806796,mainnet,254,109728000,110152676,424677,382933,41744,0.09829588134040694,2021-12-05 12:15:51 UTC
806798,mainnet,254,109728000,110152977,424978,383188,41790,0.0983345020212811,2021-12-05 12:18:25 UTC
806799,mainnet,254,109728000,110153226,425227,383414,41813,0.09833100908455954,2021-12-05 12:20:54 UTC
806801,mainnet,254,109728000,110153429,425430,383606,41824,0.09830994523188304,2021-12-05 12:23:07 UTC
806802,mainnet,254,109728000,110153530,425531,383681,41850,0.09834771144757962,2021-12-05 12:25:13 UTC
806803,mainnet,254,109728000,110153858,425859,383972,41887,0.09835884647265879,2021-12-05 12:27:24 UTC
806805,mainnet,254,109728000,110154095,426096,384194,41902,0.09833934136908115,2021-12-05 12:29:30 UTC
806806,mainnet,254,109728000,110154304,426305,384388,41917,0.09832631566601377,2021-12-05 12:31:35 UTC
806807,mainnet,254,109728000,110154525,426526,384599,41927,0.09829881414028688,2021-12-05 12:33:41 UTC
806809,mainnet,254,109728000,110154764,426765,384830,41935,0.09826250981219171,2021-12-05 12:35:52 UTC
806810,mainnet,254,109728000,110154986,426987,385045,41942,0.09822781489834585,2021-12-05 12:38:01 UTC
806812,mainnet,254,109728000,110155200,427201,385243,41958,0.09821606222831876,2021-12-05 12:40:03 UTC
806813,mainnet,254,109728000,110155431,427432,385450,41982,0.0982191319320968,2021-12-05 12:42:14 UTC
806815,mainnet,254,109728000,110155628,427629,385633,41996,0.0982066230307112,2021-12-05 12:44:16 UTC
806816,mainnet,254,109728000,110155858,427859,385846,42013,0.09819356376750285,2021-12-05 12:46:17 UTC
806817,mainnet,254,109728000,110156077,428078,386050,42028,0.0981783693625928,2021-12-05 12:48:22 UTC
806818,mainnet,254,109728000,110156333,428334,386293,42041,0.09815004178981823,2021-12-05 12:50:39 UTC
806820,mainnet,254,109728000,110156582,428583,386520,42063,0.09814435010254723,2021-12-05 12:53:04 UTC
806821,mainnet,254,109728000,110156808,428809,386730,42079,0.09812993663845675,2021-12-05 12:55:07 UTC
806823,mainnet,254,109728000,110157039,429040,386947,42093,0.09810973335819503,2021-12-05 12:57:21 UTC
806824,mainnet,254,109728000,110157318,429319,387209,42110,0.09808557273263005,2021-12-05 12:59:53 UTC
806826,mainnet,254,109728000,110157627,429628,387508,42120,0.09803830290390757,2021-12-05 13:02:43 UTC
806828,mainnet,254,109728000,110157877,429878,387750,42128,0.09799989764537846,2021-12-05 13:05:02 UTC
806829,mainnet,254,109728000,110158126,430127,387981,42146,0.09798501372850345,2021-12-05 13:07:19 UTC
806831,mainnet,254,109728000,110158376,430377,388188,42189,0.09802800800228637,2021-12-05 13:09:39 UTC
806832,mainnet,254,109728000,110158607,430608,388397,42211,0.09802651135139152,2021-12-05 13:11:54 UTC
806833,mainnet,254,109728000,110158851,430852,388620,42232,0.09801973763612563,2021-12-05 13:14:38 UTC
806835,mainnet,254,109728000,110159085,431086,388843,42243,0.09799204799042419,2021-12-05 13:16:52 UTC
806836,mainnet,254,109728000,110159332,431333,389064,42269,0.09799621174359485,2021-12-05 13:19:00 UTC
806837,mainnet,254,109728000,110159517,431518,389235,42283,0.09798664250390482,2021-12-05 13:21:15 UTC
806839,mainnet,254,109728000,110159748,431749,389420,42329,0.09804075979330583,2021-12-05 13:23:27 UTC
806840,mainnet,254,109728000,110159964,431965,389628,42337,0.09801025546051184,2021-12-05 13:25:43 UTC
806844,mainnet,255,110160000,110160979,980,886,94,0.09591836734693877,2021-12-05 13:35:54 UTC
806846,mainnet,255,110160000,110161169,1170,1043,127,0.10854700854700855,2021-12-05 13:37:44 UTC
806847,mainnet,255,110160000,110161360,1361,1224,137,0.10066127847171198,2021-12-05 13:39:35 UTC
806848,mainnet,255,110160000,110161566,1567,1416,151,0.09636247606892151,2021-12-05 13:41:30 UTC
806850,mainnet,255,110160000,110161769,1770,1603,167,0.09435028248587571,2021-12-05 13:43:27 UTC
806851,mainnet,255,110160000,110161956,1957,1785,172,0.08788962698007154,2021-12-05 13:45:26 UTC
806852,mainnet,255,110160000,110162170,2171,1964,207,0.09534776600644865,2021-12-05 13:47:29 UTC
806854,mainnet,255,110160000,110162434,2435,2177,258,0.10595482546201232,2021-12-05 13:49:54 UTC
806855,mainnet,255,110160000,110162670,2671,2403,268,0.10033695245226507,2021-12-05 13:51:59 UTC
806857,mainnet,255,110160000,110162897,2898,2624,274,0.0945479641131815,2021-12-05 13:54:05 UTC
806858,mainnet,255,110160000,110163126,3127,2839,288,0.09210105532459226,2021-12-05 13:56:00 UTC
806859,mainnet,255,110160000,110163384,3385,3071,314,0.09276218611521418,2021-12-05 13:58:19 UTC
806861,mainnet,255,110160000,110163608,3609,3291,318,0.08811305070656691,2021-12-05 14:00:24 UTC
806862,mainnet,255,110160000,110163876,3877,3545,332,0.08563322156306423,2021-12-05 14:02:44 UTC
806864,mainnet,255,110160000,110164072,4073,3735,338,0.08298551436287749,2021-12-05 14:04:49 UTC
806865,mainnet,255,110160000,110164293,4294,3935,359,0.08360503027480205,2021-12-05 14:07:03 UTC
806867,mainnet,255,110160000,110164525,4526,4148,378,0.08351745470614229,2021-12-05 14:09:22 UTC
806868,mainnet,255,110160000,110164726,4727,4321,406,0.08588957055214724,2021-12-05 14:11:17 UTC
806870,mainnet,255,110160000,110164947,4948,4534,414,0.08367016976556184,2021-12-05 14:13:36 UTC
806871,mainnet,255,110160000,110165179,5180,4756,424,0.08185328185328185,2021-12-05 14:15:54 UTC
806873,mainnet,255,110160000,110165425,5426,4990,436,0.08035385182454848,2021-12-05 14:18:13 UTC
806874,mainnet,255,110160000,110165656,5657,5209,448,0.07919391903835955,2021-12-05 14:20:42 UTC
806876,mainnet,255,110160000,110165902,5903,5434,469,0.07945112654582416,2021-12-05 14:22:58 UTC
806877,mainnet,255,110160000,110166118,6119,5630,489,0.07991501879392057,2021-12-05 14:25:07 UTC
806879,mainnet,255,110160000,110166346,6347,5834,513,0.08082558689144478,2021-12-05 14:27:22 UTC
806880,mainnet,255,110160000,110166549,6550,6026,524,0.08,2021-12-05 14:29:27 UTC
806881,mainnet,255,110160000,110166754,6755,6221,534,0.07905255366395263,2021-12-05 14:31:35 UTC
806883,mainnet,255,110160000,110167012,7013,6462,551,0.07856837302153144,2021-12-05 14:33:44 UTC
806884,mainnet,255,110160000,110167232,7233,6663,570,0.07880547490667773,2021-12-05 14:36:04 UTC
806886,mainnet,255,110160000,110167423,7424,6847,577,0.0777209051724138,2021-12-05 14:38:07 UTC
806887,mainnet,255,110160000,110167648,7649,7042,607,0.07935677866387764,2021-12-05 14:40:06 UTC
806889,mainnet,255,110160000,110167867,7868,7259,609,0.07740213523131673,2021-12-05 14:42:11 UTC
806890,mainnet,255,110160000,110168080,8081,7460,621,0.07684692488553396,2021-12-05 14:44:12 UTC
806892,mainnet,255,110160000,110168299,8300,7665,635,0.07650602409638554,2021-12-05 14:46:19 UTC
806893,mainnet,255,110160000,110168485,8486,7846,640,0.07541833608296017,2021-12-05 14:48:18 UTC
806894,mainnet,255,110160000,110168724,8725,8069,656,0.07518624641833811,2021-12-05 14:50:16 UTC
806895,mainnet,255,110160000,110168935,8936,8268,668,0.0747538048343778,2021-12-05 14:52:17 UTC
806897,mainnet,255,110160000,110169153,9154,8482,672,0.0734105309154468,2021-12-05 14:54:21 UTC
806898,mainnet,255,110160000,110169361,9362,8684,678,0.07242042298654133,2021-12-05 14:56:18 UTC
806899,mainnet,255,110160000,110169559,9560,8862,698,0.07301255230125522,2021-12-05 14:58:15 UTC
806900,mainnet,255,110160000,110169742,9743,9033,710,0.07287283177666017,2021-12-05 15:00:17 UTC
806902,mainnet,255,110160000,110169987,9988,9221,767,0.07679215058069684,2021-12-05 15:02:24 UTC
806903,mainnet,255,110160000,110170189,10190,9399,791,0.0776251226692836,2021-12-05 15:04:38 UTC
806905,mainnet,255,110160000,110170401,10402,9590,812,0.07806191117092867,2021-12-05 15:06:42 UTC
806906,mainnet,255,110160000,110170567,10568,9742,826,0.07816048448145345,2021-12-05 15:08:41 UTC
806908,mainnet,255,110160000,110170730,10731,9877,854,0.07958251793868232,2021-12-05 15:10:43 UTC
806909,mainnet,255,110160000,110170918,10919,10031,888,0.08132612876637055,2021-12-05 15:12:46 UTC
806911,mainnet,255,110160000,110171067,11068,10145,923,0.08339356704011565,2021-12-05 15:14:53 UTC
806912,mainnet,255,110160000,110171348,11349,10323,1026,0.09040444091990484,2021-12-05 15:16:58 UTC
806914,mainnet,255,110160000,110171546,11547,10475,1072,0.09283796657140382,2021-12-05 15:19:03 UTC
806915,mainnet,255,110160000,110171723,11724,10623,1101,0.09390992835209826,2021-12-05 15:21:01 UTC
806916,mainnet,255,110160000,110171901,11902,10776,1126,0.09460594858007057,2021-12-05 15:23:06 UTC
806918,mainnet,255,110160000,110172088,12089,10936,1153,0.09537596161799984,2021-12-05 15:25:11 UTC
806919,mainnet,255,110160000,110172282,12283,11108,1175,0.09566066921761784,2021-12-05 15:27:17 UTC
806920,mainnet,255,110160000,110172498,12499,11288,1211,0.09688775102008161,2021-12-05 15:29:25 UTC
806922,mainnet,255,110160000,110172694,12695,11478,1217,0.09586451358802678,2021-12-05 15:31:26 UTC
806923,mainnet,255,110160000,110172878,12879,11641,1238,0.0961254755804022,2021-12-05 15:33:26 UTC
806924,mainnet,255,110160000,110173078,13079,11820,1259,0.09626118204755715,2021-12-05 15:35:27 UTC
806926,mainnet,255,110160000,110173250,13251,11962,1289,0.09727567730737303,2021-12-05 15:37:24 UTC
806927,mainnet,255,110160000,110173446,13447,12115,1332,0.09905555142410946,2021-12-05 15:39:26 UTC
806928,mainnet,255,110160000,110173622,13623,12270,1353,0.09931733098436468,2021-12-05 15:41:34 UTC
806930,mainnet,255,110160000,110173800,13801,12424,1377,0.09977537859575393,2021-12-05 15:43:35 UTC
806931,mainnet,255,110160000,110173968,13969,12568,1401,0.10029350705132795,2021-12-05 15:45:35 UTC
806933,mainnet,255,110160000,110174152,14153,12716,1437,0.10153324383522928,2021-12-05 15:47:36 UTC
806934,mainnet,255,110160000,110174353,14354,12882,1472,0.1025498118991222,2021-12-05 15:49:43 UTC
806936,mainnet,255,110160000,110174569,14570,13048,1522,0.10446122168840083,2021-12-05 15:52:08 UTC
806937,mainnet,255,110160000,110174780,14781,13232,1549,0.10479669846424464,2021-12-05 15:54:16 UTC
806939,mainnet,255,110160000,110174991,14992,13389,1603,0.10692369263607257,2021-12-05 15:56:18 UTC
806940,mainnet,255,110160000,110175149,15150,13517,1633,0.10778877887788779,2021-12-05 15:58:30 UTC
806942,mainnet,255,110160000,110175415,15416,13735,1681,0.10904255319148937,2021-12-05 16:00:49 UTC
806943,mainnet,255,110160000,110175568,15569,13870,1699,0.1091271115678592,2021-12-05 16:03:00 UTC
806944,mainnet,255,110160000,110175852,15853,14099,1754,0.11064151895540277,2021-12-05 16:05:46 UTC
806946,mainnet,255,110160000,110176045,16046,14246,1800,0.11217748971706344,2021-12-05 16:07:54 UTC
806947,mainnet,255,110160000,110176290,16291,14447,1844,0.11319133263765269,2021-12-05 16:10:26 UTC
806949,mainnet,255,110160000,110176455,16456,14591,1865,0.11333252309188138,2021-12-05 16:12:26 UTC
806950,mainnet,255,110160000,110176671,16672,14757,1915,0.11486324376199616,2021-12-05 16:14:37 UTC
806952,mainnet,255,110160000,110176869,16870,14911,1959,0.11612329579134559,2021-12-05 16:16:49 UTC
806953,mainnet,255,110160000,110177042,17043,15055,1988,0.11664613037610749,2021-12-05 16:18:53 UTC
806955,mainnet,255,110160000,110177276,17277,15273,2004,0.11599235978468483,2021-12-05 16:21:11 UTC
806956,mainnet,255,110160000,110177478,17479,15460,2019,0.11551004062017278,2021-12-05 16:23:24 UTC
806958,mainnet,255,110160000,110177797,17798,15753,2045,0.11490055062366558,2021-12-05 16:26:15 UTC
806959,mainnet,255,110160000,110178050,18051,15981,2070,0.11467508725278378,2021-12-05 16:28:46 UTC
806961,mainnet,255,110160000,110178257,18258,16181,2077,0.11375835250301237,2021-12-05 16:30:54 UTC
806962,mainnet,255,110160000,110178474,18475,16364,2111,0.11426251691474966,2021-12-05 16:33:01 UTC
806964,mainnet,255,110160000,110178682,18683,16552,2131,0.11406091098859926,2021-12-05 16:35:08 UTC
806965,mainnet,255,110160000,110178898,18899,16751,2148,0.11365680723847822,2021-12-05 16:37:20 UTC
806966,mainnet,255,110160000,110179129,19130,16964,2166,0.11322530057501307,2021-12-05 16:39:27 UTC
806967,mainnet,255,110160000,110179334,19335,17158,2177,0.1125937419188001,2021-12-05 16:41:41 UTC
806969,mainnet,255,110160000,110179592,19593,17393,2200,0.11228499974480682,2021-12-05 16:44:08 UTC
806970,mainnet,255,110160000,110179778,19779,17565,2214,0.11193690277567117,2021-12-05 16:46:04 UTC
806972,mainnet,255,110160000,110179925,19926,17704,2222,0.11151259660744756,2021-12-05 16:47:34 UTC
806973,mainnet,255,110160000,110180078,20079,17844,2235,0.11131032421933364,2021-12-05 16:49:08 UTC
806974,mainnet,255,110160000,110180222,20223,17970,2253,0.11140780299658805,2021-12-05 16:50:38 UTC
806975,mainnet,255,110160000,110180421,20422,18156,2266,0.1109587699539712,2021-12-05 16:52:33 UTC
806977,mainnet,255,110160000,110180607,20608,18335,2273,0.11029697204968944,2021-12-05 16:54:28 UTC
806979,mainnet,255,110160000,110180819,20820,18536,2284,0.10970220941402498,2021-12-05 16:56:20 UTC
806980,mainnet,255,110160000,110180995,20996,18688,2308,0.10992570013335874,2021-12-05 16:58:17 UTC
806982,mainnet,255,110160000,110181265,21266,18934,2332,0.10965860998777391,2021-12-05 17:00:51 UTC
806983,mainnet,255,110160000,110181476,21477,19143,2334,0.10867439586534432,2021-12-05 17:02:59 UTC
806985,mainnet,255,110160000,110181684,21685,19339,2346,0.10818538160018445,2021-12-05 17:05:13 UTC
806986,mainnet,255,110160000,110181900,21901,19534,2367,0.1080772567462673,2021-12-05 17:07:23 UTC
806988,mainnet,255,110160000,110182139,22140,19750,2390,0.10794941282746161,2021-12-05 17:09:36 UTC
806989,mainnet,255,110160000,110182363,22364,19962,2402,0.10740475764621714,2021-12-05 17:11:44 UTC
806991,mainnet,255,110160000,110182621,22622,20208,2414,0.10671028202634604,2021-12-05 17:14:20 UTC
806992,mainnet,255,110160000,110182862,22863,20425,2438,0.10663517473647378,2021-12-05 17:17:06 UTC
806994,mainnet,255,110160000,110183092,23093,20615,2478,0.10730524401333738,2021-12-05 17:19:13 UTC
806996,mainnet,255,110160000,110183283,23284,20794,2490,0.10694038824944167,2021-12-05 17:21:30 UTC
806997,mainnet,255,110160000,110183503,23504,20999,2505,0.10657760381211709,2021-12-05 17:23:45 UTC
806998,mainnet,255,110160000,110183727,23728,21199,2529,0.10658293998651382,2021-12-05 17:25:55 UTC
806999,mainnet,255,110160000,110183942,23943,21393,2550,0.10650294449317128,2021-12-05 17:28:11 UTC
807001,mainnet,255,110160000,110184217,24218,21647,2571,0.10616070691221406,2021-12-05 17:30:53 UTC
807002,mainnet,255,110160000,110184452,24453,21865,2588,0.1058356847830532,2021-12-05 17:33:00 UTC
807004,mainnet,255,110160000,110184667,24668,22064,2604,0.10556186152099886,2021-12-05 17:35:21 UTC
807005,mainnet,255,110160000,110184876,24877,22240,2637,0.10600152751537564,2021-12-05 17:37:24 UTC
807006,mainnet,255,110160000,110185108,25109,22470,2639,0.10510175634234736,2021-12-05 17:39:47 UTC
807007,mainnet,255,110160000,110185349,25350,22694,2656,0.10477317554240631,2021-12-05 17:42:00 UTC
807009,mainnet,255,110160000,110185605,25606,22943,2663,0.10399906271967507,2021-12-05 17:44:23 UTC
807010,mainnet,255,110160000,110185824,25825,23160,2665,0.1031945788964182,2021-12-05 17:46:31 UTC
807012,mainnet,255,110160000,110186097,26098,23425,2673,0.10242164150509618,2021-12-05 17:49:12 UTC
807014,mainnet,255,110160000,110186380,26381,23707,2674,0.10136082786854175,2021-12-05 17:51:49 UTC
807015,mainnet,255,110160000,110186577,26578,23890,2688,0.10113627812476485,2021-12-05 17:54:00 UTC
807017,mainnet,255,110160000,110186824,26825,24120,2705,0.10083876980428705,2021-12-05 17:56:08 UTC
807018,mainnet,255,110160000,110186995,26996,24277,2719,0.10071862498147874,2021-12-05 17:58:17 UTC
807020,mainnet,255,110160000,110187329,27330,24586,2744,0.10040248810830589,2021-12-05 18:01:10 UTC
807021,mainnet,255,110160000,110187572,27573,24823,2750,0.09973524825009973,2021-12-05 18:03:23 UTC
807023,mainnet,255,110160000,110187812,27813,25056,2757,0.09912630784165678,2021-12-05 18:05:41 UTC
807024,mainnet,255,110160000,110188062,28063,25302,2761,0.09838577486369954,2021-12-05 18:08:22 UTC
807026,mainnet,255,110160000,110188605,28606,25822,2784,0.09732224008949171,2021-12-05 18:12:45 UTC
807028,mainnet,255,110160000,110188864,28865,26067,2798,0.09693400311796294,2021-12-05 18:15:00 UTC
807029,mainnet,255,110160000,110189133,29134,26323,2811,0.09648520628818562,2021-12-05 18:17:30 UTC
807031,mainnet,255,110160000,110189374,29375,26549,2826,0.09620425531914893,2021-12-05 18:19:49 UTC
807032,mainnet,255,110160000,110189622,29623,26791,2832,0.09560139081119401,2021-12-05 18:21:55 UTC
807034,mainnet,255,110160000,110189860,29861,27025,2836,0.0949733766451224,2021-12-05 18:24:02 UTC
807035,mainnet,255,110160000,110190027,30028,27176,2852,0.09497802051418676,2021-12-05 18:26:12 UTC
807037,mainnet,255,110160000,110190327,30328,27440,2888,0.09522553415985228,2021-12-05 18:28:24 UTC
807038,mainnet,255,110160000,110190572,30573,27666,2907,0.09508389755666764,2021-12-05 18:30:30 UTC
807040,mainnet,255,110160000,110190804,30805,27888,2917,0.0946924200616783,2021-12-05 18:32:42 UTC
807041,mainnet,255,110160000,110191000,31001,28070,2931,0.09454533724718557,2021-12-05 18:34:49 UTC
807043,mainnet,255,110160000,110191246,31247,28291,2956,0.09460108170384357,2021-12-05 18:36:56 UTC
807044,mainnet,255,110160000,110191503,31504,28527,2977,0.09449593702386999,2021-12-05 18:39:06 UTC
807046,mainnet,255,110160000,110191727,31728,28750,2978,0.09386031265758951,2021-12-05 18:41:14 UTC
807047,mainnet,255,110160000,110191992,31993,28999,2994,0.0935829712749664,2021-12-05 18:43:37 UTC
807049,mainnet,255,110160000,110192219,32220,29217,3003,0.09320297951582868,2021-12-05 18:45:42 UTC
807050,mainnet,255,110160000,110192454,32455,29433,3022,0.09311354182714528,2021-12-05 18:47:50 UTC
807052,mainnet,255,110160000,110192722,32723,29690,3033,0.09268710081593987,2021-12-05 18:50:25 UTC
807054,mainnet,255,110160000,110193030,33031,29994,3037,0.09194393145832702,2021-12-05 18:53:03 UTC
807055,mainnet,255,110160000,110193254,33255,30190,3065,0.0921665914900015,2021-12-05 18:55:09 UTC
807057,mainnet,255,110160000,110193516,33517,30427,3090,0.09219202195900587,2021-12-05 18:57:38 UTC
807058,mainnet,255,110160000,110193724,33725,30631,3094,0.09174203113417347,2021-12-05 18:59:40 UTC
807060,mainnet,255,110160000,110194008,34009,30911,3098,0.09109353406451233,2021-12-05 19:02:15 UTC
807061,mainnet,255,110160000,110194226,34227,31117,3110,0.09086393782686183,2021-12-05 19:04:52 UTC
807062,mainnet,255,110160000,110194484,34485,31349,3136,0.09093808902421342,2021-12-05 19:07:14 UTC
807064,mainnet,255,110160000,110194738,34739,31589,3150,0.09067618526727884,2021-12-05 19:09:38 UTC
807065,mainnet,255,110160000,110194995,34996,31829,3167,0.09049605669219339,2021-12-05 19:11:59 UTC
807067,mainnet,255,110160000,110195235,35236,32057,3179,0.090220229310932,2021-12-05 19:14:17 UTC
807068,mainnet,255,110160000,110195444,35445,32241,3204,0.09039356749894202,2021-12-05 19:16:25 UTC
807070,mainnet,255,110160000,110195677,35678,32440,3238,0.09075620830764056,2021-12-05 19:18:50 UTC
807071,mainnet,255,110160000,110196001,36002,32740,3262,0.09060607744014221,2021-12-05 19:21:28 UTC
807073,mainnet,255,110160000,110196255,36256,32977,3279,0.09044020300088261,2021-12-05 19:23:48 UTC
807075,mainnet,255,110160000,110196508,36509,33224,3285,0.08997781368977513,2021-12-05 19:26:05 UTC
807076,mainnet,255,110160000,110196727,36728,33435,3293,0.08965911566107602,2021-12-05 19:28:19 UTC
807077,mainnet,255,110160000,110196988,36989,33680,3309,0.08945902835978264,2021-12-05 19:30:43 UTC
807078,mainnet,255,110160000,110197234,37235,33894,3341,0.08972740700953404,2021-12-05 19:32:54 UTC
807080,mainnet,255,110160000,110197488,37489,34137,3352,0.08941289444903838,2021-12-05 19:35:11 UTC
807081,mainnet,255,110160000,110197770,37771,34406,3365,0.08908951311853008,2021-12-05 19:37:48 UTC
807083,mainnet,255,110160000,110198022,38023,34652,3371,0.08865686558135866,2021-12-05 19:40:10 UTC
807085,mainnet,255,110160000,110198331,38332,34955,3377,0.08809871647709486,2021-12-05 19:42:39 UTC
807086,mainnet,255,110160000,110198666,38667,35267,3400,0.08793027646313394,2021-12-05 19:45:38 UTC
807088,mainnet,255,110160000,110198905,38906,35500,3406,0.08754433763429806,2021-12-05 19:47:48 UTC
807089,mainnet,255,110160000,110199169,39170,35759,3411,0.08708195047230023,2021-12-05 19:50:15 UTC
807091,mainnet,255,110160000,110199407,39408,35991,3417,0.08670828258221681,2021-12-05 19:52:29 UTC
807092,mainnet,255,110160000,110199668,39669,36238,3431,0.08649071063046712,2021-12-05 19:54:49 UTC
807094,mainnet,255,110160000,110199909,39910,36476,3434,0.08604359809571537,2021-12-05 19:57:07 UTC
807095,mainnet,255,110160000,110200182,40183,36732,3451,0.0858820894408083,2021-12-05 19:59:20 UTC
807097,mainnet,255,110160000,110200416,40417,36933,3484,0.08620135091669347,2021-12-05 20:01:46 UTC
807098,mainnet,255,110160000,110200633,40634,37121,3513,0.08645469311414086,2021-12-05 20:04:10 UTC
807100,mainnet,255,110160000,110200921,40922,37387,3535,0.08638385220663701,2021-12-05 20:06:44 UTC
807101,mainnet,255,110160000,110201153,41154,37610,3544,0.08611556592311805,2021-12-05 20:08:59 UTC
807103,mainnet,255,110160000,110201407,41408,37845,3563,0.08604617465224111,2021-12-05 20:11:19 UTC
807104,mainnet,255,110160000,110201666,41667,38083,3584,0.08601531187750498,2021-12-05 20:13:43 UTC
807106,mainnet,255,110160000,110201892,41893,38284,3609,0.0861480438259375,2021-12-05 20:15:59 UTC
807107,mainnet,255,110160000,110202142,42143,38500,3643,0.0864437747668652,2021-12-05 20:18:28 UTC
807108,mainnet,255,110160000,110202401,42402,38754,3648,0.08603367765671431,2021-12-05 20:20:40 UTC
807109,mainnet,255,110160000,110202606,42607,38949,3658,0.08585443706433216,2021-12-05 20:22:49 UTC
807111,mainnet,255,110160000,110202860,42861,39185,3676,0.0857656144280348,2021-12-05 20:25:15 UTC
807112,mainnet,255,110160000,110203085,43086,39394,3692,0.08568908694239429,2021-12-05 20:27:24 UTC
807114,mainnet,255,110160000,110203314,43315,39609,3706,0.08555927507791758,2021-12-05 20:29:30 UTC
807115,mainnet,255,110160000,110203540,43541,39816,3725,0.08555154911462759,2021-12-05 20:31:39 UTC
807116,mainnet,255,110160000,110203767,43768,40035,3733,0.0852906232864193,2021-12-05 20:33:50 UTC
807118,mainnet,255,110160000,110203999,44000,40242,3758,0.0854090909090909,2021-12-05 20:35:57 UTC
807119,mainnet,255,110160000,110204241,44242,40455,3787,0.08559739613941504,2021-12-05 20:38:14 UTC
807120,mainnet,255,110160000,110204436,44437,40642,3795,0.08540180480230439,2021-12-05 20:40:22 UTC
807121,mainnet,255,110160000,110204656,44657,40851,3806,0.08522739995969277,2021-12-05 20:42:33 UTC
807123,mainnet,255,110160000,110204867,44868,41052,3816,0.0850494784701792,2021-12-05 20:44:52 UTC
807124,mainnet,255,110160000,110205117,45118,41276,3842,0.08515448379804069,2021-12-05 20:47:02 UTC
807126,mainnet,255,110160000,110205352,45353,41503,3850,0.08488964346349745,2021-12-05 20:49:07 UTC
807127,mainnet,255,110160000,110205568,45569,41713,3856,0.0846189295354298,2021-12-05 20:51:12 UTC
807129,mainnet,255,110160000,110205795,45796,41916,3880,0.08472355664250153,2021-12-05 20:53:19 UTC
807130,mainnet,255,110160000,110206041,46042,42144,3898,0.08466183050258459,2021-12-05 20:55:30 UTC
807131,mainnet,255,110160000,110206232,46233,42330,3903,0.08442021932385958,2021-12-05 20:57:39 UTC
807133,mainnet,255,110160000,110206488,46489,42560,3929,0.08451461636085955,2021-12-05 20:59:47 UTC
807134,mainnet,255,110160000,110206745,46746,42770,3976,0.08505540581012279,2021-12-05 21:02:10 UTC
807136,mainnet,255,110160000,110207060,47061,43061,4000,0.0849960689318119,2021-12-05 21:05:08 UTC
807137,mainnet,255,110160000,110207302,47303,43283,4020,0.0849840390672896,2021-12-05 21:07:24 UTC
807139,mainnet,255,110160000,110207531,47532,43493,4039,0.08497433308087184,2021-12-05 21:09:34 UTC
807140,mainnet,255,110160000,110207772,47773,43724,4049,0.08475498712661964,2021-12-05 21:11:52 UTC
807142,mainnet,255,110160000,110208037,48038,43979,4059,0.08449560764394855,2021-12-05 21:14:18 UTC
807143,mainnet,255,110160000,110208253,48254,44182,4072,0.0843867865876404,2021-12-05 21:16:25 UTC
807145,mainnet,255,110160000,110208468,48469,44368,4101,0.08461078214941509,2021-12-05 21:18:35 UTC
807147,mainnet,255,110160000,110208730,48731,44613,4118,0.08450473004863433,2021-12-05 21:20:53 UTC
807148,mainnet,255,110160000,110208968,48969,44846,4123,0.08419612407849864,2021-12-05 21:23:16 UTC
807150,mainnet,255,110160000,110209303,49304,45146,4158,0.084333928281681,2021-12-05 21:26:20 UTC
807151,mainnet,255,110160000,110209553,49554,45384,4170,0.08415062356217459,2021-12-05 21:28:50 UTC
807153,mainnet,255,110160000,110209867,49868,45641,4227,0.08476377636961578,2021-12-05 21:31:19 UTC
807154,mainnet,255,110160000,110210101,50102,45875,4227,0.08436788950540897,2021-12-05 21:33:34 UTC
807156,mainnet,255,110160000,110210342,50343,46089,4254,0.08450032775162386,2021-12-05 21:35:57 UTC
807158,mainnet,255,110160000,110210557,50558,46281,4277,0.0845959096483247,2021-12-05 21:38:12 UTC
807159,mainnet,255,110160000,110210839,50840,46549,4291,0.08440204563335955,2021-12-05 21:40:35 UTC
807161,mainnet,255,110160000,110211088,51089,46791,4298,0.08412769872183835,2021-12-05 21:42:54 UTC
807162,mainnet,255,110160000,110211348,51349,47037,4312,0.0839743714580615,2021-12-05 21:45:20 UTC
807163,mainnet,255,110160000,110211587,51588,47251,4337,0.08406993874544468,2021-12-05 21:47:42 UTC
807164,mainnet,255,110160000,110211825,51826,47480,4346,0.08385752325087793,2021-12-05 21:49:49 UTC
807166,mainnet,255,110160000,110212066,52067,47704,4363,0.0837958783874623,2021-12-05 21:51:58 UTC
807168,mainnet,255,110160000,110212357,52358,47993,4365,0.08336834867642003,2021-12-05 21:54:34 UTC
807169,mainnet,255,110160000,110212601,52602,48216,4386,0.08338086004334436,2021-12-05 21:56:49 UTC
807171,mainnet,255,110160000,110212893,52894,48488,4406,0.08329867281733278,2021-12-05 21:59:19 UTC
807172,mainnet,255,110160000,110213167,53168,48756,4412,0.08298224495937406,2021-12-05 22:01:46 UTC
807174,mainnet,255,110160000,110213384,53385,48971,4414,0.08268240142362086,2021-12-05 22:03:55 UTC
807175,mainnet,255,110160000,110213658,53659,49242,4417,0.08231610726998267,2021-12-05 22:06:04 UTC
807177,mainnet,255,110160000,110213922,53923,49506,4417,0.08191309830684494,2021-12-05 22:08:24 UTC
807178,mainnet,255,110160000,110214204,54205,49762,4443,0.08196660824647173,2021-12-05 22:10:58 UTC
807180,mainnet,255,110160000,110214431,54432,49963,4469,0.08210243974132864,2021-12-05 22:13:00 UTC
807181,mainnet,255,110160000,110214670,54671,50192,4479,0.08192643266082567,2021-12-05 22:15:17 UTC
807183,mainnet,255,110160000,110214896,54897,50390,4507,0.08209920396378673,2021-12-05 22:17:23 UTC
807184,mainnet,255,110160000,110215113,55114,50595,4519,0.08199368581485648,2021-12-05 22:19:31 UTC
807186,mainnet,255,110160000,110215373,55374,50851,4523,0.0816809332899917,2021-12-05 22:21:43 UTC
807187,mainnet,255,110160000,110215588,55589,51057,4532,0.0815269207936822,2021-12-05 22:23:47 UTC
807188,mainnet,255,110160000,110215777,55778,51224,4554,0.08164509304743806,2021-12-05 22:25:53 UTC
807190,mainnet,255,110160000,110216025,56026,51423,4603,0.08215828365401778,2021-12-05 22:27:54 UTC
807191,mainnet,255,110160000,110216286,56287,51677,4610,0.08190168244887808,2021-12-05 22:30:00 UTC
807193,mainnet,255,110160000,110216537,56538,51916,4622,0.08175032721355549,2021-12-05 22:32:06 UTC
807194,mainnet,255,110160000,110216785,56786,52160,4626,0.08146374106293805,2021-12-05 22:34:11 UTC
807196,mainnet,255,110160000,110217028,57029,52393,4636,0.08129197425871049,2021-12-05 22:36:21 UTC
807197,mainnet,255,110160000,110217276,57277,52637,4640,0.08100982942542381,2021-12-05 22:38:32 UTC
807198,mainnet,255,110160000,110217496,57497,52850,4647,0.08082160808390003,2021-12-05 22:40:39 UTC
807200,mainnet,255,110160000,110217782,57783,53099,4684,0.08106190402021356,2021-12-05 22:43:05 UTC
807202,mainnet,255,110160000,110218031,58032,53342,4690,0.0808174800110284,2021-12-05 22:45:21 UTC
807203,mainnet,255,110160000,110218262,58263,53569,4694,0.08056571065684912,2021-12-05 22:47:23 UTC
807205,mainnet,255,110160000,110218574,58575,53876,4699,0.08022193768672642,2021-12-05 22:50:08 UTC
807206,mainnet,255,110160000,110218842,58843,54131,4712,0.08007749434937037,2021-12-05 22:52:17 UTC
807208,mainnet,255,110160000,110219092,59093,54380,4713,0.07975563941583605,2021-12-05 22:54:34 UTC
807209,mainnet,255,110160000,110219368,59369,54649,4720,0.07950277080631306,2021-12-05 22:56:55 UTC
807211,mainnet,255,110160000,110219634,59635,54908,4727,0.07926553198624968,2021-12-05 22:59:18 UTC
807212,mainnet,255,110160000,110219872,59873,55126,4747,0.07928448549429626,2021-12-05 23:01:35 UTC
807214,mainnet,255,110160000,110220136,60137,55379,4758,0.0791193441641585,2021-12-05 23:04:04 UTC
807216,mainnet,255,110160000,110220400,60401,55629,4772,0.07900531448154832,2021-12-05 23:06:32 UTC
807217,mainnet,255,110160000,110220613,60614,55809,4805,0.07927211535288878,2021-12-05 23:08:52 UTC
807219,mainnet,255,110160000,110220848,60849,56016,4833,0.07942612039639106,2021-12-05 23:11:08 UTC
807220,mainnet,255,110160000,110221078,61079,56204,4875,0.07981466625190327,2021-12-05 23:13:33 UTC
807222,mainnet,255,110160000,110221327,61328,56419,4909,0.08004500391338377,2021-12-05 23:16:05 UTC
807223,mainnet,255,110160000,110221581,61582,56660,4922,0.07992595238868501,2021-12-05 23:18:41 UTC
807225,mainnet,255,110160000,110221847,61848,56916,4932,0.07974388824214203,2021-12-05 23:20:50 UTC
807226,mainnet,255,110160000,110222028,62029,57093,4936,0.07957568234213029,2021-12-05 23:22:59 UTC
807228,mainnet,255,110160000,110222312,62313,57347,4966,0.07969444578177909,2021-12-05 23:25:12 UTC
807229,mainnet,255,110160000,110222518,62519,57547,4972,0.07952782354164334,2021-12-05 23:27:18 UTC
807231,mainnet,255,110160000,110222733,62734,57751,4983,0.07943061178946026,2021-12-05 23:29:22 UTC
807232,mainnet,255,110160000,110222963,62964,57966,4998,0.07937869258623975,2021-12-05 23:31:33 UTC
807234,mainnet,255,110160000,110223209,63210,58191,5019,0.07940199335548173,2021-12-05 23:33:44 UTC
807235,mainnet,255,110160000,110223439,63440,58417,5023,0.07917717528373266,2021-12-05 23:35:52 UTC
807237,mainnet,255,110160000,110223676,63677,58639,5038,0.07911804890305763,2021-12-05 23:38:03 UTC
807238,mainnet,255,110160000,110223890,63891,58836,5055,0.07911912475935577,2021-12-05 23:40:07 UTC
807239,mainnet,255,110160000,110224109,64110,59032,5078,0.07920761191701763,2021-12-05 23:42:10 UTC
807240,mainnet,255,110160000,110224344,64345,59232,5113,0.0794622736809387,2021-12-05 23:44:24 UTC
807241,mainnet,255,110160000,110224589,64590,59448,5142,0.0796098467254993,2021-12-05 23:46:35 UTC
807243,mainnet,255,110160000,110224874,64875,59723,5152,0.07941425818882467,2021-12-05 23:49:01 UTC
807244,mainnet,255,110160000,110225112,65113,59945,5168,0.07936971111759557,2021-12-05 23:51:18 UTC
807246,mainnet,255,110160000,110225348,65349,60170,5179,0.07925140400006121,2021-12-05 23:53:33 UTC
807247,mainnet,255,110160000,110225596,65597,60414,5183,0.0790127597298657,2021-12-05 23:55:47 UTC
807249,mainnet,255,110160000,110225841,65842,60643,5199,0.07896175693326449,2021-12-05 23:58:05 UTC
807250,mainnet,255,110160000,110226129,66130,60915,5215,0.07885982156358687,2021-12-06 00:00:27 UTC
807251,mainnet,255,110160000,110226384,66385,61157,5228,0.07875273028545605,2021-12-06 00:02:45 UTC
807252,mainnet,255,110160000,110226632,66633,61388,5245,0.07871475094922936,2021-12-06 00:04:55 UTC
807254,mainnet,255,110160000,110226892,66893,61638,5255,0.0785582945898674,2021-12-06 00:07:15 UTC
807255,mainnet,255,110160000,110227118,67119,61854,5265,0.07844276583381755,2021-12-06 00:09:20 UTC
807257,mainnet,255,110160000,110227361,67362,62086,5276,0.07832309016953179,2021-12-06 00:11:36 UTC
807258,mainnet,255,110160000,110227575,67576,62276,5300,0.07843021190955368,2021-12-06 00:13:46 UTC
807259,mainnet,255,110160000,110227806,67807,62501,5306,0.07825150795640567,2021-12-06 00:16:04 UTC
807261,mainnet,255,110160000,110228040,68041,62722,5319,0.07817345424082539,2021-12-06 00:18:13 UTC
807262,mainnet,255,110160000,110228230,68231,62887,5344,0.07832217027450865,2021-12-06 00:20:19 UTC
807264,mainnet,255,110160000,110228405,68406,63034,5372,0.07853112300090635,2021-12-06 00:22:26 UTC
807265,mainnet,255,110160000,110228636,68637,63246,5391,0.07854364264172385,2021-12-06 00:24:41 UTC
807266,mainnet,255,110160000,110228880,68881,63481,5400,0.07839607438916392,2021-12-06 00:27:01 UTC
807268,mainnet,255,110160000,110229137,69138,63717,5421,0.0784084005901241,2021-12-06 00:29:21 UTC
807270,mainnet,255,110160000,110229374,69375,63929,5446,0.0785009009009009,2021-12-06 00:31:28 UTC
807271,mainnet,255,110160000,110229609,69610,64155,5455,0.07836517741703779,2021-12-06 00:33:42 UTC
807273,mainnet,255,110160000,110229864,69865,64393,5472,0.07832247906677163,2021-12-06 00:36:12 UTC
807274,mainnet,255,110160000,110230125,70126,64610,5516,0.07865841485326412,2021-12-06 00:38:33 UTC
807276,mainnet,255,110160000,110230373,70374,64849,5525,0.07850910847756273,2021-12-06 00:40:53 UTC
807277,mainnet,255,110160000,110230607,70608,65075,5533,0.07836222524359845,2021-12-06 00:42:58 UTC
807279,mainnet,255,110160000,110230860,70861,65307,5554,0.07837879792833857,2021-12-06 00:45:22 UTC
807280,mainnet,255,110160000,110231126,71127,65557,5570,0.07831062746917486,2021-12-06 00:47:37 UTC
807282,mainnet,255,110160000,110231373,71374,65791,5583,0.07822176142572926,2021-12-06 00:49:47 UTC
807283,mainnet,255,110160000,110231597,71598,66005,5593,0.07811670717059135,2021-12-06 00:51:58 UTC
807285,mainnet,255,110160000,110231848,71849,66240,5609,0.07806650057760024,2021-12-06 00:54:09 UTC
807286,mainnet,255,110160000,110232064,72065,66438,5627,0.07808228682439465,2021-12-06 00:56:16 UTC
807287,mainnet,255,110160000,110232286,72287,66643,5644,0.07807766265026907,2021-12-06 00:58:26 UTC
807288,mainnet,255,110160000,110232559,72560,66890,5670,0.07814222712238147,2021-12-06 01:00:42 UTC
807290,mainnet,255,110160000,110232843,72844,67150,5694,0.0781670418977541,2021-12-06 01:03:22 UTC
807291,mainnet,255,110160000,110233100,73101,67399,5702,0.07800166892381773,2021-12-06 01:05:45 UTC
807293,mainnet,255,110160000,110233337,73338,67622,5716,0.07794049469579209,2021-12-06 01:07:54 UTC
807294,mainnet,255,110160000,110233632,73633,67903,5730,0.07781836948107507,2021-12-06 01:10:22 UTC
807296,mainnet,255,110160000,110233893,73894,68151,5743,0.07771943594879151,2021-12-06 01:12:46 UTC
807297,mainnet,255,110160000,110234146,74147,68382,5765,0.07775095418560428,2021-12-06 01:15:03 UTC
807299,mainnet,255,110160000,110234418,74419,68643,5776,0.077614587672503,2021-12-06 01:17:23 UTC
807300,mainnet,255,110160000,110234669,74670,68882,5788,0.0775143966787197,2021-12-06 01:19:33 UTC
807301,mainnet,255,110160000,110234936,74937,69142,5795,0.07733162523186143,2021-12-06 01:21:50 UTC
807303,mainnet,255,110160000,110235214,75215,69420,5795,0.07704580203416872,2021-12-06 01:24:14 UTC
807304,mainnet,255,110160000,110235452,75453,69656,5797,0.07682928445522379,2021-12-06 01:26:31 UTC
807305,mainnet,255,110160000,110235711,75712,69893,5819,0.07685703719357566,2021-12-06 01:28:54 UTC
807307,mainnet,255,110160000,110235965,75966,70143,5823,0.07665271305584077,2021-12-06 01:31:10 UTC
807309,mainnet,255,110160000,110236199,76200,70374,5826,0.07645669291338583,2021-12-06 01:33:30 UTC
807310,mainnet,255,110160000,110236448,76449,70612,5837,0.07635155463119203,2021-12-06 01:35:38 UTC
807311,mainnet,255,110160000,110236707,76708,70848,5860,0.07639359649580227,2021-12-06 01:37:59 UTC
807313,mainnet,255,110160000,110236950,76951,71072,5879,0.07639926706605502,2021-12-06 01:40:19 UTC
807314,mainnet,255,110160000,110237167,77168,71273,5895,0.07639176860874974,2021-12-06 01:42:23 UTC
807316,mainnet,255,110160000,110237413,77414,71516,5898,0.07618776965406773,2021-12-06 01:44:41 UTC
807317,mainnet,255,110160000,110237671,77672,71757,5915,0.07615356885364095,2021-12-06 01:46:53 UTC
807319,mainnet,255,110160000,110237938,77939,71989,5950,0.07634175444899216,2021-12-06 01:49:22 UTC
807321,mainnet,255,110160000,110238211,78212,72259,5953,0.0761136398506623,2021-12-06 01:51:44 UTC
807322,mainnet,255,110160000,110238480,78481,72519,5962,0.07596743160765027,2021-12-06 01:54:00 UTC
807324,mainnet,255,110160000,110238712,78713,72742,5971,0.07585786337707875,2021-12-06 01:56:11 UTC
807325,mainnet,255,110160000,110238958,78959,72966,5993,0.07590015071112856,2021-12-06 01:58:31 UTC
807326,mainnet,255,110160000,110239200,79201,73200,6001,0.07576924533781139,2021-12-06 02:00:43 UTC
807327,mainnet,255,110160000,110239473,79474,73457,6017,0.07571029519088003,2021-12-06 02:03:11 UTC
807329,mainnet,255,110160000,110239726,79727,73708,6019,0.07549512712130144,2021-12-06 02:05:20 UTC
807330,mainnet,255,110160000,110239985,79986,73967,6019,0.07525066886705173,2021-12-06 02:07:34 UTC
807332,mainnet,255,110160000,110240250,80251,74227,6024,0.0750644851777548,2021-12-06 02:09:47 UTC
807333,mainnet,255,110160000,110240497,80498,74467,6031,0.07492111605257273,2021-12-06 02:11:57 UTC
807335,mainnet,255,110160000,110240770,80771,74738,6033,0.07469264958958041,2021-12-06 02:14:21 UTC
807336,mainnet,255,110160000,110241055,81056,75014,6042,0.07454105803395183,2021-12-06 02:16:51 UTC
807338,mainnet,255,110160000,110241313,81314,75260,6054,0.07445212386550902,2021-12-06 02:19:33 UTC
807339,mainnet,255,110160000,110241582,81583,75510,6073,0.0744395278428104,2021-12-06 02:21:46 UTC
807341,mainnet,255,110160000,110241842,81843,75759,6084,0.0743374509732048,2021-12-06 02:23:50 UTC
807343,mainnet,255,110160000,110242126,82127,76035,6092,0.0741777978009668,2021-12-06 02:26:18 UTC
807344,mainnet,255,110160000,110242393,82394,76287,6107,0.07411947471903294,2021-12-06 02:28:35 UTC
807346,mainnet,255,110160000,110242661,82662,76547,6115,0.07397595025525634,2021-12-06 02:30:49 UTC
807347,mainnet,255,110160000,110242899,82900,76776,6124,0.07387213510253317,2021-12-06 02:33:14 UTC
807349,mainnet,255,110160000,110243190,83191,77047,6144,0.07385414287603226,2021-12-06 02:35:20 UTC
807350,mainnet,255,110160000,110243438,83439,77290,6149,0.07369455530387468,2021-12-06 02:37:24 UTC
807352,mainnet,255,110160000,110243728,83729,77576,6153,0.07348708332835696,2021-12-06 02:39:54 UTC
807353,mainnet,255,110160000,110244002,84003,77835,6168,0.07342594907324738,2021-12-06 02:42:11 UTC
807355,mainnet,255,110160000,110244228,84229,78051,6178,0.0733476593572285,2021-12-06 02:44:14 UTC
807356,mainnet,255,110160000,110244456,84457,78254,6203,0.07344565873758244,2021-12-06 02:46:20 UTC
807358,mainnet,255,110160000,110244742,84743,78528,6215,0.07333939086414216,2021-12-06 02:48:45 UTC
807359,mainnet,255,110160000,110245000,85001,78780,6221,0.0731873742661851,2021-12-06 02:51:02 UTC
807361,mainnet,255,110160000,110245261,85262,79036,6226,0.07302197931083014,2021-12-06 02:53:38 UTC
807363,mainnet,255,110160000,110245570,85571,79330,6241,0.072933587313459,2021-12-06 02:55:47 UTC
807364,mainnet,255,110160000,110245824,85825,79573,6252,0.07284590736964754,2021-12-06 02:58:05 UTC
807366,mainnet,255,110160000,110246088,86089,79823,6266,0.07278514095877522,2021-12-06 03:00:21 UTC
807367,mainnet,255,110160000,110246345,86346,80078,6268,0.07259166608760105,2021-12-06 03:02:43 UTC
807369,mainnet,255,110160000,110246620,86621,80340,6281,0.07251128479237136,2021-12-06 03:04:58 UTC
807370,mainnet,255,110160000,110246867,86868,80578,6290,0.07240871206888613,2021-12-06 03:07:06 UTC
807372,mainnet,255,110160000,110247139,87140,80832,6308,0.0723892586642185,2021-12-06 03:09:21 UTC
807373,mainnet,255,110160000,110247408,87409,81098,6311,0.07220080312096008,2021-12-06 03:11:44 UTC
807375,mainnet,255,110160000,110247676,87677,81353,6324,0.07212838030498306,2021-12-06 03:14:09 UTC
807376,mainnet,255,110160000,110247938,87939,81614,6325,0.0719248570031499,2021-12-06 03:16:33 UTC
807378,mainnet,255,110160000,110248205,88206,81869,6337,0.07184318527084325,2021-12-06 03:18:51 UTC
807380,mainnet,255,110160000,110248490,88491,82145,6346,0.07171350758834232,2021-12-06 03:21:20 UTC
807381,mainnet,255,110160000,110248757,88758,82385,6373,0.07180197841321345,2021-12-06 03:23:58 UTC
807383,mainnet,255,110160000,110248989,88990,82615,6375,0.07163726261377683,2021-12-06 03:26:10 UTC
807384,mainnet,255,110160000,110249240,89241,82849,6392,0.07162627043623447,2021-12-06 03:28:22 UTC
807386,mainnet,255,110160000,110249519,89520,83112,6408,0.07158176943699732,2021-12-06 03:30:40 UTC
807387,mainnet,255,110160000,110249775,89776,83358,6418,0.07148903938691856,2021-12-06 03:32:56 UTC
807389,mainnet,255,110160000,110250044,90045,83623,6422,0.07131989560775168,2021-12-06 03:35:12 UTC
807390,mainnet,255,110160000,110250314,90315,83875,6440,0.07130598460942257,2021-12-06 03:37:33 UTC
807392,mainnet,255,110160000,110250557,90558,84112,6446,0.07118090063826497,2021-12-06 03:39:41 UTC
807393,mainnet,255,110160000,110250837,90838,84382,6456,0.07107157797397565,2021-12-06 03:42:08 UTC
807395,mainnet,255,110160000,110251104,91105,84639,6466,0.07097305307063279,2021-12-06 03:44:21 UTC
807396,mainnet,255,110160000,110251319,91320,84838,6482,0.07098116513359615,2021-12-06 03:46:27 UTC
807398,mainnet,255,110160000,110251544,91545,85035,6510,0.07111256758970998,2021-12-06 03:48:35 UTC
807400,mainnet,255,110160000,110251861,91862,85335,6527,0.07105223051969259,2021-12-06 03:51:15 UTC
807401,mainnet,255,110160000,110252108,92109,85573,6536,0.07095940678978167,2021-12-06 03:53:24 UTC
807403,mainnet,255,110160000,110252368,92369,85826,6543,0.0708354534529983,2021-12-06 03:55:40 UTC
807404,mainnet,255,110160000,110252625,92626,86071,6555,0.07076846673720122,2021-12-06 03:57:46 UTC
807406,mainnet,255,110160000,110252953,92954,86389,6565,0.07062633130365557,2021-12-06 04:00:29 UTC
807407,mainnet,255,110160000,110253198,93199,86620,6579,0.07059088616830653,2021-12-06 04:02:48 UTC
807409,mainnet,255,110160000,110253549,93550,86963,6587,0.07041154462854089,2021-12-06 04:05:34 UTC
807411,mainnet,255,110160000,110253800,93801,87198,6603,0.07039370582403173,2021-12-06 04:07:38 UTC
807412,mainnet,255,110160000,110254065,94066,87453,6613,0.07030170305955392,2021-12-06 04:09:53 UTC
807414,mainnet,255,110160000,110254341,94342,87724,6618,0.07014903224438744,2021-12-06 04:12:15 UTC
807415,mainnet,255,110160000,110254660,94661,88035,6626,0.06999714771658867,2021-12-06 04:14:52 UTC
807417,mainnet,255,110160000,110254908,94909,88277,6632,0.06987746156844978,2021-12-06 04:17:22 UTC
807418,mainnet,255,110160000,110255228,95229,88593,6636,0.06968465488454148,2021-12-06 04:19:43 UTC
807420,mainnet,255,110160000,110255488,95489,88849,6640,0.06953680528647278,2021-12-06 04:21:55 UTC
807421,mainnet,255,110160000,110255788,95789,89144,6645,0.06937122216538433,2021-12-06 04:24:36 UTC
807423,mainnet,255,110160000,110256045,96046,89391,6655,0.06928971534473065,2021-12-06 04:26:45 UTC
807425,mainnet,255,110160000,110256313,96314,89652,6662,0.06916959112901551,2021-12-06 04:28:53 UTC
807426,mainnet,255,110160000,110256550,96551,89870,6681,0.06919659040299946,2021-12-06 04:30:58 UTC
807428,mainnet,255,110160000,110256813,96814,90121,6693,0.06913256347222509,2021-12-06 04:33:06 UTC
807429,mainnet,255,110160000,110257151,97152,90458,6694,0.06890233860342555,2021-12-06 04:36:06 UTC
807431,mainnet,255,110160000,110257425,97426,90707,6719,0.06896516330343029,2021-12-06 04:38:16 UTC
807432,mainnet,255,110160000,110257700,97701,90981,6720,0.06878128166548961,2021-12-06 04:40:32 UTC
807434,mainnet,255,110160000,110257976,97977,91247,6730,0.06868959041407677,2021-12-06 04:42:52 UTC
807435,mainnet,255,110160000,110258268,98269,91531,6738,0.06856689291638259,2021-12-06 04:45:19 UTC
807437,mainnet,255,110160000,110258465,98466,91714,6752,0.06857189283610586,2021-12-06 04:47:32 UTC
807438,mainnet,255,110160000,110258775,98776,91988,6788,0.06872114683728842,2021-12-06 04:49:45 UTC
807440,mainnet,255,110160000,110259022,99023,92221,6802,0.06869111216586046,2021-12-06 04:51:54 UTC
807441,mainnet,255,110160000,110259260,99261,92450,6811,0.06861708022284684,2021-12-06 04:53:59 UTC
807443,mainnet,255,110160000,110259550,99551,92726,6825,0.06855782463260038,2021-12-06 04:56:20 UTC
807444,mainnet,255,110160000,110259768,99769,92930,6839,0.06854834668083272,2021-12-06 04:58:25 UTC
807446,mainnet,255,110160000,110260508,100509,93650,6859,0.0682426449372693,2021-12-06 05:04:42 UTC
807448,mainnet,255,110160000,110260734,100735,93868,6867,0.06816895815754206,2021-12-06 05:06:36 UTC
807449,mainnet,255,110160000,110260988,100989,94108,6881,0.06813613363831704,2021-12-06 05:08:52 UTC
807451,mainnet,255,110160000,110261244,101245,94353,6892,0.06807249740727937,2021-12-06 05:10:51 UTC
807452,mainnet,255,110160000,110261522,101523,94623,6900,0.06796489465441329,2021-12-06 05:13:03 UTC
807454,mainnet,255,110160000,110261769,101770,94868,6902,0.06781959320035374,2021-12-06 05:15:18 UTC
807455,mainnet,255,110160000,110261999,102000,95081,6919,0.06783333333333333,2021-12-06 05:17:19 UTC
807457,mainnet,255,110160000,110262221,102222,95297,6925,0.06774471248850542,2021-12-06 05:19:13 UTC
807458,mainnet,255,110160000,110262481,102482,95535,6947,0.06778751390488086,2021-12-06 05:21:06 UTC
807460,mainnet,255,110160000,110262702,102703,95752,6951,0.06768059355617655,2021-12-06 05:22:55 UTC
807461,mainnet,255,110160000,110262934,102935,95982,6953,0.06754748142031379,2021-12-06 05:25:09 UTC
807462,mainnet,255,110160000,110263246,103247,96285,6962,0.06743053066917198,2021-12-06 05:27:25 UTC
807464,mainnet,255,110160000,110263448,103449,96468,6981,0.06748252762230664,2021-12-06 05:29:37 UTC
807465,mainnet,255,110160000,110263683,103684,96659,7025,0.06775394467806026,2021-12-06 05:31:31 UTC
807467,mainnet,255,110160000,110263940,103941,96852,7089,0.0682021531445724,2021-12-06 05:33:36 UTC
807468,mainnet,255,110160000,110264214,104215,97093,7122,0.06833949047641893,2021-12-06 05:35:42 UTC
807469,mainnet,255,110160000,110264474,104475,97345,7130,0.06824599186408231,2021-12-06 05:37:57 UTC
807470,mainnet,255,110160000,110264698,104699,97539,7160,0.0683865175407597,2021-12-06 05:39:57 UTC
807472,mainnet,255,110160000,110265012,105013,97842,7171,0.06828678354108539,2021-12-06 05:42:43 UTC
807474,mainnet,255,110160000,110265229,105230,98050,7180,0.06823149292026988,2021-12-06 05:44:32 UTC
807475,mainnet,255,110160000,110265467,105468,98280,7188,0.06815337353510069,2021-12-06 05:46:43 UTC
807477,mainnet,255,110160000,110265696,105697,98502,7195,0.06807194149313604,2021-12-06 05:48:48 UTC
807478,mainnet,255,110160000,110265917,105918,98719,7199,0.06796767310561,2021-12-06 05:50:44 UTC
807480,mainnet,255,110160000,110266148,106149,98945,7204,0.06786686638592922,2021-12-06 05:52:45 UTC
807481,mainnet,255,110160000,110266394,106395,99188,7207,0.06773814558954838,2021-12-06 05:54:47 UTC
807483,mainnet,255,110160000,110266641,106642,99434,7208,0.06759063033326457,2021-12-06 05:56:53 UTC
807484,mainnet,255,110160000,110266865,106866,99658,7208,0.06744895476578144,2021-12-06 05:58:56 UTC
807486,mainnet,255,110160000,110267102,107103,99880,7223,0.06743975425524962,2021-12-06 06:01:01 UTC
807487,mainnet,255,110160000,110267359,107360,100133,7227,0.0673155737704918,2021-12-06 06:03:13 UTC
807489,mainnet,255,110160000,110267575,107576,100344,7232,0.06722689075630252,2021-12-06 06:05:12 UTC
807490,mainnet,255,110160000,110267815,107816,100564,7252,0.06726274393410997,2021-12-06 06:07:19 UTC
807492,mainnet,255,110160000,110268067,108068,100812,7256,0.06714291001961728,2021-12-06 06:09:27 UTC
807493,mainnet,255,110160000,110268292,108293,101021,7272,0.06715115473761,2021-12-06 06:11:22 UTC
807494,mainnet,255,110160000,110268552,108553,101267,7286,0.06711928735272171,2021-12-06 06:13:35 UTC
807496,mainnet,255,110160000,110268804,108805,101510,7295,0.06704655116952346,2021-12-06 06:15:36 UTC
807497,mainnet,255,110160000,110269004,109005,101703,7302,0.0669877528553736,2021-12-06 06:17:31 UTC
807499,mainnet,255,110160000,110269268,109269,101954,7315,0.06694487915145192,2021-12-06 06:19:51 UTC
807500,mainnet,255,110160000,110269518,109519,102196,7323,0.06686511016353326,2021-12-06 06:21:50 UTC
807502,mainnet,255,110160000,110269793,109794,102455,7339,0.06684336120370876,2021-12-06 06:24:06 UTC
807503,mainnet,255,110160000,110270009,110010,102663,7347,0.06678483774202346,2021-12-06 06:26:01 UTC
807505,mainnet,255,110160000,110270220,110221,102860,7361,0.0667840066774934,2021-12-06 06:27:50 UTC
807506,mainnet,255,110160000,110270464,110465,103095,7370,0.06671796496627891,2021-12-06 06:29:53 UTC
807508,mainnet,255,110160000,110270685,110686,103307,7379,0.06666606436224996,2021-12-06 06:31:47 UTC
807509,mainnet,255,110160000,110270952,110953,103569,7384,0.06655070164844573,2021-12-06 06:33:58 UTC
807511,mainnet,255,110160000,110271218,111219,103814,7405,0.06658035047968423,2021-12-06 06:36:23 UTC
807512,mainnet,255,110160000,110271461,111462,104025,7437,0.06672229100500619,2021-12-06 06:38:18 UTC
807514,mainnet,255,110160000,110271709,111710,104272,7438,0.06658311699937337,2021-12-06 06:40:25 UTC
807515,mainnet,255,110160000,110272003,112004,104555,7449,0.06650655333738081,2021-12-06 06:42:49 UTC
807517,mainnet,255,110160000,110272205,112206,104739,7467,0.06654724346291642,2021-12-06 06:44:48 UTC
807518,mainnet,255,110160000,110272471,112472,104956,7516,0.06682552101856462,2021-12-06 06:47:07 UTC
807520,mainnet,255,110160000,110272682,112683,105167,7516,0.06670038958849162,2021-12-06 06:49:20 UTC
807521,mainnet,255,110160000,110272937,112938,105394,7544,0.06679771201898387,2021-12-06 06:51:39 UTC
807523,mainnet,255,110160000,110273174,113175,105617,7558,0.06678153302407776,2021-12-06 06:53:41 UTC
807524,mainnet,255,110160000,110273362,113363,105794,7569,0.06676781665975672,2021-12-06 06:55:34 UTC
807526,mainnet,255,110160000,110273591,113592,106013,7579,0.06672124797520952,2021-12-06 06:57:33 UTC
807527,mainnet,255,110160000,110273825,113826,106240,7586,0.0666455818530037,2021-12-06 06:59:32 UTC
807529,mainnet,255,110160000,110274041,114042,106449,7593,0.06658073341400536,2021-12-06 07:01:33 UTC
807530,mainnet,255,110160000,110274262,114263,106660,7603,0.06653947472060072,2021-12-06 07:03:32 UTC
807532,mainnet,255,110160000,110274480,114481,106867,7614,0.06650885299744062,2021-12-06 07:05:29 UTC
807533,mainnet,255,110160000,110274709,114710,107090,7620,0.06642838462209048,2021-12-06 07:07:27 UTC
807535,mainnet,255,110160000,110274776,114777,107157,7620,0.06638960767401135,2021-12-06 07:09:28 UTC
807536,mainnet,255,110160000,110275163,115164,107535,7629,0.06624465978951756,2021-12-06 07:11:26 UTC
807537,mainnet,255,110160000,110275425,115426,107788,7638,0.0661722662138513,2021-12-06 07:13:43 UTC
807539,mainnet,255,110160000,110275648,115649,108006,7643,0.06608790391616011,2021-12-06 07:15:38 UTC
807540,mainnet,255,110160000,110275888,115889,108237,7652,0.06602869987660606,2021-12-06 07:17:44 UTC
807542,mainnet,255,110160000,110276127,116128,108469,7659,0.06595308624965555,2021-12-06 07:19:52 UTC
807543,mainnet,255,110160000,110276371,116372,108709,7663,0.06584917334066615,2021-12-06 07:22:13 UTC
807545,mainnet,255,110160000,110276636,116637,108954,7683,0.06587103577766917,2021-12-06 07:24:14 UTC
807546,mainnet,255,110160000,110276905,116906,109209,7697,0.06583922125468325,2021-12-06 07:26:36 UTC
807548,mainnet,255,110160000,110277094,117095,109382,7713,0.06586959306545967,2021-12-06 07:28:30 UTC
807549,mainnet,255,110160000,110277330,117331,109578,7753,0.06607801859696073,2021-12-06 07:30:52 UTC
807551,mainnet,255,110160000,110277564,117565,109799,7766,0.06605707480967975,2021-12-06 07:32:57 UTC
807552,mainnet,255,110160000,110277801,117802,110028,7774,0.06599208841955145,2021-12-06 07:35:23 UTC
807554,mainnet,255,110160000,110278080,118081,110301,7780,0.06588697588943183,2021-12-06 07:37:38 UTC
807555,mainnet,255,110160000,110278311,118312,110527,7785,0.06580059503685172,2021-12-06 07:39:40 UTC
807557,mainnet,255,110160000,110278584,118585,110794,7791,0.06569970906944386,2021-12-06 07:42:01 UTC
807559,mainnet,255,110160000,110278881,118882,111075,7807,0.06567016032704699,2021-12-06 07:44:41 UTC
807560,mainnet,255,110160000,110279130,119131,111305,7826,0.06569238905070889,2021-12-06 07:47:04 UTC
807562,mainnet,255,110160000,110279372,119373,111544,7829,0.06558434486860514,2021-12-06 07:49:09 UTC
807563,mainnet,255,110160000,110279588,119589,111757,7832,0.06549097325004809,2021-12-06 07:51:09 UTC
807565,mainnet,255,110160000,110279812,119813,111973,7840,0.06543530334771686,2021-12-06 07:53:10 UTC
807566,mainnet,255,110160000,110280026,120027,112166,7861,0.0654935972739467,2021-12-06 07:55:11 UTC
807568,mainnet,255,110160000,110280289,120290,112415,7875,0.06546678859423061,2021-12-06 07:57:22 UTC
807569,mainnet,255,110160000,110280557,120558,112674,7884,0.06539590902304285,2021-12-06 07:59:35 UTC
807571,mainnet,255,110160000,110280754,120755,112864,7891,0.06534719059252204,2021-12-06 08:01:48 UTC
807572,mainnet,255,110160000,110281043,121044,113100,7944,0.06562902746108853,2021-12-06 08:04:29 UTC
807574,mainnet,255,110160000,110281218,121219,113263,7956,0.06563327531162606,2021-12-06 08:06:28 UTC
807575,mainnet,255,110160000,110281414,121415,113432,7983,0.06574970143721945,2021-12-06 08:08:31 UTC
807576,mainnet,255,110160000,110281619,121620,113616,8004,0.06581154415392206,2021-12-06 08:10:40 UTC
807578,mainnet,255,110160000,110281823,121824,113811,8013,0.06577521670606777,2021-12-06 08:12:42 UTC
807579,mainnet,255,110160000,110282040,122041,114006,8035,0.06583852967445367,2021-12-06 08:14:45 UTC
807580,mainnet,255,110160000,110282265,122266,114224,8042,0.06577462254428869,2021-12-06 08:16:50 UTC
807582,mainnet,255,110160000,110282476,122477,114428,8049,0.06571846142541049,2021-12-06 08:18:48 UTC
807583,mainnet,255,110160000,110282713,122714,114655,8059,0.06567302834232443,2021-12-06 08:20:55 UTC
807585,mainnet,255,110160000,110282953,122954,114873,8081,0.06572376661190364,2021-12-06 08:22:53 UTC
807586,mainnet,255,110160000,110283125,123126,115042,8084,0.0656563195425824,2021-12-06 08:24:55 UTC
807588,mainnet,255,110160000,110283340,123341,115235,8106,0.06572023901216952,2021-12-06 08:26:54 UTC
807589,mainnet,255,110160000,110283554,123555,115423,8132,0.06581684270163085,2021-12-06 08:28:58 UTC
807591,mainnet,255,110160000,110283778,123779,115633,8146,0.06581084028793252,2021-12-06 08:30:56 UTC
807592,mainnet,255,110160000,110284000,124001,115843,8158,0.06578979201780631,2021-12-06 08:32:55 UTC
807594,mainnet,255,110160000,110284216,124217,116049,8168,0.06575589492581531,2021-12-06 08:34:54 UTC
807595,mainnet,255,110160000,110284420,124421,116245,8176,0.06571237974296944,2021-12-06 08:36:53 UTC
807597,mainnet,255,110160000,110284628,124629,116419,8210,0.06587551853902382,2021-12-06 08:38:52 UTC
807598,mainnet,255,110160000,110284794,124795,116582,8213,0.06581193156777114,2021-12-06 08:40:55 UTC
807600,mainnet,255,110160000,110285083,125084,116866,8218,0.06569984970100093,2021-12-06 08:42:52 UTC
807601,mainnet,255,110160000,110285286,125287,117044,8243,0.06579293941111208,2021-12-06 08:44:55 UTC
807603,mainnet,255,110160000,110285507,125508,117255,8253,0.06575676450903528,2021-12-06 08:46:49 UTC
807604,mainnet,255,110160000,110285718,125719,117456,8263,0.0657259443679953,2021-12-06 08:48:44 UTC
807606,mainnet,255,110160000,110285923,125924,117655,8269,0.06566659254788602,2021-12-06 08:50:42 UTC
807607,mainnet,255,110160000,110286169,126170,117896,8274,0.06557818815883332,2021-12-06 08:52:42 UTC
807609,mainnet,255,110160000,110286384,126385,118103,8282,0.06552992839340112,2021-12-06 08:54:37 UTC
807610,mainnet,255,110160000,110286602,126603,118310,8293,0.06550397699896526,2021-12-06 08:56:46 UTC
807612,mainnet,255,110160000,110286841,126842,118530,8312,0.06553034483846044,2021-12-06 08:58:50 UTC
807613,mainnet,255,110160000,110287068,127069,118757,8312,0.06541327939938144,2021-12-06 09:00:54 UTC
807615,mainnet,255,110160000,110287299,127300,118978,8322,0.06537313432835822,2021-12-06 09:03:01 UTC
807616,mainnet,255,110160000,110287515,127516,119185,8331,0.06533297782239092,2021-12-06 09:04:56 UTC
807617,mainnet,255,110160000,110287761,127762,119425,8337,0.06525414442478984,2021-12-06 09:07:01 UTC
807619,mainnet,255,110160000,110287996,127997,119653,8344,0.06518902786784066,2021-12-06 09:09:12 UTC
807621,mainnet,255,110160000,110288180,128181,119812,8369,0.06529048766977945,2021-12-06 09:11:27 UTC
807622,mainnet,255,110160000,110288392,128393,119996,8397,0.06540076172376999,2021-12-06 09:13:24 UTC
807623,mainnet,255,110160000,110288578,128579,120166,8413,0.06543059130962288,2021-12-06 09:15:22 UTC
807625,mainnet,255,110160000,110288721,128722,120300,8422,0.06542782119606594,2021-12-06 09:17:34 UTC
807627,mainnet,255,110160000,110289008,129009,120544,8465,0.06561557720779171,2021-12-06 09:19:39 UTC
807628,mainnet,255,110160000,110289291,129292,120781,8511,0.06582773876187235,2021-12-06 09:22:12 UTC
807630,mainnet,255,110160000,110289572,129573,121055,8518,0.06573900426786444,2021-12-06 09:24:25 UTC
807631,mainnet,255,110160000,110289783,129784,121256,8528,0.0657091783270665,2021-12-06 09:26:21 UTC
807633,mainnet,255,110160000,110289972,129973,121422,8551,0.06579058727581882,2021-12-06 09:28:15 UTC
807634,mainnet,255,110160000,110290201,130202,121644,8558,0.06572863704090567,2021-12-06 09:30:17 UTC
807635,mainnet,255,110160000,110290441,130442,121872,8570,0.06569969795004676,2021-12-06 09:32:23 UTC
807636,mainnet,255,110160000,110290638,130639,122067,8572,0.06561593398602256,2021-12-06 09:34:34 UTC
807638,mainnet,255,110160000,110290882,130883,122239,8644,0.0660437184355493,2021-12-06 09:36:57 UTC
807639,mainnet,255,110160000,110291099,131100,122410,8690,0.06628527841342487,2021-12-06 09:39:13 UTC
807641,mainnet,255,110160000,110291308,131309,122591,8718,0.06639301190322065,2021-12-06 09:41:35 UTC
807642,mainnet,255,110160000,110291502,131503,122767,8736,0.066431944518376,2021-12-06 09:43:34 UTC
807644,mainnet,255,110160000,110291690,131691,122920,8771,0.06660288098655186,2021-12-06 09:45:35 UTC
807645,mainnet,255,110160000,110291871,131872,123077,8795,0.0666934603251638,2021-12-06 09:47:37 UTC
807647,mainnet,255,110160000,110292072,132073,123252,8821,0.06678882133365639,2021-12-06 09:49:34 UTC
807648,mainnet,255,110160000,110292276,132277,123435,8842,0.0668445761545847,2021-12-06 09:51:31 UTC
807650,mainnet,255,110160000,110292496,132497,123635,8862,0.06688453323471474,2021-12-06 09:53:36 UTC
807651,mainnet,255,110160000,110292732,132733,123857,8876,0.06687108706953056,2021-12-06 09:55:51 UTC
807653,mainnet,255,110160000,110292917,132918,124035,8883,0.06683067756060128,2021-12-06 09:58:00 UTC
807654,mainnet,255,110160000,110293153,133154,124188,8966,0.0673355663367229,2021-12-06 10:00:07 UTC
807656,mainnet,255,110160000,110293344,133345,124349,8996,0.067464096891522,2021-12-06 10:02:20 UTC
807657,mainnet,255,110160000,110293567,133568,124547,9021,0.06753863200766651,2021-12-06 10:04:21 UTC
807659,mainnet,255,110160000,110293787,133788,124756,9032,0.06750979161060783,2021-12-06 10:06:23 UTC
807661,mainnet,255,110160000,110294069,134070,125018,9052,0.06751696874766913,2021-12-06 10:09:15 UTC
807662,mainnet,255,110160000,110294319,134320,125241,9079,0.06759231685527099,2021-12-06 10:11:17 UTC
807664,mainnet,255,110160000,110294518,134519,125408,9111,0.06773020911544095,2021-12-06 10:13:17 UTC
807665,mainnet,255,110160000,110294720,134721,125589,9132,0.0677845324782328,2021-12-06 10:15:15 UTC
807666,mainnet,255,110160000,110294957,134958,125821,9137,0.06770254449532447,2021-12-06 10:17:31 UTC
807667,mainnet,255,110160000,110295184,135185,126044,9141,0.0676184487923956,2021-12-06 10:19:48 UTC
807669,mainnet,255,110160000,110295396,135397,126242,9155,0.06761597376603617,2021-12-06 10:21:46 UTC
807670,mainnet,255,110160000,110295597,135598,126439,9159,0.06754524403014794,2021-12-06 10:23:53 UTC
807672,mainnet,255,110160000,110295842,135843,126670,9173,0.06752648277791273,2021-12-06 10:26:01 UTC
807673,mainnet,255,110160000,110296067,136068,126872,9196,0.0675838551312579,2021-12-06 10:28:04 UTC
807674,mainnet,255,110160000,110296271,136272,127071,9201,0.06751937301866855,2021-12-06 10:30:14 UTC
807675,mainnet,255,110160000,110296506,136507,127285,9222,0.06755697510017801,2021-12-06 10:32:29 UTC
807677,mainnet,255,110160000,110296711,136712,127450,9262,0.06774825911404997,2021-12-06 10:34:49 UTC
807678,mainnet,255,110160000,110296943,136944,127640,9304,0.06794017992756163,2021-12-06 10:36:49 UTC
807680,mainnet,255,110160000,110297060,137061,127738,9323,0.0680208082532595,2021-12-06 10:38:45 UTC
807681,mainnet,255,110160000,110297359,137360,127918,9442,0.06873907979033198,2021-12-06 10:40:52 UTC
807683,mainnet,255,110160000,110297482,137483,128016,9467,0.06885942261952387,2021-12-06 10:42:55 UTC
807684,mainnet,255,110160000,110297782,137783,128260,9523,0.06911592867044555,2021-12-06 10:45:01 UTC
807686,mainnet,255,110160000,110297953,137954,128406,9548,0.06921147628919785,2021-12-06 10:46:58 UTC
807687,mainnet,255,110160000,110298107,138108,128533,9575,0.06932979986677093,2021-12-06 10:49:18 UTC
807689,mainnet,255,110160000,110298323,138324,128717,9607,0.06945287874844568,2021-12-06 10:51:19 UTC
807690,mainnet,255,110160000,110298508,138509,128892,9617,0.0694323112577522,2021-12-06 10:53:24 UTC
807692,mainnet,255,110160000,110298704,138705,129077,9628,0.06941350347860567,2021-12-06 10:55:24 UTC
807693,mainnet,255,110160000,110298899,138900,129263,9637,0.06938084953203744,2021-12-06 10:57:23 UTC
807694,mainnet,255,110160000,110299119,139120,129464,9656,0.06940770557791834,2021-12-06 10:59:19 UTC
807696,mainnet,255,110160000,110299340,139341,129671,9670,0.06939809532011397,2021-12-06 11:01:25 UTC
807697,mainnet,255,110160000,110299535,139536,129841,9695,0.0694802774911134,2021-12-06 11:03:24 UTC
807699,mainnet,255,110160000,110299761,139762,130047,9715,0.06951102588686481,2021-12-06 11:05:29 UTC
807700,mainnet,255,110160000,110299933,139934,130208,9726,0.0695041948347078,2021-12-06 11:07:39 UTC
807702,mainnet,255,110160000,110300187,140188,130412,9776,0.06973492738322824,2021-12-06 11:09:43 UTC
807703,mainnet,255,110160000,110300301,140302,130506,9796,0.06982081509885818,2021-12-06 11:11:51 UTC
807705,mainnet,255,110160000,110300584,140585,130703,9882,0.0702919941672298,2021-12-06 11:13:52 UTC
807706,mainnet,255,110160000,110300799,140800,130876,9924,0.07048295454545454,2021-12-06 11:16:19 UTC
807707,mainnet,255,110160000,110301024,141025,131071,9954,0.07058322992377238,2021-12-06 11:18:20 UTC
807709,mainnet,255,110160000,110301172,141173,131205,9968,0.07060840245656039,2021-12-06 11:20:21 UTC
807710,mainnet,255,110160000,110301403,141404,131411,9993,0.0706698537523691,2021-12-06 11:22:26 UTC
807712,mainnet,255,110160000,110301661,141662,131643,10019,0.07072468269542996,2021-12-06 11:25:07 UTC
807713,mainnet,255,110160000,110301882,141883,131849,10034,0.07072024132559926,2021-12-06 11:27:09 UTC
807715,mainnet,255,110160000,110302064,142065,132011,10054,0.07077042198993419,2021-12-06 11:29:05 UTC
807716,mainnet,255,110160000,110302272,142273,132206,10067,0.07075833081470131,2021-12-06 11:31:11 UTC
807718,mainnet,255,110160000,110302464,142465,132377,10088,0.07081037447794195,2021-12-06 11:33:20 UTC
807719,mainnet,255,110160000,110302664,142665,132556,10109,0.07085830441944416,2021-12-06 11:35:21 UTC
807721,mainnet,255,110160000,110302892,142893,132763,10130,0.07089220605627987,2021-12-06 11:37:24 UTC
807722,mainnet,255,110160000,110303112,143113,132973,10140,0.07085310209414938,2021-12-06 11:39:28 UTC
807723,mainnet,255,110160000,110303330,143331,133176,10155,0.07084999058124201,2021-12-06 11:41:25 UTC
807724,mainnet,255,110160000,110303544,143545,133372,10173,0.07086976209551012,2021-12-06 11:43:29 UTC
807726,mainnet,255,110160000,110303742,143743,133534,10209,0.07102258892606944,2021-12-06 11:45:30 UTC
807727,mainnet,255,110160000,110303937,143938,133706,10232,0.0710861620975698,2021-12-06 11:47:31 UTC
807729,mainnet,255,110160000,110304113,144114,133856,10258,0.07117976046740775,2021-12-06 11:49:31 UTC
807730,mainnet,255,110160000,110304276,144277,133996,10281,0.07125875919238686,2021-12-06 11:51:37 UTC
807732,mainnet,255,110160000,110304522,144523,134228,10295,0.07123433640320226,2021-12-06 11:53:53 UTC
807733,mainnet,255,110160000,110304771,144772,134446,10326,0.07132594700632719,2021-12-06 11:56:05 UTC
807735,mainnet,255,110160000,110304985,144986,134624,10362,0.07146896941773688,2021-12-06 11:58:28 UTC
807736,mainnet,255,110160000,110305101,145102,134719,10383,0.07155656021281581,2021-12-06 12:00:39 UTC
807738,mainnet,255,110160000,110305435,145436,135017,10419,0.07163975906928133,2021-12-06 12:02:37 UTC
807739,mainnet,255,110160000,110305640,145641,135192,10449,0.07174490699734277,2021-12-06 12:04:50 UTC
807741,mainnet,255,110160000,110305814,145815,135342,10473,0.0718238864314371,2021-12-06 12:06:48 UTC
807742,mainnet,255,110160000,110305951,145952,135464,10488,0.07185924139443105,2021-12-06 12:09:08 UTC
807744,mainnet,255,110160000,110306198,146199,135675,10524,0.07198407649847126,2021-12-06 12:10:51 UTC
807745,mainnet,255,110160000,110306422,146423,135870,10553,0.07207201054479145,2021-12-06 12:12:53 UTC
807747,mainnet,255,110160000,110306637,146638,136061,10577,0.07213000722868561,2021-12-06 12:15:04 UTC
807748,mainnet,255,110160000,110306858,146859,136253,10606,0.07221893108355634,2021-12-06 12:17:24 UTC
807749,mainnet,255,110160000,110307099,147100,136473,10627,0.07224337185588035,2021-12-06 12:19:48 UTC
807751,mainnet,255,110160000,110307350,147351,136710,10641,0.07221532259706415,2021-12-06 12:22:21 UTC
807752,mainnet,255,110160000,110307556,147557,136900,10657,0.07222293757666529,2021-12-06 12:24:24 UTC
807754,mainnet,255,110160000,110307758,147759,137088,10671,0.07221895112988042,2021-12-06 12:26:24 UTC
807755,mainnet,255,110160000,110307958,147959,137265,10694,0.07227677937807095,2021-12-06 12:28:26 UTC
807757,mainnet,255,110160000,110308158,148159,137447,10712,0.07230070397343395,2021-12-06 12:30:40 UTC
807758,mainnet,255,110160000,110308361,148362,137641,10721,0.07226243916905946,2021-12-06 12:32:45 UTC
807760,mainnet,255,110160000,110308605,148606,137851,10755,0.07237258253367966,2021-12-06 12:35:20 UTC
807761,mainnet,255,110160000,110308813,148814,138048,10766,0.07234534385205693,2021-12-06 12:37:24 UTC
807763,mainnet,255,110160000,110309008,149009,138230,10779,0.07233791247508539,2021-12-06 12:39:23 UTC
807764,mainnet,255,110160000,110309246,149247,138444,10803,0.07238336448973849,2021-12-06 12:42:04 UTC
807765,mainnet,255,110160000,110309476,149477,138658,10819,0.07237902821169812,2021-12-06 12:44:17 UTC
807767,mainnet,255,110160000,110309674,149675,138835,10840,0.07242358443293803,2021-12-06 12:46:13 UTC
807768,mainnet,255,110160000,110309872,149873,139018,10855,0.07242798903071267,2021-12-06 12:48:15 UTC
807770,mainnet,255,110160000,110310073,150074,139198,10876,0.0724709143489212,2021-12-06 12:50:19 UTC
807771,mainnet,255,110160000,110310300,150301,139413,10888,0.07244130112241436,2021-12-06 12:52:32 UTC
807773,mainnet,255,110160000,110310520,150521,139620,10901,0.07242178832189529,2021-12-06 12:54:35 UTC
807774,mainnet,255,110160000,110310620,150621,139711,10910,0.07243345881384401,2021-12-06 12:56:36 UTC
807776,mainnet,255,110160000,110310933,150934,139971,10963,0.07263439649118157,2021-12-06 12:58:41 UTC
807777,mainnet,255,110160000,110311137,151138,140149,10989,0.07270838571371858,2021-12-06 13:00:58 UTC
807778,mainnet,255,110160000,110311429,151430,140403,11027,0.07281912434788351,2021-12-06 13:03:44 UTC
807779,mainnet,255,110160000,110311655,151656,140625,11031,0.07273698369995252,2021-12-06 13:05:59 UTC
807781,mainnet,255,110160000,110311865,151866,140821,11045,0.07272858967774222,2021-12-06 13:08:25 UTC
807782,mainnet,255,110160000,110312130,152131,141043,11088,0.07288455344407123,2021-12-06 13:10:45 UTC
807784,mainnet,255,110160000,110312336,152337,141240,11097,0.07284507375096004,2021-12-06 13:12:51 UTC
807785,mainnet,255,110160000,110312554,152555,141443,11112,0.07283930385762512,2021-12-06 13:15:01 UTC
807787,mainnet,255,110160000,110312802,152803,141675,11128,0.072825795305066,2021-12-06 13:17:29 UTC
807788,mainnet,255,110160000,110313044,153045,141901,11144,0.07281518507628475,2021-12-06 13:20:07 UTC
807790,mainnet,255,110160000,110313358,153359,142187,11172,0.07284867533043382,2021-12-06 13:22:41 UTC
807792,mainnet,255,110160000,110313593,153594,142406,11188,0.07284138703334765,2021-12-06 13:25:12 UTC
807793,mainnet,255,110160000,110313863,153864,142658,11206,0.07283055165600791,2021-12-06 13:27:34 UTC
807795,mainnet,255,110160000,110314072,154073,142851,11222,0.07283560390204644,2021-12-06 13:29:40 UTC
807796,mainnet,255,110160000,110314357,154358,143115,11243,0.0728371707329714,2021-12-06 13:32:21 UTC
807798,mainnet,255,110160000,110314605,154606,143341,11265,0.07286263146320324,2021-12-06 13:34:33 UTC
807799,mainnet,255,110160000,110314820,154821,143550,11271,0.0728002015230492,2021-12-06 13:36:46 UTC
807801,mainnet,255,110160000,110315076,155077,143793,11284,0.07276385279570793,2021-12-06 13:38:59 UTC
807802,mainnet,255,110160000,110315309,155310,144023,11287,0.07267400682505956,2021-12-06 13:41:05 UTC
807804,mainnet,255,110160000,110315548,155549,144244,11305,0.07267806286122058,2021-12-06 13:43:14 UTC
807805,mainnet,255,110160000,110315763,155764,144456,11308,0.07259700572661205,2021-12-06 13:45:27 UTC
807807,mainnet,255,110160000,110315997,155998,144672,11326,0.0726034949166015,2021-12-06 13:47:36 UTC
807808,mainnet,255,110160000,110316255,156256,144897,11359,0.07269480851935285,2021-12-06 13:50:00 UTC
807810,mainnet,255,110160000,110316504,156505,145116,11389,0.0727708379923964,2021-12-06 13:52:42 UTC
807811,mainnet,255,110160000,110316792,156793,145370,11423,0.0728540177176277,2021-12-06 13:55:08 UTC
807813,mainnet,255,110160000,110317029,157030,145594,11436,0.07282684837292237,2021-12-06 13:57:19 UTC
807814,mainnet,255,110160000,110317253,157254,145801,11453,0.07283121574014016,2021-12-06 13:59:28 UTC
807816,mainnet,255,110160000,110317489,157490,146015,11475,0.07286176900120643,2021-12-06 14:01:45 UTC
807817,mainnet,255,110160000,110317697,157698,146216,11482,0.07281005466144148,2021-12-06 14:03:44 UTC
807819,mainnet,255,110160000,110317905,157906,146415,11491,0.07277114232518081,2021-12-06 14:05:49 UTC
807820,mainnet,255,110160000,110318116,158117,146605,11512,0.07280684556372813,2021-12-06 14:07:53 UTC
807822,mainnet,255,110160000,110318328,158329,146801,11528,0.07281041375869235,2021-12-06 14:09:55 UTC
807823,mainnet,255,110160000,110318587,158588,147057,11531,0.0727104194516609,2021-12-06 14:12:19 UTC
807824,mainnet,255,110160000,110318810,158811,147263,11548,0.07271536606406358,2021-12-06 14:14:22 UTC
807826,mainnet,255,110160000,110318971,158972,147418,11554,0.07267946556626324,2021-12-06 14:16:27 UTC
807827,mainnet,255,110160000,110319268,159269,147687,11582,0.07271973830437813,2021-12-06 14:18:32 UTC
807829,mainnet,255,110160000,110319528,159529,147931,11598,0.07270151508503156,2021-12-06 14:20:52 UTC
807830,mainnet,255,110160000,110319784,159785,148179,11606,0.07263510342022092,2021-12-06 14:23:19 UTC
807832,mainnet,255,110160000,110320004,160005,148380,11625,0.07265397956313865,2021-12-06 14:25:35 UTC
807833,mainnet,255,110160000,110320210,160211,148570,11641,0.0726604290591782,2021-12-06 14:27:38 UTC
807835,mainnet,255,110160000,110320457,160458,148807,11651,0.07261090129504294,2021-12-06 14:29:49 UTC
807836,mainnet,255,110160000,110320708,160709,149046,11663,0.07257216459563559,2021-12-06 14:32:18 UTC
807838,mainnet,255,110160000,110320792,160793,149129,11664,0.07254047128917304,2021-12-06 14:34:29 UTC
807839,mainnet,255,110160000,110321156,161157,149454,11703,0.07261862655671178,2021-12-06 14:36:44 UTC
807841,mainnet,255,110160000,110321377,161378,149651,11727,0.07266789773079355,2021-12-06 14:39:38 UTC
807843,mainnet,255,110160000,110321612,161613,149871,11742,0.07265504631434352,2021-12-06 14:41:39 UTC
807844,mainnet,255,110160000,110321795,161796,150015,11781,0.07281391381739968,2021-12-06 14:43:40 UTC
807846,mainnet,255,110160000,110321980,161981,150190,11791,0.07279248800785278,2021-12-06 14:45:43 UTC
807847,mainnet,255,110160000,110322201,162202,150399,11803,0.07276729016904847,2021-12-06 14:47:49 UTC
807849,mainnet,255,110160000,110322408,162409,150592,11817,0.07276074601776995,2021-12-06 14:49:57 UTC
807850,mainnet,255,110160000,110322558,162559,150721,11838,0.07282279049452814,2021-12-06 14:52:05 UTC
807852,mainnet,255,110160000,110322824,162825,150979,11846,0.07275295562720713,2021-12-06 14:54:06 UTC
807853,mainnet,255,110160000,110323056,163057,151186,11871,0.07280276222425287,2021-12-06 14:56:09 UTC
807855,mainnet,255,110160000,110323266,163267,151378,11889,0.07281936949904144,2021-12-06 14:58:20 UTC
807856,mainnet,255,110160000,110323498,163499,151584,11915,0.07287506345604561,2021-12-06 15:00:34 UTC
807858,mainnet,255,110160000,110323726,163727,151797,11930,0.07286519633292005,2021-12-06 15:03:01 UTC
807859,mainnet,255,110160000,110323995,163996,152039,11957,0.07291031488572892,2021-12-06 15:05:45 UTC
807861,mainnet,255,110160000,110324193,164194,152215,11979,0.07295638086653593,2021-12-06 15:07:55 UTC
807862,mainnet,255,110160000,110324400,164401,152396,12005,0.07302267017840525,2021-12-06 15:10:04 UTC
807864,mainnet,255,110160000,110324604,164605,152589,12016,0.0729989976003159,2021-12-06 15:12:05 UTC
807865,mainnet,255,110160000,110324820,164821,152790,12031,0.07299433931355835,2021-12-06 15:14:22 UTC
807867,mainnet,255,110160000,110325052,165053,152992,12061,0.0730734976038,2021-12-06 15:16:57 UTC
807868,mainnet,255,110160000,110325261,165262,153148,12114,0.07330178746475294,2021-12-06 15:19:13 UTC
807870,mainnet,255,110160000,110325465,165466,153299,12167,0.07353172252909963,2021-12-06 15:21:27 UTC
807871,mainnet,255,110160000,110325677,165678,153463,12215,0.07372735064402033,2021-12-06 15:23:47 UTC
807873,mainnet,255,110160000,110325886,165887,153638,12249,0.07383942081055177,2021-12-06 15:25:59 UTC
807874,mainnet,255,110160000,110326097,166098,153818,12280,0.0739322568604077,2021-12-06 15:28:16 UTC
807876,mainnet,255,110160000,110326304,166305,153992,12313,0.07403866390066444,2021-12-06 15:30:34 UTC
807878,mainnet,255,110160000,110326505,166506,154143,12363,0.07424957659183452,2021-12-06 15:32:36 UTC
807879,mainnet,255,110160000,110326743,166744,154345,12399,0.0743594971933023,2021-12-06 15:35:12 UTC
807881,mainnet,255,110160000,110326934,166935,154499,12436,0.07449606134124061,2021-12-06 15:37:21 UTC
807882,mainnet,255,110160000,110327176,167177,154723,12454,0.07449589357387679,2021-12-06 15:39:36 UTC
807884,mainnet,255,110160000,110327379,167380,154897,12483,0.07457880272433982,2021-12-06 15:41:52 UTC
807885,mainnet,255,110160000,110327599,167600,155097,12503,0.07460023866348449,2021-12-06 15:44:04 UTC
807887,mainnet,255,110160000,110327801,167802,155282,12520,0.07461174479446014,2021-12-06 15:46:11 UTC
807888,mainnet,255,110160000,110327968,167969,155433,12536,0.07463281915115288,2021-12-06 15:48:09 UTC
807889,mainnet,255,110160000,110328171,168172,155601,12571,0.07475085031991056,2021-12-06 15:50:25 UTC
807890,mainnet,255,110160000,110328409,168410,155807,12603,0.07483522356154623,2021-12-06 15:52:32 UTC
807892,mainnet,255,110160000,110328643,168644,156033,12611,0.07477882403168805,2021-12-06 15:54:46 UTC
807893,mainnet,255,110160000,110328847,168848,156225,12623,0.07475954704823273,2021-12-06 15:57:17 UTC
807895,mainnet,255,110160000,110329071,169072,156421,12651,0.07482610958644838,2021-12-06 15:59:28 UTC
807896,mainnet,255,110160000,110329272,169273,156602,12671,0.07485541108150738,2021-12-06 16:01:44 UTC
807898,mainnet,255,110160000,110329490,169491,156788,12703,0.07494793233859025,2021-12-06 16:04:14 UTC
807899,mainnet,255,110160000,110329703,169704,156987,12717,0.07493635977938057,2021-12-06 16:06:41 UTC
807901,mainnet,255,110160000,110329880,169881,157118,12763,0.07512906093088692,2021-12-06 16:08:46 UTC
807903,mainnet,255,110160000,110330146,170147,157342,12805,0.07525845298477199,2021-12-06 16:11:17 UTC
807904,mainnet,255,110160000,110330288,170289,157457,12832,0.07535425071496103,2021-12-06 16:13:22 UTC
807905,mainnet,255,110160000,110330526,170527,157662,12865,0.07544259853278366,2021-12-06 16:15:33 UTC
807907,mainnet,255,110160000,110330724,170725,157841,12884,0.07546639332259482,2021-12-06 16:17:42 UTC
807908,mainnet,255,110160000,110330926,170927,158015,12912,0.07554102043562456,2021-12-06 16:19:53 UTC
807910,mainnet,255,110160000,110331132,171133,158202,12931,0.07556111328615756,2021-12-06 16:22:00 UTC
807911,mainnet,255,110160000,110331320,171321,158375,12946,0.07556575084198668,2021-12-06 16:23:59 UTC
807913,mainnet,255,110160000,110331561,171562,158589,12973,0.07561697811869761,2021-12-06 16:26:11 UTC
807914,mainnet,255,110160000,110331799,171800,158804,12996,0.07564610011641444,2021-12-06 16:28:16 UTC
807916,mainnet,255,110160000,110332007,172008,158974,13034,0.07577554532347333,2021-12-06 16:30:41 UTC
807917,mainnet,255,110160000,110332179,172180,159128,13052,0.07580439075386224,2021-12-06 16:32:54 UTC
807919,mainnet,255,110160000,110332454,172455,159338,13117,0.07606042155924735,2021-12-06 16:35:16 UTC
807920,mainnet,255,110160000,110332639,172640,159492,13148,0.07615848007414272,2021-12-06 16:37:21 UTC
807921,mainnet,255,110160000,110332849,172850,159687,13163,0.07615273358403239,2021-12-06 16:39:32 UTC
807923,mainnet,255,110160000,110333073,173074,159884,13190,0.07621017599408346,2021-12-06 16:41:50 UTC
807924,mainnet,255,110160000,110333278,173279,160065,13214,0.07625851949745786,2021-12-06 16:44:10 UTC
807926,mainnet,255,110160000,110333473,173474,160223,13251,0.07638608667581309,2021-12-06 16:46:15 UTC
807927,mainnet,255,110160000,110333636,173637,160367,13270,0.07642380368239488,2021-12-06 16:48:25 UTC
807929,mainnet,255,110160000,110333835,173836,160537,13299,0.0765031408914149,2021-12-06 16:50:38 UTC
807930,mainnet,255,110160000,110334063,174064,160731,13333,0.07659826270796949,2021-12-06 16:53:01 UTC
807932,mainnet,255,110160000,110334258,174259,160891,13368,0.07671339787328058,2021-12-06 16:55:18 UTC
807933,mainnet,255,110160000,110334431,174432,161042,13390,0.07676343790130251,2021-12-06 16:57:21 UTC
807935,mainnet,255,110160000,110334609,174610,161200,13410,0.07679972510165511,2021-12-06 16:59:28 UTC
807936,mainnet,255,110160000,110334805,174806,161353,13453,0.0769596009290299,2021-12-06 17:01:45 UTC
807937,mainnet,255,110160000,110335016,175017,161545,13472,0.0769753795345595,2021-12-06 17:04:05 UTC
807939,mainnet,255,110160000,110335203,175204,161694,13510,0.07711011164128673,2021-12-06 17:06:04 UTC
807940,mainnet,255,110160000,110335370,175371,161835,13536,0.0771849393571343,2021-12-06 17:08:05 UTC
807942,mainnet,255,110160000,110335591,175592,162019,13573,0.07729851018269625,2021-12-06 17:10:15 UTC
807943,mainnet,255,110160000,110335811,175812,162215,13597,0.07733829317680249,2021-12-06 17:12:36 UTC
807945,mainnet,255,110160000,110336012,176013,162380,13633,0.0774545062012465,2021-12-06 17:14:59 UTC
807946,mainnet,255,110160000,110336241,176242,162582,13660,0.07750706415042952,2021-12-06 17:17:18 UTC
807948,mainnet,255,110160000,110336395,176396,162713,13683,0.07756978616295154,2021-12-06 17:19:23 UTC
807949,mainnet,255,110160000,110336625,176626,162904,13722,0.07768958137533545,2021-12-06 17:21:49 UTC
807951,mainnet,255,110160000,110336852,176853,163094,13759,0.07779907606882552,2021-12-06 17:23:55 UTC
807952,mainnet,255,110160000,110337070,177071,163295,13776,0.0777993008454236,2021-12-06 17:26:10 UTC
807954,mainnet,255,110160000,110337262,177263,163455,13808,0.07789555632026988,2021-12-06 17:28:46 UTC
807955,mainnet,255,110160000,110337541,177542,163692,13850,0.07800971037838934,2021-12-06 17:31:03 UTC
807957,mainnet,255,110160000,110337818,177819,163959,13860,0.07794442663607376,2021-12-06 17:33:44 UTC
807959,mainnet,255,110160000,110338077,178078,164202,13876,0.07792091106144498,2021-12-06 17:36:21 UTC
807960,mainnet,255,110160000,110338258,178259,164358,13901,0.07798203737258708,2021-12-06 17:38:27 UTC
807962,mainnet,255,110160000,110338473,178474,164538,13936,0.0780842027410155,2021-12-06 17:40:45 UTC
807963,mainnet,255,110160000,110338671,178672,164722,13950,0.07807602758126624,2021-12-06 17:42:47 UTC
807965,mainnet,255,110160000,110338890,178891,164917,13974,0.07811460610092179,2021-12-06 17:44:59 UTC
807966,mainnet,255,110160000,110339132,179133,165145,13988,0.07808723127508611,2021-12-06 17:47:28 UTC
807968,mainnet,255,110160000,110339416,179417,165399,14018,0.07813083487072017,2021-12-06 17:49:50 UTC
807969,mainnet,255,110160000,110339664,179665,165632,14033,0.07810647594133527,2021-12-06 17:52:11 UTC
807971,mainnet,255,110160000,110339880,179881,165844,14037,0.07803492308804154,2021-12-06 17:54:20 UTC
807972,mainnet,255,110160000,110340000,180001,165957,14044,0.07802178876784018,2021-12-06 17:56:20 UTC
807974,mainnet,255,110160000,110340320,180321,166242,14079,0.07807742858568885,2021-12-06 17:58:40 UTC
807975,mainnet,255,110160000,110340605,180606,166488,14118,0.07817016045978539,2021-12-06 18:01:21 UTC
807977,mainnet,255,110160000,110340848,180849,166713,14136,0.07816465670255296,2021-12-06 18:03:39 UTC
807978,mainnet,255,110160000,110341040,181041,166887,14154,0.07818118547732282,2021-12-06 18:05:47 UTC
807980,mainnet,255,110160000,110341215,181216,167045,14171,0.07819949673318029,2021-12-06 18:07:54 UTC
807981,mainnet,255,110160000,110341482,181483,167290,14193,0.07820567215662073,2021-12-06 18:10:26 UTC
807983,mainnet,255,110160000,110341728,181729,167514,14215,0.07822086733542803,2021-12-06 18:12:46 UTC
807984,mainnet,255,110160000,110341962,181963,167725,14238,0.0782466765221501,2021-12-06 18:15:09 UTC
807986,mainnet,255,110160000,110342181,182182,167922,14260,0.07827337497667168,2021-12-06 18:17:15 UTC
807987,mainnet,255,110160000,110342375,182376,168083,14293,0.07837105759529762,2021-12-06 18:19:20 UTC
807989,mainnet,255,110160000,110342571,182572,168260,14312,0.07839099095151501,2021-12-06 18:21:20 UTC
807990,mainnet,255,110160000,110342810,182811,168478,14333,0.07840337835250615,2021-12-06 18:23:29 UTC
807992,mainnet,255,110160000,110343035,183036,168689,14347,0.07838348740138552,2021-12-06 18:25:40 UTC
807993,mainnet,255,110160000,110343252,183253,168888,14365,0.07838889404266233,2021-12-06 18:27:48 UTC
807995,mainnet,255,110160000,110343448,183449,169048,14401,0.07850138185544757,2021-12-06 18:29:50 UTC
807996,mainnet,255,110160000,110343651,183652,169226,14426,0.07855073726395574,2021-12-06 18:32:00 UTC
807998,mainnet,255,110160000,110343864,183865,169425,14440,0.07853588230495201,2021-12-06 18:34:07 UTC
807999,mainnet,255,110160000,110344055,184056,169595,14461,0.07856847915851697,2021-12-06 18:36:09 UTC
808000,mainnet,255,110160000,110344266,184267,169782,14485,0.07860875794363614,2021-12-06 18:38:30 UTC
808002,mainnet,255,110160000,110344524,184525,170021,14504,0.07860181547215825,2021-12-06 18:40:46 UTC
808003,mainnet,255,110160000,110344764,184765,170259,14506,0.07851054041620437,2021-12-06 18:43:00 UTC
808005,mainnet,255,110160000,110344981,184982,170466,14516,0.07847250002702966,2021-12-06 18:45:15 UTC
808006,mainnet,255,110160000,110345214,185215,170668,14547,0.07854115487406528,2021-12-06 18:47:22 UTC
808008,mainnet,255,110160000,110345446,185447,170867,14580,0.0786208458481399,2021-12-06 18:49:40 UTC
808009,mainnet,255,110160000,110345657,185658,171061,14597,0.0786230596042185,2021-12-06 18:51:51 UTC
808011,mainnet,255,110160000,110345887,185888,171268,14620,0.07864950938199346,2021-12-06 18:54:02 UTC
808012,mainnet,255,110160000,110346132,186133,171505,14628,0.07858896595445193,2021-12-06 18:56:23 UTC
808014,mainnet,255,110160000,110346341,186342,171689,14653,0.07863498298826888,2021-12-06 18:58:15 UTC
808015,mainnet,255,110160000,110346520,186521,171859,14662,0.07860777070678368,2021-12-06 19:00:02 UTC
808017,mainnet,255,110160000,110346710,186711,172042,14669,0.07856526931996508,2021-12-06 19:01:58 UTC
808018,mainnet,255,110160000,110346897,186898,172214,14684,0.07856691885413435,2021-12-06 19:04:08 UTC
808020,mainnet,255,110160000,110347143,187144,172443,14701,0.07855448211003292,2021-12-06 19:06:29 UTC
808021,mainnet,255,110160000,110347350,187351,172641,14710,0.07851572716452007,2021-12-06 19:08:30 UTC
808023,mainnet,255,110160000,110347554,187555,172836,14719,0.0784783130281784,2021-12-06 19:10:39 UTC
808024,mainnet,255,110160000,110347780,187781,173041,14740,0.0784956944525804,2021-12-06 19:12:56 UTC
808026,mainnet,255,110160000,110348014,188015,173236,14779,0.07860543041778581,2021-12-06 19:15:06 UTC
808027,mainnet,255,110160000,110348244,188245,173443,14802,0.07863157055964302,2021-12-06 19:17:20 UTC
808029,mainnet,255,110160000,110348485,188486,173674,14812,0.07858408582069756,2021-12-06 19:19:49 UTC
808031,mainnet,255,110160000,110348784,188785,173957,14828,0.07854437587732076,2021-12-06 19:22:42 UTC
808032,mainnet,255,110160000,110349034,189035,174178,14857,0.07859391118046923,2021-12-06 19:24:43 UTC
808033,mainnet,255,110160000,110349254,189255,174354,14901,0.07873504002536261,2021-12-06 19:27:18 UTC
808034,mainnet,255,110160000,110349484,189485,174554,14931,0.07879779402063487,2021-12-06 19:29:32 UTC
808035,mainnet,255,110160000,110349691,189692,174744,14948,0.07880142546865446,2021-12-06 19:31:46 UTC
808037,mainnet,255,110160000,110349939,189940,174961,14979,0.07886174581446773,2021-12-06 19:33:57 UTC
808038,mainnet,255,110160000,110350090,190091,175072,15019,0.07900952701600812,2021-12-06 19:35:47 UTC
808040,mainnet,255,110160000,110350357,190358,175308,15050,0.07906155769655071,2021-12-06 19:38:03 UTC
808041,mainnet,255,110160000,110350514,190515,175441,15074,0.07912237881531638,2021-12-06 19:39:53 UTC
808043,mainnet,255,110160000,110350716,190717,175609,15108,0.07921685009726454,2021-12-06 19:42:01 UTC
808044,mainnet,255,110160000,110350915,190916,175796,15120,0.0791971338180142,2021-12-06 19:44:05 UTC
808045,mainnet,255,110160000,110351110,191111,175944,15167,0.07936225544317177,2021-12-06 19:46:16 UTC
808047,mainnet,255,110160000,110351320,191321,176138,15183,0.07935877399762703,2021-12-06 19:48:21 UTC
808048,mainnet,255,110160000,110351543,191544,176335,15209,0.07940212170571774,2021-12-06 19:50:31 UTC
808050,mainnet,255,110160000,110351754,191755,176542,15213,0.07933561054470549,2021-12-06 19:52:30 UTC
808051,mainnet,255,110160000,110352019,192020,176767,15253,0.07943443391313405,2021-12-06 19:55:03 UTC
808053,mainnet,255,110160000,110352215,192216,176949,15267,0.07942627044574853,2021-12-06 19:57:16 UTC
808055,mainnet,255,110160000,110352498,192499,177201,15298,0.07947054270411795,2021-12-06 19:59:52 UTC
808056,mainnet,255,110160000,110352760,192761,177447,15314,0.07944553099434014,2021-12-06 20:02:13 UTC
808058,mainnet,255,110160000,110353002,193003,177655,15348,0.0795220799676689,2021-12-06 20:04:39 UTC
808059,mainnet,255,110160000,110353213,193214,177828,15386,0.07963191073110644,2021-12-06 20:06:46 UTC
808061,mainnet,255,110160000,110353412,193413,178016,15397,0.07960685165940241,2021-12-06 20:09:03 UTC
808062,mainnet,255,110160000,110353591,193592,178182,15410,0.07960039671060788,2021-12-06 20:11:15 UTC
808064,mainnet,255,110160000,110353861,193862,178414,15448,0.07968554951460317,2021-12-06 20:13:29 UTC
808065,mainnet,255,110160000,110354117,194118,178647,15471,0.07969894600191636,2021-12-06 20:15:55 UTC
808067,mainnet,255,110160000,110354360,194361,178873,15488,0.07968676843605456,2021-12-06 20:18:08 UTC
808068,mainnet,255,110160000,110354575,194576,179060,15516,0.07974261985034126,2021-12-06 20:20:27 UTC
808070,mainnet,255,110160000,110354826,194827,179283,15544,0.07978360288871665,2021-12-06 20:22:50 UTC
808071,mainnet,255,110160000,110355037,195038,179454,15584,0.0799023779981337,2021-12-06 20:24:52 UTC
808073,mainnet,255,110160000,110355225,195226,179629,15597,0.07989202257895978,2021-12-06 20:27:05 UTC
808074,mainnet,255,110160000,110355441,195442,179818,15624,0.07994187533897525,2021-12-06 20:29:16 UTC
808075,mainnet,255,110160000,110355678,195679,180037,15642,0.07993703974366181,2021-12-06 20:31:35 UTC
808077,mainnet,255,110160000,110355861,195862,180210,15652,0.07991340842021423,2021-12-06 20:33:46 UTC
808078,mainnet,255,110160000,110356105,196106,180423,15683,0.07997205592893639,2021-12-06 20:35:57 UTC
808080,mainnet,255,110160000,110356324,196325,180632,15693,0.07993378326754107,2021-12-06 20:38:04 UTC
808081,mainnet,255,110160000,110356506,196507,180800,15707,0.07993099482461184,2021-12-06 20:40:22 UTC
808083,mainnet,255,110160000,110356765,196766,181043,15723,0.07990709777095636,2021-12-06 20:42:59 UTC
808084,mainnet,255,110160000,110357050,197051,181296,15755,0.0799539205586371,2021-12-06 20:45:32 UTC
808086,mainnet,255,110160000,110357265,197266,181480,15786,0.08002392708322772,2021-12-06 20:47:49 UTC
808088,mainnet,255,110160000,110357683,197684,181851,15833,0.08009247081200299,2021-12-06 20:51:34 UTC
808089,mainnet,255,110160000,110357891,197892,182049,15843,0.08005881996240373,2021-12-06 20:53:49 UTC
808091,mainnet,255,110160000,110358124,198125,182255,15870,0.08010094637223975,2021-12-06 20:56:07 UTC
808092,mainnet,255,110160000,110358326,198327,182431,15896,0.08015045858607249,2021-12-06 20:58:26 UTC
808094,mainnet,255,110160000,110358556,198557,182641,15916,0.08015834244070973,2021-12-06 21:00:40 UTC
808095,mainnet,255,110160000,110358714,198715,182797,15918,0.08010467252094708,2021-12-06 21:03:00 UTC
808097,mainnet,255,110160000,110359036,199037,183092,15945,0.08011073318026296,2021-12-06 21:05:19 UTC
808098,mainnet,255,110160000,110359279,199280,183306,15974,0.08015857085507828,2021-12-06 21:07:37 UTC
808100,mainnet,255,110160000,110359542,199543,183559,15984,0.08010303543597119,2021-12-06 21:10:12 UTC
808101,mainnet,255,110160000,110359794,199795,183801,15994,0.08005205335468855,2021-12-06 21:12:24 UTC
808103,mainnet,255,110160000,110360056,200057,184054,16003,0.07999220222236662,2021-12-06 21:14:43 UTC
808104,mainnet,255,110160000,110360288,200289,184266,16023,0.079999400865749,2021-12-06 21:16:56 UTC
808106,mainnet,255,110160000,110360551,200552,184516,16036,0.07995931229805736,2021-12-06 21:19:13 UTC
808108,mainnet,255,110160000,110360790,200791,184733,16058,0.07997370400067733,2021-12-06 21:21:30 UTC
808109,mainnet,255,110160000,110361032,201033,184966,16067,0.07992220182756064,2021-12-06 21:23:43 UTC
808111,mainnet,255,110160000,110361288,201289,185212,16077,0.0798702363268733,2021-12-06 21:26:00 UTC
808112,mainnet,255,110160000,110361544,201545,185456,16089,0.07982832618025751,2021-12-06 21:28:23 UTC
808114,mainnet,255,110160000,110361671,201672,185570,16102,0.07984251656154548,2021-12-06 21:30:49 UTC
808115,mainnet,255,110160000,110362010,202011,185882,16129,0.07984218681160928,2021-12-06 21:32:57 UTC
808117,mainnet,255,110160000,110362144,202145,186007,16138,0.07983378268074896,2021-12-06 21:35:00 UTC
808118,mainnet,255,110160000,110362452,202453,186282,16171,0.07987532908872677,2021-12-06 21:37:16 UTC
808120,mainnet,255,110160000,110362658,202659,186476,16183,0.079853349715532,2021-12-06 21:39:39 UTC
808121,mainnet,255,110160000,110362916,202917,186709,16208,0.07987502279257036,2021-12-06 21:42:02 UTC
808123,mainnet,255,110160000,110363138,203139,186908,16231,0.079900954518827,2021-12-06 21:44:08 UTC
808124,mainnet,255,110160000,110363348,203349,187099,16250,0.07991187564236854,2021-12-06 21:46:16 UTC
808125,mainnet,255,110160000,110363546,203547,187274,16273,0.07994713751615107,2021-12-06 21:48:21 UTC
808127,mainnet,255,110160000,110363759,203760,187460,16300,0.07999607381232823,2021-12-06 21:50:36 UTC
808129,mainnet,255,110160000,110363971,203972,187637,16335,0.08008452140489872,2021-12-06 21:53:01 UTC
808130,mainnet,255,110160000,110364186,204187,187816,16371,0.08017650487053535,2021-12-06 21:55:15 UTC
808132,mainnet,255,110160000,110364380,204381,187991,16390,0.08019336435382937,2021-12-06 21:57:38 UTC
808133,mainnet,255,110160000,110364610,204611,188185,16426,0.08027916387681992,2021-12-06 22:00:00 UTC
